player,birthday,yrs,from,to,month,day,country
David Allan,1981-12-27,11,2004,2015,12,27,USA
Henry Louis,1934-02-05,22,1954,1976,2,5,USA
Tommie Lee,1939-08-05,9,1962,1971,8,5,USA
Donald William,1954-09-08,13,1977,1990,9,8,USA
Fausto Andres,1972-08-25,5,2001,2006,8,25,USA
Fernando Antonio,1985-12-17,9,2010,2019,12,17,D.R.
John W.,1850-11-04,0,1875,1875,11,4,USA
Edward James,1877-04-15,13,1897,1910,4,15,USA
Bert Wood,1869-11-11,4,1892,1896,11,11,USA
Charles S.,1866-10-14,4,1893,1897,10,14,USA
Leander Franklin,1862-03-16,0,1890,1890,3,16,USA
Harry Frederick,1874-10-22,2,1903,1905,10,22,USA
William Glenn,1951-02-16,11,1973,1984,2,16,USA
Jeffrey William,1972-08-17,4,1997,2001,8,17,USA
James Anthony,1967-09-19,10,1989,1999,9,19,USA
Kurt Thomas,1969-06-02,8,1993,2001,6,2,USA
Lawrence Kyle,1968-02-18,5,1991,1996,2,18,USA
Ody Cleon,1886-09-05,0,1910,1910,9,5,USA
Paul David,1967-09-15,14,1990,2004,9,15,USA
Albert Julius,1927-07-31,7,1950,1957,7,31,USA
Francis Patterson,1850-01-02,0,1871,1871,1,2,USA
Reginald Damascus,1980-07-15,2,2006,2008,7,15,USA
William Edward,1929-01-30,0,1952,1952,1,30,USA
Michael Brent,1977-09-23,4,2001,2005,9,23,USA
Talmadge Lafayette,1921-10-30,2,1942,1944,10,30,USA
Theodore Wade,1933-03-06,17,1955,1972,3,6,USA
Virgil Woodrow,1915-02-01,1,1946,1947,2,1,USA
Clifford Alexander,1921-08-28,2,1947,1949,8,28,USA
Harry Terrell,1883-10-04,6,1905,1911,10,4,USA
Shawn Wesley,1966-06-17,5,1987,1992,6,17,USA
Calvin Ross,1924-03-02,7,1949,1956,3,2,USA
George Allen,1899-11-09,0,1923,1923,11,9,USA
Johnny Ray,1962-07-04,0,1985,1985,7,4,USA
Bob Kelly,1974-03-11,18,1996,2014,3,11,Venezuela
Bryan Enrique,1997-04-22,0,2019,2019,4,22,D.R.
Joseph Lawrence,1913-05-24,0,1942,1942,5,24,USA
Jose Dariel,1987-01-29,5,2014,2019,1,29,Cuba
Juan de Dios,1985-04-08,0,2011,2011,4,8,D.R.
Etanislao Toni,1984-11-13,7,2007,2014,11,13,D.R.
Winston Leonardo,1977-04-05,3,2006,2009,4,5,D.R.
William Henry,1883-02-02,4,1906,1910,2,2,USA
Jeremiah Lee,1981-12-18,7,2005,2012,12,18,USA
Alfredo,1982-12-08,6,2008,2014,12,8,Mexico
Jose Omar,1977-12-18,4,2001,2005,12,18,D.R.
Juan Carlos,1970-05-05,8,1995,2003,5,5,Mexico
Adam Joseph,1988-08-27,2,2014,2016,8,27,USA
James Justin,1958-09-24,9,1983,1992,9,24,USA
Thomas James,1930-03-07,3,1956,1959,3,7,USA
Dustin Michael,1988-02-26,5,2011,2016,2,26,USA
Florian Frederick,1937-04-10,1,1963,1964,4,10,USA
Cecilio,1946-11-22,3,1972,1975,11,22,Mexico
Eduardo Elixbet,1944-03-09,2,1970,1972,3,9,Panama
Jose,1891-03-04,2,1920,1922,3,4,Cuba
Manuel Alcides,1981-05-01,5,2007,2012,5,1,Panama
Baldomero Pedro,1896-05-19,5,1913,1918,5,19,Cuba
Mark Robert,1968-09-16,3,1994,1997,9,16,USA
Manuel Elias,1969-01-11,NA,NA,NA,1,11,D.R.
Ronald Jose,1997-12-18,1,2018,2019,12,18,Venezuela
Marion Danne,1913-02-10,NA,NA,NA,2,10,USA
Kenneth Jerry,1936-12-17,12,1958,1970,12,17,USA
James Aubrey,1907-01-25,0,1931,1931,1,25,USA
Cristhian Pascual,1991-07-26,5,2014,2019,7,26,D.R.
Willy Rafael,1995-09-02,1,2018,2019,9,2,D.R.
Jason Kendall,1991-08-04,1,2018,2019,8,4,USA
Ace Townsend,1910-03-02,5,1941,1946,3,2,USA
Austin David,1986-08-19,5,2014,2019,8,19,USA
Austin Lance,1991-05-05,2,2017,2019,5,5,USA
Charles Benjamin,1882-05-18,20,1906,1926,5,18,USA
John Bertram,1891-06-21,9,1910,1919,6,21,USA
Robert Burnette,1901-07-24,0,1925,1925,7,24,USA
Robert Andrew,1907-01-20,1,1931,1932,1,20,USA
Robert Henry,1921-12-14,13,1946,1959,12,14,USA
Robert Melvin,1952-01-06,0,1977,1977,1,6,USA
Elvin Clark,1915-06-24,8,1939,1947,6,24,USA
Chance,1994-08-10,1,2018,2019,8,10,USA
Daniel Leslie,1887-06-19,1,1914,1915,6,19,USA
David Lee,1987-05-15,0,2013,2013,5,15,USA
Richard Leroy,1920-04-08,0,1947,1947,4,8,USA
Harold Douglas,1943-01-27,0,1969,1969,1,27,USA
George Henry,1855-01-25,0,1879,1879,1,25,USA
Glenn Charles,1947-10-04,7,1975,1982,10,4,USA
Herbert Loren,1928-04-14,2,1948,1950,4,14,USA
Joseph Edward,1877-10-28,0,1902,1902,10,28,USA
Joel Lee,1971-07-02,2,1996,1998,7,2,USA
Karl Tutwiler,1891-08-11,1,1914,1915,8,11,USA
Lane Weston,1989-11-13,4,2014,2018,11,13,USA
Matthew James,1988-08-31,7,2012,2019,8,31,USA
John Michael,1947-09-13,2,1967,1969,9,13,USA
Robert Michael,1948-07-24,6,1972,1978,7,24,USA
Jon Michael,1978-07-29,10,2004,2014,7,29,USA
Charles Dwight,1921-10-07,0,1946,1946,10,7,USA
Reuben Alexander,1878-12-24,0,1905,1905,12,24,USA
Ricky Lee,1959-01-21,3,1982,1985,1,21,USA
Russ Moore,1980-08-30,5,2004,2009,8,30,USA
Ryan Scott,1987-04-21,0,2011,2011,4,21,USA
Earl John,1894-08-26,12,1922,1934,8,26,USA
Spencer Dewey,1898-06-21,4,1923,1927,6,21,USA
Terry Wayne,1973-03-06,10,1995,2005,3,6,USA
James Irvin,1890-09-27,7,1912,1919,9,27,USA
William Edward,1972-10-08,1,1996,1997,10,8,USA
Joseph Wilbur,1927-10-30,16,1950,1966,10,30,USA
Nathan Masler,1988-02-25,4,2011,2015,2,25,USA
Robert Gordon,1925-11-06,3,1950,1953,11,6,USA
James David,1959-08-09,6,1983,1989,8,9,USA
Jim Charles,1985-05-15,6,2013,2019,5,15,CAN
Nicholas James,1986-08-24,1,2008,2009,8,24,USA
Morris Woodrow,1915-09-13,6,1939,1945,9,13,USA
John Dewey,1918-05-11,7,1942,1949,5,11,USA
Richard Earl,1920-03-03,0,1942,1942,3,3,USA
Merle Theron,1872-08-05,1,1902,1903,8,5,USA
Grady Emmett,1897-06-29,1,1928,1929,6,29,USA
John Harry,1874-01-19,0,1895,1895,1,19,USA
Jonathan Scott,1977-08-30,5,2003,2008,8,30,USA
Steven Thomas,1964-10-26,0,1990,1990,10,26,USA
Timothy Max,1987-11-13,1,2016,2017,11,13,USA
David George,1943-07-15,5,1963,1968,7,15,USA
Ehire Enrique,1989-08-21,6,2013,2019,8,21,Venezuela
Michael Troy,1963-09-21,5,1987,1992,9,21,USA
Jeremy David,1979-06-06,13,2002,2015,6,6,USA
Benny Peter,1971-12-28,4,1998,2002,12,28,USA
Tommie Lee,1942-08-09,11,1962,1973,8,9,USA
Harry,1929-04-20,1,1954,1955,4,20,USA
Joseph Abram,1887-06-12,3,1912,1915,6,12,USA
Samuel Lester,1887-04-12,6,1913,1919,4,12,USA
Juan Roberto,1958-02-23,12,1981,1993,2,23,P.R.
Dario Abdiel,1994-12-28,0,2019,2019,12,28,Panama
Luis,1959-03-13,9,1980,1989,3,13,P.R.
Christopher Louis,1979-02-23,4,2004,2008,2,23,USA
Jesus Alexander,1990-06-30,5,2014,2019,6,30,Venezuela
Richard Warren,1961-12-31,15,1985,2000,12,31,USA
Henry John,1931-01-31,15,1955,1970,1,31,USA
Patrick Howard,1969-12-10,0,1995,1995,12,10,USA
Nicholas Mark,1990-03-15,5,2014,2019,3,15,USA
Willie Mays,1954-10-14,8,1977,1985,10,14,USA
Daniel Ray,1959-03-17,2,1979,1981,3,17,USA
Edward Wilbur,1890-02-04,14,1910,1924,2,4,Russia
Kurt Harold,1978-09-09,3,2001,2004,9,9,USA
Raleigh Leonidas,1887-12-05,4,1911,1915,12,5,USA
George Wilson,1890-12-29,0,1912,1912,12,29,USA
John Leckie,1861-08-29,0,1884,1884,8,29,USA
Darrel Wayne,1962-06-12,5,1986,1991,6,12,USA
Jackie Delane,1940-07-13,10,1964,1974,7,13,USA
William G.,1904-12-25,3,1929,1932,12,25,USA
Albert Earl,1887-11-01,0,1912,1912,11,1,USA
Ruben,1991-06-14,0,2019,2019,6,14,USA
Gibson Alberto,1960-01-18,0,1988,1988,1,18,D.R.
Jonathan,1982-10-30,5,2007,2012,10,30,P.R.
Joseph Peter,1933-06-26,0,1958,1958,6,26,USA
Andrew William,1985-10-06,4,2013,2017,10,6,CAN
Francis Burt,1950-05-04,0,1978,1978,5,4,USA
Frederick Joseph,1882-01-14,0,1910,1910,1,14,USA
Hanser Joel,1992-10-17,4,2015,2019,10,17,D.R.
Jose Edgardo,1969-06-29,2,1995,1997,6,29,P.R.
Matthew James,1983-01-20,13,2006,2019,1,20,USA
Ozhaino Jurdy Jiandro,1997-01-07,2,2017,2019,1,7,Curacao
Edward John,1918-10-27,5,1941,1946,10,27,USA
Edward Arthur,1929-02-28,1,1949,1950,2,28,USA
Harold John,1921-06-30,0,1947,1947,6,30,USA
Alberto Jose,1986-06-10,6,2011,2017,6,10,D.R.
Victor,1947-05-12,3,1973,1976,5,12,USA
Jorge Luis,1995-07-28,0,2019,2019,7,28,D.R.
Santo,1952-12-23,1,1976,1977,12,23,D.R.
Arismendy,1991-10-29,3,2014,2017,10,29,D.R.
Israel,1973-05-06,2,2000,2002,5,6,D.R.
Raul,1992-12-04,1,2016,2017,12,4,D.R.
Sandy,1995-09-07,2,2017,2019,9,7,D.R.
Victor Alfonso,1993-04-03,2,2017,2019,4,3,D.R.
Angel Luis,1941-06-20,3,1967,1970,6,20,P.R.
John Forbes,1885-11-29,0,1914,1914,11,29,USA
Dale Leonard,1918-03-09,1,1943,1944,3,9,USA
Michael Peter,1961-01-29,10,1986,1996,1,29,USA
Scott Phillip,1968-06-12,10,1990,2000,6,12,USA
Cory Jerome,1979-06-13,9,2001,2010,6,13,USA
Jay Robert,1961-04-14,3,1987,1990,4,14,USA
Victor,1893-10-25,11,1917,1928,10,25,USA
Charles,1917-02-19,3,1941,1944,2,19,USA
Robert Somerville,1922-08-07,2,1955,1957,8,7,CAN
David Dale,1903-04-26,4,1929,1933,4,26,USA
Doyle Lafayette,1950-09-04,18,1971,1989,9,4,USA
Gary Wayne,1953-03-27,6,1975,1981,3,27,USA
Gerald Paul,1968-03-26,2,1990,1992,3,26,USA
Hugh,1917-07-10,0,1937,1937,7,10,USA
Matthew,1947-01-30,8,1973,1981,1,30,USA
Manuel de Jesus,1971-03-20,14,1992,2006,3,20,D.R.
William Henry,1858-11-24,0,1884,1884,11,24,USA
Grover Cleveland,1887-02-26,19,1911,1930,2,26,USA
Scott Alain,1989-07-10,4,2015,2019,7,10,USA
Tyler John,1994-07-14,0,2019,2019,7,14,USA
Walter Ernest,1891-03-05,5,1912,1917,3,5,USA
Jason,1977-11-29,0,2004,2004,11,29,USA
Jorge Mario,1993-06-11,3,2016,2019,6,11,Colombia
Antonio,1972-04-16,10,1997,2007,4,16,D.R.
Edgardo Antonio,1973-11-08,11,1995,2006,11,8,Venezuela
Eliezer Jesus,1979-02-07,5,2006,2011,2,7,Venezuela
Anthony Joseph,1994-07-20,2,2017,2019,7,20,USA
Luis Rene,1965-07-29,14,1988,2002,7,29,P.R.
Andrew Neal,1961-12-22,9,1986,1995,12,22,USA
Brian Marshall,1958-01-03,2,1979,1981,1,3,USA
Kolby Kenneth,1997-08-13,1,2018,2019,8,13,USA
Austin Michael,1994-01-16,0,2019,2019,1,16,USA
Bernard Keith,1939-04-16,11,1962,1973,4,16,USA
Robert Gilman,1867-07-10,10,1890,1900,7,10,USA
Robert,1894-10-13,0,1919,1919,10,13,USA
Robert Earl,1914-07-02,0,1937,1937,7,2,USA
Robert Gray,1937-10-23,6,1961,1967,10,23,USA
Brandon Durell,1986-02-12,3,2009,2012,2,12,USA
John Chad,1975-02-06,6,1999,2005,2,6,USA
Cody Edward,1988-11-20,7,2012,2019,11,20,USA
Richard Anthony,1942-03-08,14,1963,1977,3,8,USA
Dustin R.,1972-08-09,0,2000,2000,8,9,USA
Ethan Nathan,1904-01-01,12,1926,1938,1,1,USA
Frank Leon,1888-08-26,5,1912,1917,8,26,USA
Gary Martin,1955-02-04,6,1979,1985,2,4,USA
Gregory Lomack,1993-03-15,2,2017,2019,3,15,USA
Frank Erwin,1846-04-20,0,1872,1872,4,20,USA
Harold Andrew,1940-07-23,7,1966,1973,7,23,USA
Hezekiah,1863-02-25,0,1884,1884,2,25,USA
Horace Tanner,1899-06-11,0,1919,1919,6,11,USA
Cyrus Alban,1855-10-02,0,1879,1879,10,2,USA
James Bradley,1958-05-29,0,1983,1983,5,29,USA
Jermaine LaMont,1972-01-11,3,1996,1999,1,11,USA
John Marshall,1890-10-27,0,1914,1914,10,27,USA
John Thomas,1904-09-30,12,1932,1944,9,30,USA
Kim Bryant,1953-04-05,1,1980,1981,4,5,USA
Lloyd Cecil,1950-05-08,6,1969,1975,5,8,USA
Logan Shane,1997-05-23,0,2019,2019,5,23,USA
Lucas Gale,1978-08-04,1,2002,2003,8,4,USA
Myron Smith,1854-03-22,5,1883,1888,3,22,USA
Neil Patrick,1958-01-24,10,1979,1989,1,24,USA
Artemus Ward,1888-09-14,6,1914,1920,9,14,USA
Jesse Hall,1868-05-01,0,1893,1893,5,1,USA
Ronald Frederick,1943-12-23,0,1972,1972,12,23,USA
Roderick Bernet,1959-10-05,5,1983,1988,10,5,USA
Fletcher Manson,1886-08-23,0,1910,1910,8,23,USA
Leonard Eugene,1940-07-10,10,1963,1973,7,10,USA
Robert George,1952-05-01,0,1975,1975,5,1,USA
Gair Roosevelt,1931-10-28,0,1954,1954,10,28,USA
Arthur Algernon,1849-01-29,5,1871,1876,1,29,USA
William,1850-07-16,0,1872,1872,7,16,USA
William Robert,1934-07-11,12,1958,1970,7,11,USA
Dana Eric,1966-08-14,0,1991,1991,8,14,USA
Douglas L.,1846-07-12,12,1871,1883,7,12,USA
Mack Pendleton,1887-01-23,2,1911,1913,1,23,USA
Milo Henry,1890-10-16,4,1913,1917,10,16,USA
Dale LeBeau,1965-06-04,2,1989,1991,6,4,USA
Baldomero Melo,1913-02-07,6,1933,1939,2,7,Mexico
Armando,1972-10-26,6,1999,2005,10,26,USA
Carlos Manuel,1973-11-06,8,1997,2005,11,6,D.R.
Rafael D.,1887-06-30,2,1911,1913,6,30,Cuba
Abraham,1989-06-27,6,2013,2019,6,27,D.R.
William Francis,1952-11-21,14,1974,1988,11,21,USA
Edwin,1976-12-17,0,2003,2003,12,17,D.R.
Erick R.,1978-02-01,10,2001,2011,2,1,D.R.
Hector Radhames,1975-10-17,4,1999,2003,10,17,D.R.
Miguel Emilio,1993-04-04,3,2015,2018,4,4,D.R.
Yency,1994-06-04,1,2018,2019,6,4,USA
Zoilo Manuel,1989-06-10,1,2013,2014,6,10,D.R.
Reinaldo Albert,1994-04-16,3,2016,2019,4,16,USA
Luis,1923-06-19,3,1950,1953,6,19,Cuba
Roberto,1968-02-05,16,1988,2004,2,5,P.R.
Santos,1943-10-19,14,1964,1978,10,19,P.R.
Santos,1966-06-18,19,1988,2007,6,18,P.R.
Peter Morgan,1994-12-07,0,2019,2019,12,7,USA
Yonder,1987-04-08,9,2010,2019,4,8,Cuba
Felipe Rojas,1935-05-12,16,1958,1974,5,12,D.R.
Jesus Maria Rojas,1942-03-24,16,1963,1979,3,24,D.R.
Mateo Rojas,1938-12-22,14,1960,1974,12,22,D.R.
Moises Rojas,1966-07-03,18,1990,2008,7,3,USA
Charles Augustus,1879-11-10,3,1906,1909,11,10,USA
Wendell,1952-09-22,3,1977,1980,9,22,USA
Garvin James,1971-12-08,0,1996,1996,12,8,USA
Thomas Edison,1926-01-31,3,1954,1957,1,31,USA
Walter Emmons,1911-12-01,0,1936,1936,12,1,USA
Porfirio,1952-05-17,2,1982,1984,5,17,Nicaragua
Daniel,1992-09-08,3,2016,2019,9,8,USA
Ernest Matthias,1894-12-01,0,1920,1920,12,1,USA
Jesse Howard,1893-01-02,1,1916,1917,1,2,USA
Aaron Samuel,1991-01-14,5,2014,2019,1,14,Germany
David Tilden,1876-11-06,5,1906,1911,11,6,USA
George Lee,1933-03-20,8,1959,1967,3,20,USA
Joseph Salvatore,1932-05-26,6,1955,1961,5,26,USA
Nicholas,1876-09-15,35,1898,1933,9,15,USA
Jose Carlos,1990-05-06,8,2011,2019,5,6,Venezuela
George Joseph,1935-02-11,6,1958,1964,2,11,USA
Abraham,1982-10-17,2,2004,2006,10,17,USA
Clemente Rafael,1968-05-18,0,2000,2000,5,18,Venezuela
Dario Rafael,1989-01-17,3,2014,2017,1,17,D.R.
Dariel,1988-11-07,1,2015,2016,11,7,Cuba
Gabriel de Jesus,1974-03-06,2,1998,2000,3,6,Mexico
Henderson Javier,1990-04-18,6,2011,2017,4,18,Venezuela
Jose Lino,1956-04-12,8,1981,1989,4,12,USA
Jose Ricardo,1989-05-06,6,2013,2019,5,6,Venezuela
Jose Antonio,1995-05-21,2,2017,2019,5,21,Venezuela
Juan M.,1973-08-09,4,1999,2003,8,9,USA
Luis Cesar,1949-01-15,9,1968,1977,1,15,P.R.
Jesus Manuel Orlando,1952-02-28,3,1973,1976,2,28,P.R.
Oswaldo,1933-10-19,1,1958,1959,10,19,Cuba
Pedro Manuel,1987-02-06,8,2010,2018,2,6,D.R.
Roy Emilio,1991-06-08,1,2014,2015,6,8,USA
Rogelio,1938-04-18,2,1960,1962,4,18,Cuba
Cesar Octavio,1971-11-25,1,1995,1996,11,25,Mexico
Antonio Enrique,1979-05-10,2,2002,2004,5,10,Venezuela
Victor Aurelio,1976-11-08,1,2002,2003,11,8,Mexico
Wilson Eduardo,1970-03-24,16,1989,2005,3,24,Venezuela
Yordan Ruben,1997-06-27,0,2019,2019,6,27,Cuba
Roy Maxwell,1938-02-02,8,1962,1970,2,2,USA
William Crawford,1863-08-10,8,1885,1893,8,10,USA
Garrabrant Ryerson,1940-12-08,7,1965,1972,12,8,USA
Adbert Marcelo,1995-03-01,0,2019,2019,3,1,Venezuela
John Joseph,1934-01-23,13,1954,1967,1,23,USA
Richard Louis,1962-04-01,9,1991,2000,4,1,USA
Alexi Jose,1989-04-06,6,2011,2017,4,6,Venezuela
Ruben,1936-01-06,11,1958,1969,1,6,Mexico
Ruben,1965-02-12,7,1991,1998,2,12,USA
Wayne Harper,1915-11-08,2,1937,1939,11,8,USA
Raymond Payne,1979-12-19,3,2005,2008,12,19,USA
Hector,1984-05-24,4,2010,2014,5,24,USA
Edward Allen,1959-04-13,2,1984,1986,4,13,USA
Leon Kessling,1882-08-02,16,1903,1919,8,2,USA
Steven C.,1988-03-15,0,2013,2013,3,15,USA
Alfredo,1978-01-16,9,2002,2011,1,16,Mexico
Morris F.,1874-01-01,1,1897,1898,1,1,USA
Edmundo,1930-01-30,8,1952,1960,1,30,Cuba
Vicente,1932-08-08,2,1955,1957,8,8,Cuba
Walter,1893-04-10,0,1915,1915,4,10,USA
Alfred Walton,1914-01-28,5,1941,1946,1,28,USA
Allan Lee,1964-01-07,5,1986,1991,1,7,USA
Andy Holm,1922-11-13,1,1948,1949,11,13,USA
William Edward,1895-11-28,0,1925,1925,11,28,USA
Robert Carl,1935-09-29,6,1957,1963,9,29,USA
Brady Kevin,1964-01-18,14,1988,2002,1,18,USA
Brian James,1972-04-26,12,1993,2005,4,26,USA
Brian Nikola,1982-03-11,4,2005,2009,3,11,USA
Brett Franklin,1988-02-01,10,2009,2019,2,1,USA
Bryan Douglas,1986-12-16,5,2010,2015,12,16,USA
Brian Wade,1993-05-19,2,2017,2019,5,19,USA
Karl Adam,1956-05-27,1,1982,1983,5,27,USA
Robert Chase,1987-11-30,5,2014,2019,11,30,USA
Cody Andrew,1990-09-14,4,2015,2019,9,14,USA
Norman Craig,1938-07-01,3,1961,1964,7,1,USA
David S.,1868-10-10,1,1889,1890,10,10,USA
David Carter,1960-08-01,9,1983,1992,8,1,USA
Drew Thomas,1981-06-09,0,2006,2006,6,9,USA
Andrew James,1994-03-22,2,2017,2019,3,22,USA
Dwain Cleaven,1947-11-23,3,1971,1974,11,23,USA
Ferrell Jack,1918-01-09,7,1946,1953,1,9,USA
John Frederick,1885-12-11,9,1909,1918,12,11,USA
Garret Joseph,1972-06-30,16,1994,2010,6,30,USA
George Jendrus,1889-09-26,4,1914,1918,9,26,USA
Edward John,1880-01-13,0,1907,1907,1,13,USA
Harold,1904-02-10,0,1932,1932,2,10,USA
Harry Walter,1931-09-10,4,1957,1961,9,10,USA
Jason Roger,1979-06-09,2,2003,2005,6,9,USA
James Lea,1957-02-23,6,1978,1984,2,23,USA
James Drew,1976-01-22,5,1999,2004,1,22,USA
John Joseph,1873-12-14,14,1894,1908,12,14,Norway
John Charles,1929-11-23,4,1958,1962,11,23,USA
Joshua Aaron,1982-08-10,2,2007,2009,8,10,USA
Justin Charles,1992-09-28,1,2018,2019,9,28,USA
Kent McKay,1963-08-12,1,1989,1990,8,12,USA
Lawrence Dennis,1952-12-03,3,1974,1977,12,3,USA
Larry Eugene,1953-05-06,19,1975,1994,5,6,USA
Lars Eric,1987-09-25,2,2010,2012,9,25,USA
Matthew Jason,1976-08-17,7,1998,2005,8,17,USA
Marlon Ordell,1974-01-06,11,1998,2009,1,6,USA
Michael Allen,1951-06-22,8,1971,1979,6,22,USA
Michael James,1966-07-30,0,1993,1993,7,30,USA
Nick Paul,1990-07-05,0,2019,2019,7,5,USA
Arnold Revola,1912-06-19,4,1937,1941,6,19,USA
Richard Lee,1953-12-25,1,1979,1980,12,25,USA
Richard Arlen,1956-11-29,2,1986,1988,11,29,USA
Scott Richard,1962-08-01,8,1987,1995,8,1,USA
Shaun,1994-10-29,0,2019,2019,10,29,USA
George Lee,1934-02-22,0,1959,1959,2,22,USA
Tanner Ackley,1993-05-27,1,2018,2019,5,27,USA
Timothy Devon,1993-06-23,3,2016,2019,6,23,USA
Tyler John,1989-12-30,3,2016,2019,12,30,USA
Warner Samuel,1866-06-18,7,1889,1896,6,18,USA
Walter Carl,1897-09-25,2,1917,1919,9,25,USA
Wingo Charlie,1886-08-13,0,1910,1910,8,13,USA
Robert Lazaro,1984-04-25,11,2005,2016,4,25,USA
Stephen Michael,1978-02-06,0,2006,2006,2,6,USA
Clayton John,1978-05-15,0,2000,2000,5,15,USA
George Edward,1859-04-05,7,1884,1891,4,5,USA
Elbert DeVore,1901-12-11,0,1925,1925,12,11,USA
Ernest Henry,1918-01-11,0,1946,1946,1,11,USA
Fred,1952-05-04,1,1976,1977,5,4,USA
Hubert Carl,1922-08-31,1,1947,1948,8,31,USA
Ivy Paul,1907-05-06,7,1931,1938,5,6,USA
James Pratt,1865-06-05,0,1890,1890,6,5,USA
John Edward,1923-01-03,0,1955,1955,1,3,USA
John Richard,1949-02-09,0,1973,1973,2,9,USA
John Francis,1990-06-09,0,2018,2018,6,9,USA
Kim Darrell,1953-11-14,0,1975,1975,11,14,USA
Michael Jay,1943-07-09,7,1966,1973,7,9,USA
Nathan Hardy,1913-09-30,9,1937,1946,9,30,USA
Robert Patrick,1952-12-11,4,1975,1979,12,11,USA
Darrell Shane,1971-08-28,7,1995,2002,8,28,USA
Stanley Joseph,1917-04-17,6,1939,1945,4,17,USA
William Walter,1859-09-18,4,1884,1888,9,18,USA
Matthew Lee,1989-08-28,4,2015,2019,8,28,USA
William Morgan,1907-07-25,6,1931,1937,7,25,USA
Elvis Augusto,1988-08-26,10,2009,2019,8,26,Venezuela
Frederick Hotham,1850-08-23,8,1876,1884,8,23,USA
William Wiman,1858-10-14,0,1885,1885,10,14,CAN
Joaquin,1952-12-21,12,1976,1988,12,21,D.R.
Luis,1972-11-22,3,1995,1998,11,22,D.R.
Miguel Enrique,1995-03-02,2,2017,2019,3,2,D.R.
Norman Stanley,1947-09-24,1,1972,1973,9,24,USA
Matthew Ryan,1985-09-10,0,2011,2011,9,10,USA
Thomas Samuel,1904-10-02,0,1929,1929,10,2,USA
Frederick Norman,1912-12-23,8,1936,1944,12,23,USA
Richard Alexander,1979-07-19,14,1999,2013,7,19,USA
Dean William,1986-11-24,1,2014,2015,11,24,USA
William Perley,1857-05-24,0,1884,1884,5,24,USA
Adrian Constantine,1852-04-17,26,1871,1897,4,17,USA
Eric Todd,1967-11-08,8,1989,1997,11,8,USA
Dustin Kamakana Mai Ku'u Makualani,1989-08-09,0,2016,2016,8,9,USA
Joseph,1916-04-11,0,1944,1944,4,11,USA
William James,1927-05-19,0,1953,1953,5,19,USA
John Lawrence,1915-07-15,1,1944,1945,7,15,USA
John August,1930-04-12,13,1948,1961,4,12,USA
Matthew Antonio,1985-04-08,0,2008,2008,4,8,USA
Norichika,1982-01-05,5,2012,2017,1,5,Japan
Luis Ernesto,1934-04-29,17,1956,1973,4,29,Venezuela
Robert John,1950-01-31,4,1973,1977,1,31,USA
Luis Eduardo,1953-06-14,4,1980,1984,6,14,Venezuela
Robert Kevin,1967-12-06,15,1989,2004,12,6,USA
Edward Samuel,1892-02-29,1,1915,1916,2,29,USA
Frederick Romaine,1879-05-09,0,1904,1904,5,9,USA
Peter William,1904-05-20,18,1927,1945,5,20,USA
Lucius Benjamin,1907-04-02,20,1930,1950,4,2,USA
Aristides,1994-04-22,1,2018,2019,4,22,D.R.
Gregori Emilio,1978-01-11,5,2004,2009,1,11,D.R.
Jayson Julio,1992-11-22,1,2016,2017,11,22,D.R.
Luis Antonio,1964-05-19,9,1986,1995,5,19,P.R.
Angel,1890-08-02,3,1914,1917,8,2,Cuba
Angel Valdes,1915-11-20,0,1941,1941,11,20,Cuba
Victor Teodoro,1995-02-07,2,2017,2019,2,7,Mexico
Elvis Alejandro,1991-07-15,1,2015,2016,7,15,Venezuela
Pedro,1993-07-02,1,2018,2019,7,2,D.R.
Maurice John,1898-12-14,2,1923,1925,12,14,USA
Christopher Alan,1988-09-26,7,2012,2019,9,26,USA
Frederick Marvin,1910-03-07,1,1936,1937,3,7,USA
James Patrick,1883-05-13,14,1904,1918,5,13,Ireland
James William,1932-05-25,1,1961,1962,5,25,USA
George Albert,1914-04-27,8,1938,1946,4,27,USA
Francisco Antonio,1989-09-14,0,2018,2018,9,14,Venezuela
Jose Raimundo,1943-08-22,2,1968,1970,8,22,Cuba
Orlando Jesus,1994-08-04,3,2016,2019,8,4,Venezuela
Oswaldo Celestino,1991-05-09,3,2013,2016,5,9,Venezuela
Daniel Miers,1941-05-27,0,1961,1961,5,27,USA
Rinaldo Joseph,1919-11-20,0,1947,1947,11,20,Italy
Joseph A.,1858-02-27,6,1884,1890,2,27,USA
Daniel Wayne,1974-07-08,8,2000,2008,7,8,USA
Frank Julian,1882-01-28,2,1908,1910,1,28,USA
Nolan James,1991-04-16,6,2013,2019,4,16,USA
Jonathan Paul,1986-01-05,5,2010,2015,1,5,USA
Henry Irven,1922-01-28,4,1948,1952,1,28,USA
Alejandro,1967-11-20,10,1992,2002,11,20,USA
Alberto A.,1983-10-14,2,2007,2009,10,14,D.R.
George Alberto,1972-03-12,3,1996,1999,3,12,USA
Joaquin,1984-09-21,9,2006,2015,9,21,D.R.
Rodolfo,1931-06-06,0,1959,1959,6,6,Cuba
Russell Loris,1899-01-03,0,1931,1931,1,3,USA
Donald Louis,1943-02-15,1,1965,1966,2,15,USA
Stephen Ralph,1945-09-25,5,1969,1974,9,25,USA
Marcos Rafael,1969-08-05,0,1993,1993,8,5,Venezuela
Antonio Rafael,1953-07-02,13,1976,1989,7,2,Venezuela
Antonio Jose,1978-04-29,9,1999,2008,4,29,Venezuela
Charles Anthony,1880-08-30,2,1905,1907,8,30,USA
Edison Rosanda,1948-07-04,4,1973,1977,7,4,Bahamas
Harry Gregory,1882-03-20,0,1906,1906,3,20,USA
Orville Martin,1908-03-02,0,1934,1934,3,2,USA
Rogelio,1994-06-30,0,2019,2019,6,30,Cuba
William Reginald,1869-09-03,NA,NA,NA,9,3,USA
Robert Livingston,1850-07-04,0,1871,1871,7,4,USA
Noble George,1924-06-03,0,1946,1946,6,3,USA
Howard Elmer,1889-12-02,0,1911,1911,12,2,USA
Jack William,1965-03-07,6,1988,1994,3,7,USA
Michael Dennis,1954-03-07,7,1980,1987,3,7,USA
Shawn Michael,1990-09-11,4,2015,2019,9,11,USA
Harry John,1879-02-12,5,1902,1907,2,12,USA
Larry Wayne,1963-02-25,0,1989,1989,2,25,USA
Willis S.,1851-03-02,0,1872,1872,3,2,USA
Christopher Paul,1947-11-06,5,1971,1976,11,6,USA
James Lee,1974-03-24,1,1999,2000,3,24,USA
Scott Gentry,1962-08-18,0,1988,1988,8,18,USA
Tony Dale,1959-05-03,1,1986,1987,5,3,USA
Morris,1910-11-16,10,1936,1946,11,16,USA
Bradley James,1963-08-20,6,1986,1992,8,20,USA
Orie Edgar,1909-10-18,0,1943,1943,10,18,USA
Rene,1964-02-24,4,1993,1997,2,24,Cuba
Jonathan Arturo,1990-10-10,1,2015,2016,10,10,D.R.
Randy,1995-02-28,0,2019,2019,2,28,Cuba
Luis Sangel,1997-04-09,0,2019,2019,4,9,Venezuela
Jose Juan,1984-03-12,4,2008,2012,3,12,D.R.
Jacob Joseph,1986-03-06,9,2010,2019,3,6,USA
Gerald William,1941-06-12,9,1961,1970,6,12,USA
Luis Rolando,1965-07-18,4,1998,2002,7,18,Cuba
Bronson Anthony,1977-02-24,17,2000,2017,2,24,USA
Christian Israel,1995-05-30,2,2017,2019,5,30,USA
Fernando,1952-03-21,11,1975,1986,3,21,USA
Luis Enrique,1927-02-18,8,1955,1963,2,18,P.R.
Rudolph,1950-06-19,0,1971,1971,6,19,USA
Barbaro Erisbel,1990-03-25,0,2014,2014,3,25,Cuba
Humberto Jose,1994-01-23,0,2019,2019,1,23,Venezuela
Harry,1855-02-08,9,1875,1884,2,8,USA
John Thomas,1862-06-30,6,1882,1888,6,30,USA
Randall Carl,1962-10-20,0,1986,1986,10,20,USA
James Marion,1914-06-22,0,1938,1938,6,22,USA
Robert Anthony,1909-06-19,4,1928,1932,6,19,USA
Jose Eleazar,1985-05-02,4,2007,2011,5,2,Venezuela
Cody James,1990-06-30,4,2013,2017,6,30,USA
Miguel,1980-09-29,4,2002,2006,9,29,D.R.
Don Richard,1927-03-19,14,1948,1962,3,19,USA
Alan Dean,1951-07-08,16,1973,1989,7,8,USA
Andrew Jason,1967-07-11,13,1991,2004,7,11,USA
Alec Edward,1991-10-04,3,2015,2018,10,4,USA
Thomas Steven,1954-12-04,8,1976,1984,12,4,USA
Kenneth Lowther,1901-09-16,5,1925,1930,9,16,USA
Billy Manual,1970-07-11,6,1992,1998,7,11,USA
Nevin Robert,1984-08-14,0,2015,2015,8,14,USA
Thomas William,1878-09-26,0,1907,1907,9,26,USA
Robert Thomas,1938-06-19,15,1956,1971,6,19,USA
Kenneth Joseph,1931-09-22,6,1957,1963,9,22,USA
Brian Hanly,1953-09-23,5,1976,1981,9,23,USA
Paul Andre,1960-12-10,13,1986,1999,12,10,USA
Ezequiel F.,1979-11-04,1,2005,2006,11,4,D.R.
Pedro Julio,1968-11-28,14,1992,2006,11,28,D.R.
Barrett,1991-10-22,0,2017,2017,10,22,USA
Joseph Henry,1922-09-01,11,1945,1956,9,1,USA
Willians Jose,1991-10-14,1,2018,2019,10,14,Venezuela
Carlos A.,1991-11-02,2,2016,2018,11,2,Venezuela
Scott Barham,1976-03-29,11,2004,2015,3,29,USA
Justin Scott,1973-09-05,0,2001,2001,9,5,USA
Charles Morgan Herbert,1873-11-19,0,1899,1899,11,19,USA
Keith Rowe,1959-02-19,6,1983,1989,2,19,USA
Luis A.,1985-05-10,0,2010,2010,5,10,P.R.
Albert Wright,1861-03-09,3,1884,1887,3,9,USA
William Cecil Glenn,1954-10-04,3,1976,1979,10,4,CAN
Garrett Bernard,1979-12-12,7,2003,2010,12,12,USA
James Curtis,1921-03-10,2,1950,1952,3,10,USA
Hubert Burley,1904-06-04,0,1927,1927,6,4,USA
Mitchell Shane,1985-10-01,2,2009,2011,10,1,USA
Francis Montgomery,1887-12-09,1,1909,1910,12,9,USA
Richard Gilbert,1897-04-08,1,1926,1927,4,8,USA
Maurice Dailey,1924-03-08,4,1952,1956,3,8,USA
William Franklin,1911-09-25,4,1936,1940,9,25,USA
Jacob Henry,1879-07-01,7,1902,1909,7,1,USA
Harry Herbert,1881-07-05,0,1903,1903,7,5,USA
Robert Michael,1982-04-15,1,2008,2009,4,15,USA
Derek Alfred,1970-03-27,0,1996,1996,3,27,CAN
Richard Thomas,1971-07-13,3,1993,1996,7,13,USA
Frederick Steven,1950-02-15,10,1971,1981,2,15,USA
Bryan Christopher,1986-07-11,2,2009,2011,7,11,USA
David Ralph,1949-11-28,1,1973,1974,11,28,USA
Donald Glenn,1963-07-03,3,1988,1991,7,3,USA
Gerald Lee,1952-07-24,9,1975,1984,7,24,USA
Elden LeRoy,1910-09-21,9,1933,1942,9,21,USA
Leycester Doyle,1920-12-28,0,1947,1947,12,28,USA
Douglas Reagan,1950-03-09,4,1976,1980,3,9,USA
Phillippe,1989-01-07,3,2012,2015,1,7,CAN
Richard Santo,1971-09-02,14,1995,2009,9,2,USA
Joseph John,1965-12-09,1,1994,1995,12,9,USA
Bradley David,1969-04-14,17,1993,2010,4,14,USA
Dennis Kay,1940-11-25,1,1965,1966,11,25,USA
Jeffrey Wellington,1976-10-19,2,2001,2003,10,19,USA
James Philip,1879-12-08,20,1909,1929,12,8,United Kingdom
James Parker,1963-12-07,2,1991,1993,12,7,USA
Rick Gerald,1946-10-27,6,1970,1976,10,27,USA
Christopher Tyler,1991-09-06,3,2016,2019,9,6,USA
Albert,1952-02-29,0,1976,1976,2,29,USA
William Askew,1885-01-02,2,1907,1909,1,2,USA
Martin Gordon,1903-03-05,6,1924,1930,3,5,USA
Abiatal,1995-02-14,1,2018,2019,2,14,D.R.
David Bruce,1972-03-04,5,1997,2002,3,4,USA
Howard Earl,1902-05-21,12,1929,1941,5,21,USA
Earl Douglas,1931-09-09,7,1956,1963,9,9,USA
Steven Thomas,1970-04-14,13,1990,2003,4,14,USA
Xavier Tyrone,1990-01-01,0,2012,2012,1,1,USA
Alexander Thomas,1987-01-29,10,2009,2019,1,29,USA
Roberto Francisco,1924-04-02,10,1949,1959,4,2,Mexico
Luis Armando,1989-07-19,7,2012,2019,7,19,Venezuela
Pedro Manuel,1997-01-14,0,2019,2019,1,14,Venezuela
Michael Anthony,1981-03-13,9,2008,2017,3,13,USA
Ramon Antonio,1952-01-22,4,1977,1981,1,22,P.R.
James Epherium,1920-07-06,0,1950,1950,7,6,USA
Dylan Davis Haines,1985-07-30,4,2011,2015,7,30,USA
John Berton,1983-04-01,9,2009,2018,4,1,CAN
Benigno,1951-02-07,11,1974,1985,2,7,P.R.
Robert Joseph,1969-07-08,7,1992,1999,7,8,USA
Luis Ignacio,1978-01-12,10,2003,2013,1,12,Mexico
Erick Johan,1984-01-14,11,2006,2017,1,14,D.R.
Manuel Antonio,1972-05-04,8,1997,2005,5,4,D.R.
Willy Del Jesus,1983-03-09,5,2005,2010,3,9,D.R.
Jacob Stuart,1861-07-06,2,1884,1886,7,6,USA
William Oscar,1919-09-27,0,1947,1947,9,27,USA
Yancey Wyatt,1891-05-21,8,1913,1921,5,21,USA
Richard John,1925-06-04,0,1953,1953,6,4,USA
Robert Cunningham,1966-04-27,1,1992,1993,4,27,USA
Joseph Allen,1971-10-08,0,1996,1996,10,8,USA
Jose Joaquin,1939-08-18,12,1960,1972,8,18,Cuba
Oscar Gregorio,1965-02-21,2,1990,1992,2,21,Venezuela
Charles Amos,1873-02-20,2,1903,1905,2,20,USA
Robert Ernest,1949-08-25,2,1979,1981,8,25,USA
Loren Rolland,1928-01-11,1,1952,1953,1,11,USA
John Charles,1913-05-14,7,1934,1941,5,14,USA
Charles Percy,1895-05-04,0,1915,1915,5,4,USA
Mack Neal,1959-03-09,0,1981,1981,3,9,USA
Brandon Allen,1978-04-05,7,2002,2009,4,5,USA
Lester John,1888-03-20,1,1909,1910,3,20,USA
Walter Wayne,1959-09-22,13,1980,1993,9,22,USA
Edgar Suter,1895-04-08,0,1917,1917,4,8,USA
Michael James,1952-04-01,5,1975,1980,4,1,USA
Michael Joseph,1977-11-11,6,2001,2007,11,11,USA
Frederic John,1926-05-15,2,1953,1955,5,15,USA
Burke Heinrich,1983-02-08,7,2008,2015,2,8,USA
Arthur Herman,1886-09-21,0,1904,1904,9,21,USA
Harrison Joseph,1994-06-03,2,2017,2019,6,3,USA
Lore Verne,1888-04-27,6,1912,1918,4,27,USA
Morris Hiram,1902-12-01,1,1929,1930,12,1,USA
Edward Joseph,1907-05-15,11,1926,1937,5,15,USA
Cha-Seung,1980-05-29,4,2004,2008,5,29,South Korea
Carlos Obed,1968-11-04,15,1990,2005,11,4,P.R.
Benito,1977-05-06,0,2001,2001,5,6,D.R.
Danys G.,1977-09-10,10,2001,2011,9,10,Cuba
Ednel Javier,1992-12-01,5,2014,2019,12,1,P.R.
Jose Antonio,1953-12-31,1,1977,1978,12,31,D.R.
Kevin Richard,1967-01-10,3,1990,1993,1,10,USA
Michel,1996-01-21,0,2019,2019,1,21,Cuba
Pedro Alberys,1988-03-11,5,2014,2019,3,11,D.R.
Sandy,1993-11-25,1,2018,2019,11,25,D.R.
James Charles Jacob,1889-10-05,11,1912,1923,10,5,USA
James Charles Jacob,1916-09-08,9,1938,1947,9,8,USA
William Mallory,1895-02-24,2,1923,1925,2,24,USA
Jeffrey Robert,1968-05-27,14,1991,2005,5,27,USA
Stanley Raymond,1944-12-15,16,1966,1982,12,15,USA
Edson Garfield,1919-10-16,1,1946,1947,10,16,CAN
Grover Cleveland,1889-12-10,0,1914,1914,12,10,USA
Andrew Scott,1984-05-31,8,2009,2017,5,31,USA
William F.,1888-04-12,15,1907,1922,4,12,USA
Harry Lewis,1881-11-19,0,1911,1911,11,19,USA
Robert Sherwood,1942-10-13,16,1962,1978,10,13,USA
Philip Cory,1971-01-24,9,1993,2002,1,24,USA
Lonas Edgar,1931-04-15,13,1953,1966,4,15,USA
Frederick Middleton,1895-08-16,2,1916,1918,8,16,USA
Arthur Eugene,1893-11-25,7,1917,1924,11,25,USA
Harvey Francis,1876-11-24,1,1899,1900,11,24,USA
Howard Lee,1957-07-31,2,1981,1983,7,31,USA
David Dewitt,1986-05-03,12,2007,2019,5,3,USA
Jeffrey Todd,1978-11-19,2,2007,2009,11,19,USA
James Hopkins,1934-12-16,0,1959,1959,12,16,USA
Linwood Clifton,1869-11-22,0,1895,1895,11,22,USA
John Mark,1961-11-04,8,1984,1992,11,4,USA
Charles Roger,1970-10-03,2,1995,1997,10,3,USA
Scott Alan,1961-12-18,12,1986,1998,12,18,USA
Steven John,1942-02-12,1,1967,1968,2,12,USA
Abraham Lincoln,1895-02-12,2,1919,1921,2,12,USA
Robert Michael,1951-07-10,10,1975,1985,7,10,USA
Harold Douglas,1959-03-15,21,1980,2001,3,15,USA
Herbert Loren,1922-07-04,0,1945,1945,7,4,USA
Albert Wells,1895-06-02,2,1917,1919,6,2,USA
Robert Allen,1940-01-16,1,1962,1963,1,16,USA
Howard Douglas,1891-09-27,5,1915,1920,9,27,USA
Charles Douglas,1949-08-22,14,1976,1990,8,22,USA
Jeffrey Scot,1982-12-19,0,2008,2008,12,19,USA
Jeffrey Michael,1978-03-21,2,2004,2006,3,21,USA
Edward Enoch,1864-04-17,8,1883,1891,4,17,USA
David Lee,1945-03-05,0,1964,1964,3,5,USA
Albert Jones,1906-02-28,0,1938,1938,2,28,USA
William Presley,1911-02-22,9,1940,1949,2,22,USA
Charles,1878-07-17,0,1901,1901,7,17,USA
Charles Arthur,1856-01-15,0,1884,1884,1,15,USA
Charles Joseph,1952-12-06,3,1978,1981,12,6,USA
David Glenn,1956-11-25,0,1982,1982,11,25,USA
Delmer David,1892-05-03,2,1914,1916,5,3,USA
Douglas Lee,1961-04-03,6,1984,1990,4,3,USA
Johnnie B.,1949-06-15,18,1968,1986,6,15,USA
Earnest Gould,1875-08-08,0,1905,1905,8,8,USA
Floyd Wilton,1916-10-10,12,1943,1955,10,10,USA
John Franklin,1886-03-13,14,1908,1922,3,13,USA
Frank,1944-01-11,2,1969,1971,1,11,USA
Frank Watts,1946-10-29,4,1970,1974,10,29,USA
George F.,1857-08-20,3,1883,1886,8,20,USA
Eugene Walter,1925-06-15,8,1953,1961,6,15,USA
Howard Francis,1888-03-01,3,1912,1915,3,1,USA
Jack Edward,1950-05-04,1,1976,1977,5,4,USA
Jesse Ormond,1888-06-03,0,1911,1911,6,3,USA
Jesse,1895-03-04,0,1919,1919,3,4,USA
Jeffrey Glen,1981-06-21,10,2005,2015,6,21,Germany
John David,1981-01-20,6,2008,2014,1,20,USA
Kirtley,1869-06-24,9,1890,1899,6,24,USA
Neal Vernon,1904-04-30,0,1927,1927,4,30,USA
Norman Leslie,1862-10-14,7,1883,1890,10,14,USA
Philip,1856-09-19,3,1883,1886,9,19,USA
Scott,1970-05-18,0,1995,1995,5,18,USA
Timothy Scott,1981-09-19,10,2005,2015,9,19,USA
Steven Byrne,1956-08-30,5,1978,1983,8,30,USA
Thomas Calvin,1913-06-11,3,1935,1938,6,11,USA
Thomas Henry,1934-05-06,0,1963,1963,5,6,USA
Trace Lee,1891-11-07,0,1911,1911,11,7,USA
Gabor Paul,1972-06-20,11,1998,2009,6,20,USA
Mitchell Francis,1910-05-09,0,1938,1938,5,9,USA
John Lawrence,1950-11-24,1,1974,1975,11,24,CAN
Stephen Charles,1957-01-16,12,1981,1993,1,16,USA
Robert Rudolph,1925-08-01,0,1956,1956,8,1,USA
Rocco Dan,1981-09-25,7,2003,2010,9,25,USA
Jack Edward,1936-10-16,9,1961,1970,10,16,USA
Robert Harvey,1948-06-09,1,1975,1976,6,9,USA
David George,1938-03-30,7,1966,1973,3,30,USA
Frank DeWitt,1928-12-25,0,1953,1953,12,25,USA
Howard Edward,1900-06-03,1,1924,1925,6,3,USA
Henry Clay,1894-06-13,0,1927,1927,6,13,USA
James,1971-07-15,10,1995,2005,7,15,USA
Jeffrey Allen,1965-09-05,0,1990,1990,9,5,USA
Clarence Geoghan,1864-11-01,6,1884,1890,11,1,USA
Charles B.,1859-04-08,6,1884,1890,4,8,USA
Marcus Elmore,1863-10-29,6,1887,1893,10,29,USA
Orson Frederick,1881-11-03,0,1908,1908,11,3,USA
Reginald Conrad,1954-08-19,1,1978,1979,8,19,USA
Rickey Alan,1953-06-01,2,1975,1977,6,1,USA
John Robert,1974-05-22,10,1999,2009,5,22,USA
Michael Richard,1886-07-03,2,1911,1913,7,3,USA
Wladimir Ramon,1984-07-02,2,2007,2009,7,2,Curacao
Collin Thomas,1986-06-06,7,2008,2015,6,6,USA
Wesley Owen,1944-12-04,1,1966,1967,12,4,USA
Grant Robert,1977-12-30,14,2001,2015,12,30,Australia
Jeffrey Scott,1963-08-13,7,1987,1994,8,13,USA
Jay Scott,1960-10-06,10,1982,1992,10,6,USA
Pelham Ashby,1894-02-06,0,1928,1928,2,6,USA
Mark Alan,1949-01-31,0,1971,1971,1,31,USA
Jeffery D.,1969-04-17,0,1998,1998,4,17,USA
James Chandler,1884-02-22,1,1907,1908,2,22,USA
Cornelius,1881-04-22,6,1907,1913,4,22,USA
Noble Winfred,1897-11-30,4,1925,1929,11,30,USA
Anthony Fred,1937-11-21,0,1962,1962,11,21,USA
George Irvin,1923-08-01,8,1951,1959,8,1,USA
Harold Earl,1924-10-29,0,1948,1948,10,29,USA
David James,1891-04-20,15,1915,1930,4,20,USA
Frank Carter,1846-05-09,NA,NA,NA,5,9,USA
Frank Anthony,1993-08-10,2,2017,2019,8,10,USA
Christopher Michael,1956-02-04,8,1981,1989,2,4,USA
Salvatore Leonard,1944-02-13,15,1966,1981,2,13,USA
Jett Adam,1990-03-26,3,2015,2018,3,26,USA
Edward Norman,1952-03-22,3,1973,1976,3,22,USA
Richard Lee,1946-11-01,5,1969,1974,11,1,USA
Jeffery Todd,1964-01-15,0,1991,1991,1,15,USA
Daniel Robert,1920-05-03,4,1947,1951,5,3,USA
Michael Scott,1963-07-31,9,1986,1995,7,31,USA
William John,1874-02-26,1,1895,1896,2,26,USA
Brian Glen,1970-09-28,7,1996,2003,9,28,USA
Ernest,1931-01-31,18,1953,1971,1,31,USA
Wilborn Everett,1893-05-25,0,1915,1915,5,25,USA
George Edward,1938-09-24,4,1962,1966,9,24,USA
Joshua Charles,1982-07-18,3,2007,2010,7,18,USA
Wesley Wade,1983-11-23,0,2008,2008,11,23,USA
Willie Anthony,1969-02-27,11,1991,2002,2,27,USA
Alan,1951-09-03,11,1974,1985,9,3,USA
Brian Patrick,1981-02-28,4,2006,2010,2,28,USA
Floyd Franklin,1955-06-10,15,1977,1992,6,10,USA
James M.,1865-06-11,1,1888,1889,6,11,USA
James Henry,1871-05-05,3,1893,1896,5,5,USA
Thomas Edward,1869-05-08,1,1895,1896,5,8,USA
Jackie Kay,1925-06-24,3,1947,1950,6,24,USA
Brandon,1987-01-07,0,2013,2013,1,7,USA
Manuel,1991-03-13,4,2015,2019,3,13,Mexico
Travis Steven,1971-12-30,0,1998,1998,12,30,USA
Rodrigo Richard,1975-09-05,13,1999,2012,9,5,USA
John Edward,1992-07-11,2,2016,2018,7,11,USA
Donald Odell,1920-06-20,0,1943,1943,6,20,USA
Walter Lawrence,1891-08-11,8,1914,1922,8,11,USA
Bret Edward,1967-08-16,5,1991,1996,8,16,USA
Brian Scott,1973-03-04,4,1995,1999,3,4,USA
David Monroe,1905-05-07,6,1926,1932,5,7,USA
Frank Frederick,1882-02-03,3,1907,1910,2,3,USA
William Joseph,1882-06-10,5,1905,1910,6,10,USA
Stephen David,1938-02-22,14,1960,1974,2,22,USA
Steven Lee,1948-03-13,1,1970,1971,3,13,USA
Tyrus Turner,1893-07-09,8,1915,1923,7,9,USA
James Patrick,1941-09-15,0,1966,1966,9,15,USA
Lorenzo Antonio,1977-08-10,2,2000,2002,8,10,D.R.
Curtis Cordell,1931-08-22,2,1957,1959,8,22,USA
George Oliver,1876-05-16,3,1902,1905,5,16,USA
Daniel Paul,1985-06-25,4,2009,2013,6,25,USA
Brian David,1981-04-02,3,2007,2010,4,2,USA
Joshua David,1978-03-30,9,2002,2011,3,30,USA
Luke Francis,1990-11-13,1,2018,2019,11,13,USA
Raymond Douglas,1949-04-15,5,1972,1977,4,15,USA
Jesse Lee,1959-10-29,11,1981,1992,10,29,USA
John David,1964-10-15,2,1989,1991,10,15,USA
Joshua LaRoy,1982-12-17,3,2006,2009,12,17,Venezuela
Clyde Raymond,1891-07-08,4,1922,1926,7,8,USA
Greg Robert,1959-01-27,3,1983,1986,1,27,USA
Eros Bolivar,1885-05-18,9,1906,1915,5,18,USA
Brian Stuart,1968-08-26,0,1995,1995,8,26,USA
Alfred L.,1839-01-18,0,1871,1871,1,18,USA
Andrew Jon,1974-09-05,0,2001,2001,9,5,USA
Glen F.,1971-05-10,2,1999,2001,5,10,USA
Kevin Stewart,1975-07-26,10,1999,2009,7,26,USA
Leonard Harold,1955-07-07,11,1976,1987,7,7,USA
Raymond Herrell,1936-03-12,7,1960,1967,3,12,USA
Richard Frank,1972-10-29,0,1999,1999,10,29,USA
Sean Reed,1980-05-26,0,2007,2007,5,26,USA
Brian Edward,1975-12-08,0,1998,1998,12,8,USA
Jeffrey Carver,1959-11-21,1,1984,1985,11,21,USA
John Duncan,1912-09-19,6,1937,1943,9,19,USA
Samuel W.,1858-05-24,5,1884,1889,5,24,USA
Albert Joseph,1915-04-02,NA,NA,NA,4,2,USA
Michael Roswell,1948-04-30,6,1975,1981,4,30,USA
Scott A.,1992-12-18,1,2018,2019,12,18,USA
Bruce Raymond,1929-10-23,0,1953,1953,10,23,USA
Clint Harold,1979-03-06,12,2003,2015,3,6,USA
Herbert Paul,1915-03-02,6,1937,1943,3,2,USA
Charles Edward,1900-06-12,1,1927,1928,6,12,USA
Austin Scott,1989-12-28,4,2015,2019,12,28,USA
William Horace,1858-04-13,0,1884,1884,4,13,USA
Robert Avery,1902-01-06,0,1924,1924,1,6,USA
Brian Keith,1967-03-25,4,1990,1994,3,25,USA
Brandon Michael,1986-05-15,6,2012,2018,5,15,USA
Darwin James Kunane,1985-11-08,7,2010,2017,11,8,USA
Daniel J.,1989-10-21,2,2016,2018,10,21,USA
Edmund J.,1890-01-23,1,1915,1916,1,23,USA
Everett Duane,1900-12-01,1,1923,1924,12,1,USA
Frank Samuel,1900-01-09,1,1929,1930,1,9,USA
Frank,1926-08-26,3,1957,1960,8,26,USA
John Francis,1900-01-31,0,1926,1926,1,31,USA
Jacob Andrew,1990-04-14,3,2016,2019,4,14,USA
Jesse Lawrence,1892-08-26,12,1915,1927,8,26,USA
John Delbert,1976-04-24,1,2000,2001,4,24,USA
Junie Shoaf,1911-12-01,0,1934,1934,12,1,USA
Larry Richard,1974-07-23,2,2001,2003,7,23,USA
Luther Owens,1947-04-28,1,1972,1973,4,28,USA
Matthew D.,1990-06-17,5,2014,2019,6,17,USA
Emile Deering,1903-12-25,3,1927,1930,12,25,USA
Rex Edward,1924-12-19,7,1943,1950,12,19,USA
Richard Monroe,1959-07-21,1,1982,1983,7,21,USA
Charles Roscoe,1850-05-08,10,1871,1881,5,8,USA
Samuel Thomas,1899-12-18,0,1921,1921,12,18,USA
Scott Michael,1987-09-05,1,2012,2013,9,5,USA
William Henry,1957-03-03,11,1983,1994,3,3,USA
Anthony Lee,1983-11-09,3,2016,2019,11,9,USA
Virgil Jennings,1897-03-05,9,1919,1928,3,5,USA
Clyde Lee,1895-12-29,8,1920,1928,12,29,USA
Edgar Vernon,1904-09-16,0,1924,1924,9,16,USA
Leslie Earl,1905-02-23,2,1928,1930,2,23,USA
Tucker Jackson,1991-01-07,5,2014,2019,1,7,USA
Victor Dee,1922-09-01,2,1944,1946,9,1,USA
William Harrison,1853-01-26,12,1874,1886,1,26,USA
George Bernard,1917-08-26,2,1939,1941,8,26,USA
Edward Anthony,1943-08-23,1,1965,1966,8,23,USA
Christopher Edward,1979-03-01,0,2006,2006,3,1,USA
Salome,1957-06-16,6,1982,1988,6,16,Mexico
Daniel Edward,1983-04-24,0,2007,2007,4,24,USA
Richard Anthony,1932-10-13,0,1960,1960,10,13,USA
Steven Phillip,1990-12-07,4,2015,2019,12,7,USA
Facundo Anthony,1932-06-20,2,1961,1963,6,20,USA
German,1956-10-19,3,1979,1982,10,19,Mexico
Kyle David,1990-05-23,4,2015,2019,5,23,USA
Robert Alexander,1908-03-12,0,1935,1935,3,12,USA
Aaron James,1988-01-02,5,2014,2019,1,2,USA
William Joseph,1900-05-28,9,1921,1930,5,28,USA
Robert Schley,1899-01-27,6,1923,1929,1,27,USA
Tracy Souter,1906-09-28,12,1933,1945,9,28,USA
Francis Joseph,1913-07-01,11,1939,1950,7,1,USA
Franklin Jose,1996-02-27,2,2017,2019,2,27,Venezuela
Jake Dalton,1991-07-22,3,2016,2019,7,22,USA
James Erigena,1875-03-28,9,1899,1908,3,28,USA
John Joseph,1915-12-18,4,1942,1946,12,18,USA
Martin Glenn,1958-06-23,9,1982,1991,6,23,USA
Michael Patrick,1976-10-22,11,1998,2009,10,22,USA
Charles Henry,1915-02-14,12,1937,1949,2,14,USA
Timothy Wayne,1961-01-24,0,1988,1988,1,24,USA
Thomas Loren,1960-04-02,4,1988,1992,4,2,USA
Felipe Jesus,1994-09-15,0,2019,2019,9,15,USA
Francisco Javier,1953-06-10,7,1974,1981,6,10,Mexico
Jaime Jonathan,1996-07-18,1,2018,2019,7,18,Panama
Jose Manuel,1957-06-26,0,1982,1982,6,26,USA
Manuel Antonio,1974-09-21,1,1997,1998,9,21,Panama
Yhonathan,1991-12-01,0,2015,2015,12,1,Colombia
James Leland,1948-02-10,12,1971,1983,2,10,USA
Roland,1883-10-20,3,1909,1912,10,20,USA
Edward Grant,1868-05-10,NA,NA,NA,5,10,USA
Franklin Lee,1844-10-22,0,1871,1871,10,22,USA
Frank John,1890-08-06,0,1914,1914,8,6,USA
David Irenus,1900-06-21,0,1929,1929,6,21,USA
Anthony Dirk,1966-08-17,1,1996,1997,8,17,USA
Hyder Edward,1886-10-06,1,1908,1909,10,6,USA
Steven Charles,1951-09-08,2,1974,1976,9,8,USA
Edward,1882-10-02,2,1905,1907,10,2,USA
Hardin,1891-03-26,0,1912,1912,3,26,USA
John Joseph,1887-04-26,11,1908,1919,4,26,USA
Jeffrey Finas,1969-09-22,4,1995,1999,9,22,USA
Kevin Thomas,1978-08-18,1,2006,2007,8,18,USA
Richard Donovan,1940-09-12,0,1969,1969,9,12,USA
John C.,1878-10-27,9,1899,1908,10,27,USA
Thomas Arthur,1879-04-10,0,1904,1904,4,10,USA
Richard William,1907-11-22,19,1927,1946,11,22,USA
Kimera Anotchi,1972-07-21,5,1996,2001,7,21,USA
Robert Edward,1924-07-15,0,1944,1944,7,15,USA
James Richard,1984-01-06,0,2008,2008,1,6,USA
John Francis,1882-04-14,0,1904,1904,4,14,USA
Lester Justin,1903-04-04,4,1928,1932,4,4,USA
Anthony Joseph,1932-05-09,0,1952,1952,5,9,USA
William Jackson,1885-01-08,4,1903,1907,1,8,USA
Boyd Owen,1920-02-11,0,1943,1943,2,11,USA
Henry Irving,1914-06-27,0,1938,1938,6,27,USA
Jason Alan,1979-10-30,10,2004,2014,10,30,USA
Robert Wilbur,1941-07-30,9,1965,1974,7,30,USA
Brian Deon,1982-04-25,1,2008,2009,4,25,USA
Clifford Paul,1979-09-05,1,2004,2005,9,5,USA
David Robert,1917-03-24,0,1945,1945,3,24,USA
Daric William,1985-08-16,7,2007,2014,8,16,USA
Harry Lamb,1875-01-20,0,1905,1905,1,20,USA
Shawn Edward,1963-05-14,4,1992,1996,5,14,USA
Vincent David,1908-02-01,1,1931,1932,2,1,CAN
Charles Franklin,1865-03-13,0,1890,1890,3,13,USA
Philip Joseph,1979-01-25,0,2006,2006,1,25,USA
Christopher Joseph,1978-12-06,0,2007,2007,12,6,USA
Romanus,1922-02-08,3,1948,1951,2,8,USA
Albert C.,1888-08-22,6,1912,1918,8,22,USA
Tyler Morris,1993-04-16,1,2018,2019,4,16,USA
Walter Franklin,1909-10-06,0,1936,1936,10,6,USA
Edwin Frank,1922-11-04,3,1944,1947,11,4,USA
James Blaine,1887-12-10,2,1911,1913,12,10,USA
Anthony Edward,1987-11-01,8,2011,2019,11,1,USA
Brian Michael,1982-01-06,2,2008,2010,1,6,USA
Richard William,1906-07-07,0,1939,1939,7,7,USA
William Capers,1898-12-04,0,1918,1918,12,4,USA
Charles Edwin,1863-02-09,8,1884,1892,2,9,USA
Christopher M.,1989-02-22,5,2014,2019,2,22,USA
Kevin Charles,1959-05-12,13,1982,1995,5,12,USA
John Landis,1895-06-03,14,1913,1927,6,3,USA
Norman Delaney,1939-01-21,2,1961,1963,1,21,USA
Randy William,1954-03-13,5,1977,1982,3,13,USA
Antonio Francisco,1985-09-21,8,2009,2017,9,21,D.R.
Charles A.,1858-03-02,7,1884,1891,3,2,USA
Emil,1880-01-21,3,1904,1907,1,21,USA
Joseph Edward,1898-07-11,2,1923,1925,7,11,USA
Richard Anthony,1967-04-08,4,1993,1997,4,8,USA
John Alvin,1940-07-21,9,1963,1972,7,21,USA
Aaron,1984-03-10,0,2009,2009,3,10,USA
William Derrick,1963-12-07,1,1989,1990,12,7,USA
Hubert Edgar,1912-03-16,0,1939,1939,3,16,USA
Charles William,1907-09-17,0,1927,1927,9,17,USA
Delbert Oakley,1940-06-12,0,1970,1970,6,12,USA
Charles Richard,1945-10-07,0,1969,1969,10,7,USA
Creed Napoleon,1876-09-28,1,1898,1899,9,28,USA
Jason Charles,1971-01-05,3,1995,1998,1,5,USA
John William,1868-05-28,0,1889,1889,5,28,USA
John William,1884-01-10,8,1906,1914,1,10,USA
Raymond,1890-02-08,4,1913,1917,2,8,USA
William David,1960-10-14,4,1986,1990,10,14,USA
Kevin Wade,1966-10-21,0,1989,1989,10,21,USA
Kimothy Emil,1968-03-15,5,1991,1996,3,15,USA
Miguel Jerez,1971-02-19,20,1992,2012,2,19,D.R.
Rafael,1945-11-25,2,1973,1975,11,25,D.R.
Leocadio Francisco,1973-12-09,11,1996,2007,12,9,D.R.
William McKinley,1892-05-18,0,1916,1916,5,18,USA
Lawrence,1876-05-01,0,1895,1895,5,1,USA
Earl Jesse,1935-01-05,12,1955,1967,1,5,USA
George Burnett,1891-10-07,0,1912,1912,10,7,USA
Joseph V.,1853-11-11,19,1871,1890,11,11,USA
Allen Zelmo,1968-11-29,1,1995,1996,11,29,USA
Howard Dion,1972-03-25,4,1995,1999,3,25,USA
James Milton,1901-03-26,0,1927,1927,3,26,USA
Christopher Sean,1954-08-24,0,1976,1976,8,24,USA
Matthew Daniel,1921-10-16,9,1947,1956,10,16,USA
Albert,1859-08-07,2,1884,1886,8,7,USA
Henry Albert,1922-07-31,13,1948,1961,7,31,USA
Jakob Christopher,1995-10-06,1,2018,2019,10,6,USA
Louis Walter,1898-11-30,0,1918,1918,11,30,USA
Richard Edward,1977-01-10,7,2001,2008,1,10,USA
Russell Lee,1914-05-10,14,1936,1950,5,10,USA
Trevor Andrew,1991-01-17,7,2012,2019,1,17,USA
Justin Reis,1974-08-01,2,1998,2000,8,1,USA
George Charles,1987-12-09,2,2016,2018,12,9,USA
Frank Matt,1933-07-01,10,1955,1965,7,1,USA
Charles John,1885-12-20,6,1911,1917,12,20,USA
James Sloan,1931-01-29,12,1949,1961,1,29,USA
George Washington,1891-07-22,4,1912,1916,7,22,USA
Harry Edward,1892-10-06,0,1920,1920,10,6,USA
John Edward,1931-05-29,0,1953,1953,5,29,USA
Ross,1955-05-27,4,1978,1982,5,27,USA
Stanwood Fulton,1894-12-14,12,1914,1926,12,14,USA
Frank Conrad,1918-10-07,10,1947,1957,10,7,USA
George W.,1869-03-22,0,1889,1889,3,22,USA
Eduardo,1935-01-06,4,1960,1964,1,6,Cuba
Daniel,1972-05-24,11,1993,2004,5,24,D.R.
Denny M.,1980-08-23,6,2004,2010,8,23,D.R.
Gerson,1995-05-31,1,2018,2019,5,31,D.R.
Jose Joaquin,1964-07-25,9,1988,1997,7,25,D.R.
Jose Antonio,1980-10-19,14,2004,2018,10,19,D.R.
Rafael Darwing,1993-03-08,1,2017,2018,3,8,D.R.
Dimitrios Speros,1928-07-05,0,1959,1959,7,5,USA
Michael,1930-12-18,2,1956,1958,12,18,USA
Michael Joseph,1984-12-07,5,2010,2015,12,7,USA
John Morris,1876-07-27,0,1907,1907,7,27,USA
Harry Elbert,1878-01-17,7,1901,1908,1,17,USA
Jason Raymond,1978-09-20,10,2003,2013,9,20,CAN
Harry Owen,1883-09-06,0,1908,1908,9,6,USA
Jonah James,1980-08-13,2,2005,2007,8,13,USA
Don Edward,1949-06-28,18,1970,1988,6,28,USA
William Lear,1899-04-18,11,1919,1930,4,18,USA
Yorman Michael,1984-07-11,4,2005,2009,7,11,Venezuela
Brandon Alan,1986-09-03,5,2010,2015,9,3,USA
Robert Brooks,1948-04-24,5,1975,1980,4,24,USA
John Woolf,1882-03-12,5,1913,1918,3,12,USA
Walter Esau,1899-07-29,5,1924,1929,7,29,USA
Alexander Rodger,1869-11-21,0,1889,1889,11,21,USA
Ernest Joseph,1867-03-17,0,1895,1895,3,17,USA
Charles Alonzo,1934-12-25,2,1956,1958,12,25,USA
Charles Alonzo,1953-12-04,3,1978,1981,12,4,USA
Clifford,1974-02-11,2,1996,1998,2,11,USA
Theodore Lester,1980-08-28,2,2006,2008,8,28,USA
Beveric Benton,1905-04-25,5,1930,1935,4,25,USA
William Daro,1964-05-11,8,1987,1995,5,11,USA
Randall Colter,1977-01-16,2,2005,2007,1,16,USA
William Lamar,1962-03-29,5,1984,1989,3,29,USA
Joseph William,1874-03-18,0,1902,1902,3,18,USA
Charles David,1959-10-02,9,1980,1989,10,2,USA
Henry Eugene,1920-09-05,6,1947,1953,9,5,USA
Michael Richard,1950-06-21,3,1974,1977,6,21,USA
Oliver Perry,1862-05-02,2,1889,1891,5,2,USA
Ralph William,1929-02-11,0,1954,1954,2,11,USA
Cramer Theodore,1921-01-07,10,1948,1958,1,7,USA
Gary Ray,1952-08-22,1,1976,1977,8,22,USA
Lawrence Donald,1941-09-11,8,1963,1971,9,11,USA
Kevin Gerard,1965-11-07,0,1990,1990,11,7,USA
Christopher Charles,1962-06-23,0,1991,1991,6,23,USA
Lewis Paige,1948-08-27,0,1977,1977,8,27,USA
Ebenezer Ambrose,1866-08-10,4,1887,1891,8,10,USA
Pedro,1986-10-27,6,2011,2017,10,27,D.R.
Gordon Blaine,1964-04-25,2,1989,1991,4,25,USA
Desmond Aloysius,1893-04-07,0,1914,1914,4,7,USA
James Louis,1954-07-04,8,1978,1986,7,4,USA
Matthew Thomas,1993-04-28,0,2019,2019,4,28,USA
James Edward,1939-08-21,10,1963,1973,8,21,USA
Clarence Howeth,1876-07-23,11,1899,1910,7,23,USA
Blake William,1989-01-17,3,2011,2014,1,17,USA
John Andrew,1918-05-25,8,1941,1949,5,25,USA
James Melvin,1859-08-22,3,1884,1887,8,22,USA
Steven Scott,1979-11-18,0,2002,2002,11,18,USA
George W.,1848-09-02,5,1871,1876,9,2,USA
Walter William,1904-10-16,21,1924,1945,10,16,USA
Chad Lee,1985-01-17,1,2011,2012,1,17,USA
Christopher Michael,1990-09-04,3,2015,2018,9,4,USA
Clyde Eugene,1900-01-06,5,1926,1931,1,6,USA
David Beals,1886-07-05,7,1908,1915,7,5,USA
Robert Charles,1875-08-15,1,1897,1898,8,15,USA
Charles Schlagel,1890-10-14,1,1911,1912,10,14,USA
Glenn Alfred,1940-10-12,10,1965,1975,10,12,USA
Henry Ward,1884-06-15,1,1909,1910,6,15,USA
Heinz Reinhard,1915-08-26,4,1943,1947,8,26,Germany
Joseph Edward,1908-06-25,1,1936,1937,6,25,USA
Joshua Patrick,1980-05-15,13,2001,2014,5,15,USA
Martin Henry,1893-12-22,0,1915,1915,12,22,USA
Ervin F.,1878-07-19,3,1899,1902,7,19,USA
Richard Godhard,1972-02-01,7,1993,2000,2,1,USA
Robert Joseph,1972-07-16,1,1996,1997,7,16,USA
Frederick Thomas,1886-11-17,6,1909,1915,11,17,USA
Ernest George Bernard,1890-02-21,0,1914,1914,2,21,USA
James Gordon,1986-09-16,10,2009,2019,9,16,USA
Timothy Lamar,1990-01-27,6,2013,2019,1,27,USA
Jacob Peter,1867-08-04,19,1888,1907,8,4,USA
William Aloysius,1907-12-08,3,1939,1942,12,8,USA
James Joseph,1905-03-01,1,1927,1928,3,1,USA
Richard Henry,1940-01-21,0,1965,1965,1,21,USA
Rodney Roy,1968-08-03,13,1991,2004,8,3,USA
Thomas Joseph,1955-01-28,7,1979,1986,1,28,USA
Zinn Bertram,1885-09-30,5,1913,1918,9,30,USA
Julio,1931-12-20,8,1955,1963,12,20,Cuba
Erik Joseph,1979-03-05,12,2002,2014,3,5,CAN
Howard William,1935-09-29,6,1962,1968,9,29,USA
William Eugene,1896-12-02,0,1925,1925,12,2,USA
Phillip Burlette,1898-03-08,1,1922,1923,3,8,USA
Hugh Carpenter,1889-10-23,3,1912,1915,10,23,USA
Andrew Jackson,1908-08-16,1,1930,1931,8,16,USA
David,1994-10-10,0,2019,2019,10,10,USA
Cameron Rock,1991-10-02,5,2014,2019,10,2,USA
Stephen Wayne,1957-12-06,14,1981,1995,12,6,USA
Frederick Leonard,1879-12-31,10,1906,1916,12,31,USA
Edward Harry,1859-07-02,4,1887,1891,7,2,USA
Edward,1875-08-27,1,1897,1898,8,27,USA
Lucas Matthew,1972-01-20,2,1996,1998,1,20,USA
Leroy,1884-05-10,1,1907,1908,5,10,USA
Tyler Joseph,1993-05-23,1,2018,2019,5,23,USA
Jalen Christopher,1993-07-10,1,2018,2019,7,10,USA
Dallas James,1989-06-12,1,2014,2015,6,12,USA
Joseph Samuel,1920-11-26,0,1944,1944,11,26,USA
Ramon Andrew,1956-10-13,1,1983,1984,10,13,USA
Freddy Ray,1942-11-24,7,1968,1975,11,24,USA
Clarence Scott,1918-12-09,0,1948,1948,12,9,USA
Joseph Stanley,1910-11-04,10,1938,1948,11,4,USA
Eugene T.,1861-06-07,0,1886,1886,6,7,USA
James Lawrence,1902-09-19,0,1924,1924,9,19,USA
Charles Frederick,1887-12-11,2,1921,1923,12,11,USA
Stephen Arnold Douglas,1860-11-06,2,1884,1886,11,6,USA
Richard Kipp,1960-03-06,2,1983,1985,3,6,USA
Melvin Brian,1947-09-02,0,1970,1970,9,2,USA
Henry Bernard,1921-06-27,3,1946,1949,6,27,USA
Joseph Ronald,1977-04-19,14,2001,2015,4,19,USA
Kevin Patrick,1974-01-01,2,2000,2002,1,1,USA
Aloysius Frank,1907-09-12,5,1934,1939,9,12,USA
Mark Henry,1944-06-08,17,1965,1982,6,8,USA
Carroll Wayne,1930-09-05,6,1950,1956,9,5,USA
Kevin Donnell,1967-08-08,0,1990,1990,8,8,USA
Timothy Wayne,1961-10-19,13,1987,2000,10,19,USA
Ira Allison,1874-04-16,0,1897,1897,4,16,USA
Michael John,1988-10-03,0,2013,2013,10,3,USA
Robert,1936-12-07,8,1962,1970,12,7,USA
Stanley Peter,1966-08-06,11,1989,2000,8,6,USA
Matthew Thomas,1980-06-06,15,2003,2018,6,6,USA
Ronald J.,1982-12-31,6,2009,2015,12,31,Venezuela
Todd Stephen,1975-10-23,1,2000,2001,10,23,USA
Jeffrey Ryan,1987-01-17,6,2012,2018,1,17,USA
Timothy William,1970-04-06,0,1996,1996,4,6,USA
Andrew James,1991-08-05,0,2015,2015,8,5,USA
Stephen B.,1849-10-01,2,1871,1873,10,1,Cuba
John,1930-08-23,2,1957,1959,8,23,USA
Roy Chester,1907-08-20,6,1935,1941,8,20,USA
William Samuel,1933-10-24,3,1952,1955,10,24,USA
David Gus,1951-08-27,17,1972,1989,8,27,USA
Charles C.,1868-08-12,2,1889,1891,8,12,USA
Chadwick Micah,1989-02-28,1,2017,2018,2,28,USA
James Thomas,1903-05-17,NA,NA,NA,5,17,USA
David Michael,1972-09-14,11,1995,2006,9,14,USA
Derek Nathaniel,1968-12-11,10,1991,2001,12,11,USA
Albert Jojuan,1966-08-25,11,1989,2000,8,25,USA
Eric Alvin,1963-10-27,8,1985,1993,10,27,USA
Fernando Jerome Lee,1913-01-21,1,1939,1940,1,21,USA
Frank Gustav,1862-12-11,0,1885,1885,12,11,USA
Wilbur Gary,1936-11-17,11,1958,1969,11,17,USA
George Glenn,1874-11-02,4,1907,1911,11,2,USA
George Antonio,1959-10-21,12,1981,1993,10,21,D.R.
David Russell,1928-11-15,14,1950,1964,11,15,USA
Heath Justin,1977-09-29,10,2004,2014,9,29,USA
Herman S.,1897-07-16,10,1924,1934,7,16,USA
Mark Christian,1974-08-23,10,1997,2007,8,23,USA
Clayton Daniel,1968-11-18,3,1999,2002,11,18,USA
Cody James,1995-07-13,2,2017,2019,7,13,USA
Rafael Leonidas,1961-10-24,16,1982,1998,10,24,D.R.
Ronald,1975-04-07,12,1998,2010,4,7,USA
Jay Stuart,1965-12-11,17,1986,2003,12,11,USA
Jerry Houston,1947-10-06,3,1971,1974,10,6,USA
Joshua Lee,1986-11-13,2,2010,2012,11,13,USA
Joshua Evan,1992-08-14,3,2016,2019,8,14,USA
Juan,1968-03-29,6,1989,1995,3,29,D.R.
Kevin Robert,1955-07-13,6,1976,1982,7,13,USA
Lester Rowland,1901-12-14,8,1923,1931,12,14,USA
Michael Allen,1968-04-22,1,1990,1991,4,22,USA
Michael John,1974-12-07,0,2000,2000,12,7,USA
John Hutchins,1864-03-04,0,1889,1889,3,4,USA
Edwin Daniel,1982-02-21,2,2007,2009,2,21,Venezuela
Robert Edward,1948-07-13,3,1975,1978,7,13,Germany
Ralph Albert,1890-11-06,0,1912,1912,11,6,USA
Robert Allen,1977-01-17,7,2000,2007,1,17,USA
Rudolph Fred,1881-01-01,0,1907,1907,1,1,USA
Terence William,1962-10-27,1,1986,1987,10,27,USA
Trevor Daniel,1986-10-12,5,2009,2014,10,12,USA
Vincent Michael,1988-03-11,0,2014,2014,3,11,USA
Duane Arthur,1985-11-15,2,2011,2013,11,15,USA
Brandon Kyle,1988-04-20,8,2011,2019,4,20,USA
Adrian,1979-04-07,20,1998,2018,4,7,D.R.
Carlos Ivan,1977-04-24,19,1998,2017,4,24,P.R.
Engel Manuel,1989-11-01,0,2013,2013,11,1,D.R.
Esteban,1967-12-26,5,1991,1996,12,26,D.R.
Francis LeBron,1979-11-29,6,2002,2008,11,29,D.R.
Omar,1981-08-24,0,2010,2010,8,24,D.R.
Rigoberto,1969-11-13,7,1997,2004,11,13,Mexico
Anthony John,1990-01-18,0,2019,2019,1,18,USA
Harry Parker,1874-02-01,8,1902,1910,2,1,USA
Marvin Larry,1971-01-20,8,1995,2003,1,20,Nicaragua
Alfredo,1966-04-07,3,1991,1994,4,7,USA
Johnny Lee,1947-12-07,16,1967,1983,12,7,USA
Charles Albert,1884-05-05,22,1903,1925,5,5,USA
Arthur Melville,1862-03-31,0,1883,1883,3,31,USA
Bruce Edwin,1955-08-18,11,1978,1989,8,18,USA
Alan Paul,1972-01-21,8,1995,2003,1,21,USA
Andrew Charles,1967-08-20,13,1989,2002,8,20,USA
Joseph Anthony,1901-01-08,0,1931,1931,1,8,USA
Raymond Adelphia,1902-04-22,13,1925,1938,4,22,USA
Bernard Oliver,1898-07-27,9,1923,1932,7,27,USA
Andrew S.,1994-07-06,3,2016,2019,7,6,USA
Juan Jose,1950-05-13,17,1971,1988,5,13,P.R.
Armando German,1972-11-03,14,1994,2008,11,3,D.R.
Yamil Antonio,1972-10-05,3,1995,1998,10,5,P.R.
Michael Paul,1965-11-22,13,1989,2002,11,22,USA
Alfred Stanley,1914-05-20,6,1939,1945,5,20,USA
Charles Wesley,1854-11-21,15,1878,1893,11,21,USA
David Hans,1945-11-07,0,1964,1964,11,7,USA
Dennis John,1939-10-05,6,1962,1968,10,5,USA
Erik Hans,1968-09-13,1,1995,1996,9,13,USA
Francis Allen,1904-10-27,1,1927,1928,10,27,USA
James Fred,1902-03-15,3,1928,1931,3,15,USA
Gary David,1972-04-17,13,1995,2008,4,17,USA
Herschel Emmett,1896-09-21,4,1923,1927,9,21,USA
Isaac B.,1856-06-07,0,1884,1884,6,7,USA
David Jeffrey,1980-06-10,5,2004,2009,6,10,USA
Joseph Rosenblum,1900-07-02,0,1923,1923,7,2,USA
Joel Todd,1970-01-31,1,1998,1999,1,31,USA
Justin Titus,1874-02-20,1,1906,1907,2,20,USA
Shayne Anthony,1972-04-10,2,1997,1999,4,10,Australia
Henry Omer,1890-01-25,0,1914,1914,1,25,USA
Joaquin Antonio,1977-07-26,16,2001,2017,7,26,D.R.
Allen Wilbert,1905-03-28,0,1934,1934,3,28,USA
William Joseph,1988-03-05,0,2011,2011,3,5,USA
Kristen James,1974-11-07,11,1999,2010,11,7,USA
Vernon Adair,1924-09-19,10,1943,1953,9,19,USA
Clytus George,1850-11-23,0,1872,1872,11,23,USA
John Needles,1895-03-08,14,1913,1927,3,8,USA
John Alton,1911-03-18,18,1934,1952,3,18,USA
Alfred Lee,1957-08-24,7,1978,1985,8,24,USA
Lawrence James,1897-11-20,12,1923,1935,11,20,USA
Stanley W.,1901-09-29,0,1922,1922,9,29,USA
John Cleave,1890-06-27,15,1910,1925,6,27,USA
Sidney Wright,1894-08-04,0,1922,1922,8,4,USA
Chad Robert,1980-05-05,1,2004,2005,5,5,USA
Todd Eric,1963-02-11,8,1987,1995,2,11,USA
Joseph Louis,1886-01-21,8,1911,1919,1,21,USA
John,1917-05-01,13,1939,1952,5,1,USA
Louis Joseph,1929-11-20,6,1954,1960,11,20,USA
Jeffrey James,1970-11-19,0,1997,1997,11,19,USA
Jason Phillip,1971-05-26,10,1993,2003,5,26,USA
Bruce Michael,1954-08-21,6,1980,1986,8,21,USA
Juan Bautista,1954-11-30,14,1978,1992,11,30,Panama
James Richard,1989-01-19,0,2016,2016,1,19,Australia
August Samuel,1917-02-14,1,1944,1945,2,14,USA
David Scott,1970-09-03,6,1998,2004,9,3,USA
William Aloysius,1878-06-13,10,1901,1911,6,13,USA
Louis William,1910-05-13,7,1932,1939,5,13,USA
Brandon Charles,1975-02-21,3,2001,2004,2,21,USA
Bradley Steven,1985-09-25,3,2009,2012,9,25,USA
Clarence Edward,1894-11-01,0,1914,1914,11,1,USA
Charles Carl,1882-01-07,3,1907,1910,1,7,USA
Joseph August,1886-12-20,1,1913,1914,12,20,USA
John Henne,1901-08-27,5,1922,1927,8,27,USA
Martin,1871-10-25,3,1896,1899,10,25,USA
Peter Francis,1977-11-09,5,1999,2004,11,9,USA
Travis Michael,1993-10-08,0,2019,2019,10,8,USA
John Henry,1867-12-06,2,1890,1892,12,6,USA
Walter Anton,1905-10-10,10,1930,1940,10,10,USA
John Baptist,1857-10-08,4,1876,1880,10,8,USA
Martin Andrew,1888-06-18,4,1911,1915,6,18,USA
Justin Christopher,1984-06-07,2,2009,2011,6,7,USA
Alfred Henry,1889-09-27,0,1916,1916,9,27,USA
Christian Stanford,1988-05-04,4,2014,2018,5,4,USA
David Bruce,1953-06-06,17,1975,1992,6,6,USA
Dustin Michael,1978-02-01,0,2004,2004,2,1,USA
Jason Chris,1981-09-25,5,2005,2010,9,25,USA
Morris,1902-03-02,16,1923,1939,3,2,USA
Sean Frederick,1970-04-11,7,1993,2000,4,11,USA
William Jose,1983-02-04,0,2005,2005,2,4,Venezuela
Frank Pierce,1853-07-27,0,1884,1884,7,27,USA
Jason Thomas,1983-11-27,3,2009,2012,11,27,USA
Nathan,1832-09-17,0,1871,1871,9,17,USA
William Lance,1976-02-10,14,1999,2013,2,10,USA
John Chambers,1903-05-24,9,1924,1933,5,24,USA
Robert Leon,1899-01-24,0,1918,1918,1,24,USA
Curtis Henry,1878-02-18,1,1900,1901,2,18,USA
Dwight Vern,1952-05-31,4,1978,1982,5,31,USA
Joseph Carl,1882-03-24,0,1909,1909,3,24,USA
Rogearvin Argelo,1984-06-12,6,2008,2014,6,12,Curacao
Antonio,1956-08-24,12,1979,1991,8,24,P.R.
Victor Hugo,1953-10-06,0,1977,1977,10,6,USA
Adam Gino,1976-11-28,6,2000,2006,11,28,USA
William Henry,1871-03-16,8,1899,1907,3,16,USA
Juan Ramon,1953-08-31,3,1976,1979,8,31,D.R.
Walter Jacob,1893-05-20,0,1918,1918,5,20,USA
Carlos,1927-01-28,0,1953,1953,1,28,P.R.
Douglas Howell,1980-06-24,7,2008,2015,6,24,USA
John George,1922-12-22,3,1948,1951,12,22,USA
Dale Anthony,1956-12-13,10,1977,1987,12,13,USA
Dennis Martin,1887-10-08,0,1912,1912,10,8,USA
Lawrence Peter,1925-05-12,19,1946,1965,5,12,USA
Raymond Frederick,1907-08-31,11,1934,1945,8,31,USA
Jose Orlando,1994-05-27,3,2016,2019,5,27,P.R.
Angel Maria,1978-01-27,8,2001,2009,1,27,D.R.
Geronimo Emiliano Letta,1965-03-18,11,1989,2000,3,18,D.R.
Charles Joseph,1860-09-06,0,1884,1884,9,6,USA
Charles Francis,1902-10-18,13,1925,1938,10,18,USA
Claude Elzy,1880-02-14,11,1904,1915,2,14,USA
Damon Scott,1963-12-03,10,1987,1997,12,3,USA
Joseph Howard,1872-09-10,0,1902,1902,9,10,USA
Joseph Howard,1894-12-31,1,1921,1922,12,31,USA
Jonas Arthur,1904-12-16,4,1942,1946,12,16,USA
Allen Kent,1941-05-10,13,1962,1975,5,10,USA
Cornelius John,1922-01-11,6,1948,1954,1,11,USA
Quintin Lonell,1984-11-21,5,2012,2017,11,21,USA
Sean Robert,1966-03-22,10,1990,2000,3,22,USA
Thomas Haney,1842-12-31,0,1871,1871,12,31,USA
Frank Louis,1944-04-14,6,1964,1970,4,14,USA
Richard George,1935-11-21,7,1960,1967,11,21,USA
Harry Thomas,1872-05-10,0,1903,1903,5,10,USA
Henry Washburn,1844-01-01,0,1871,1871,1,1,USA
Jonathon David,1990-01-22,1,2018,2019,1,22,USA
Michael David,1970-01-18,2,1995,1997,1,18,USA
Pierino Peter,1935-01-08,9,1953,1962,1,8,Italy
Roman Mathias,1909-02-28,0,1936,1936,2,28,USA
Andres,1971-04-05,1,1995,1996,4,5,Mexico
Frederick Cyril,1930-04-05,0,1956,1956,4,5,USA
Robert Henry,1884-02-25,10,1908,1918,2,25,USA
Fred Donald,1931-03-13,3,1955,1958,3,13,USA
Herman Anthony,1911-08-16,6,1940,1946,8,16,USA
Karl Jon,1959-03-06,5,1983,1988,3,6,USA
James William,1958-02-12,0,1978,1978,2,12,USA
Dellin,1988-03-23,8,2011,2019,3,23,USA
Rafael Jose,1975-04-29,12,2003,2015,4,29,Venezuela
Yuniesky,1982-01-31,8,2005,2013,1,31,Cuba
Franklin Lyle,1888-02-15,0,1910,1910,2,15,USA
Wilson,1981-11-02,12,2001,2013,11,2,D.R.
Christian Gabriel,1991-09-02,4,2013,2017,9,2,Panama
William Lamar,1942-01-01,0,1964,1964,1,1,USA
James Charles,1946-11-05,0,1965,1965,11,5,USA
Jeffrey Allen,1960-12-10,0,1984,1984,12,10,USA
Lawrence Joseph,1905-09-22,4,1928,1932,9,22,USA
Chad Robert,1989-04-26,6,2013,2019,4,26,USA
Harold Matthew,1881-06-19,10,1903,1913,6,19,USA
Walter McKinley,1897-02-18,15,1920,1935,2,18,USA
Markus Lynn,1992-10-07,5,2014,2019,10,7,USA
Christian Frederick Albert John Henry David,1894-12-06,4,1914,1918,12,6,USA
Kurt Anthony,1947-01-23,14,1971,1985,1,23,USA
Harold Joseph,1930-11-15,9,1952,1961,11,15,USA
Floyd Clifford,1916-10-21,3,1944,1947,10,21,USA
Jason Robert,1973-11-27,0,2002,2002,11,27,USA
Clarence Benjamin,1877-08-28,0,1901,1901,8,28,USA
Brian Scott,1971-09-05,2,1996,1998,9,5,USA
Louis Eugene,1922-11-27,0,1942,1942,11,27,USA
Henry Monte,1875-02-24,1,1903,1904,2,24,USA
Terry Paul,1956-07-07,NA,NA,NA,7,7,USA
Hugo Francis,1883-04-01,NA,NA,NA,4,1,Czech Republic
Joseph Carlo,1990-05-29,3,2016,2019,5,29,USA
Roland Americo,1960-02-02,5,1982,1987,2,2,USA
Jeffrey Thomas,1986-10-05,3,2012,2015,10,5,USA
Thomas Anthony,1952-12-16,0,1975,1975,12,16,USA
Henry Arcado,1922-01-14,0,1949,1949,1,14,Italy
James Blair,1944-10-29,12,1972,1984,10,29,USA
Austin M.,1985-04-29,1,2017,2018,4,29,USA
Bo Joseph,1998-03-05,0,2019,2019,3,5,USA
Alphonse Dante,1963-11-18,13,1988,2001,11,18,USA
Vernon Edgell,1920-08-17,6,1948,1954,8,17,USA
Daniel Denison,1864-10-31,0,1886,1886,10,31,USA
Charles Stephen,1928-07-27,1,1948,1949,7,27,USA
Jesse Thomas,1991-10-22,1,2018,2019,10,22,USA
Lee Francis,1976-05-21,4,2000,2004,5,21,USA
Shane Robert,1995-05-31,1,2018,2019,5,31,USA
Oscar,1847-03-21,4,1872,1876,3,21,USA
Michael Joseph,1959-07-31,13,1984,1997,7,31,USA
Harry Lee,1897-10-09,5,1920,1925,10,9,USA
Louis W.,1865-09-28,12,1886,1898,9,28,USA
Nicholas Raymond,1978-05-16,3,2001,2004,5,16,USA
Randor,1984-03-14,0,2008,2008,3,14,D.R.
Steven Ray,1967-08-04,1,1997,1998,8,4,USA
Carson Lee,1895-03-31,10,1916,1926,3,31,USA
Lyle Randolph,1893-08-22,1,1920,1921,8,22,USA
Larry Robert,1977-11-04,5,2001,2006,11,4,USA
Elliot Allardice,1897-10-13,0,1929,1929,10,13,USA
Cavan Thomas,1995-04-11,0,2019,2019,4,11,USA
Craig Alan,1965-12-14,19,1988,2007,12,14,USA
Charles Orval,1906-09-15,0,1932,1932,9,15,USA
Ivan Edward,1892-12-13,0,1917,1917,12,13,USA
George William,1858-07-18,0,1884,1884,7,18,USA
Lawrence David,1946-07-27,13,1970,1983,7,27,USA
Dann James,1959-05-26,9,1983,1992,5,26,USA
James Melvin,1924-04-20,0,1949,1949,4,20,USA
Emil,1912-09-16,4,1937,1941,9,16,USA
Stephen Thomas,1928-11-13,13,1949,1962,11,13,USA
Brett Aaron,1975-04-19,0,1999,1999,4,19,USA
Bruce,1985-11-18,3,2011,2014,11,18,USA
Chad Ryan,1984-07-29,9,2006,2015,7,29,USA
Richard Arlin,1942-12-04,7,1968,1975,12,4,USA
Harry Pree,1883-11-11,7,1908,1915,11,11,USA
John Eugene,1943-02-21,12,1968,1980,2,21,USA
John Augustus,1891-11-30,10,1913,1923,11,30,USA
Haskell Clark,1907-09-27,2,1927,1929,9,27,USA
George Alvin,1914-07-11,4,1944,1948,7,11,USA
Stefan Alexander,1917-02-26,0,1944,1944,2,26,USA
Adoniram Judson,1855-09-12,2,1882,1884,9,12,USA
James Douglas,1950-03-05,10,1973,1983,3,5,USA
Frank Zephrin,1869-03-10,0,1892,1892,3,10,USA
George Raymond,1850-06-23,0,1871,1871,6,23,USA
Gregory Paul,1992-11-09,4,2015,2019,11,9,USA
Ronald Kyle,1993-04-12,0,2019,2019,4,12,USA
James Edward,1890-04-25,0,1921,1921,4,25,USA
David Solomon,1838-07-16,2,1871,1873,7,16,USA
Michael Lawrence,1961-03-10,9,1986,1995,3,10,USA
Kurt Daniel,1980-08-11,2,2006,2008,8,11,USA
Ralph Joseph,1908-11-05,4,1933,1937,11,5,USA
Joseph Leo,1884-12-03,8,1906,1914,12,3,USA
Werner Joseph,1929-07-04,3,1955,1958,7,4,USA
Timothy Dean,1960-09-05,5,1985,1990,9,5,USA
Frank Stephen,1920-03-13,6,1942,1948,3,13,USA
John George,1894-10-28,1,1925,1926,10,28,USA
Joseph Richard,1982-09-18,3,2007,2010,9,18,USA
William Robinson,1864-12-27,3,1886,1889,12,27,USA
William Henry,1900-10-22,0,1921,1921,10,22,USA
Braden Adam,1993-08-22,0,2019,2019,8,22,USA
Charles Tuller,1924-01-01,3,1952,1955,1,1,USA
Frank H.,1856-09-21,0,1884,1884,9,21,USA
James Morton,1898-01-28,1,1923,1924,1,28,USA
Lloyd Clifton,1890-04-25,0,1914,1914,4,25,USA
Max Frederick,1899-09-05,11,1924,1935,9,5,USA
Michael David,1958-11-05,0,1983,1983,11,5,USA
Rivington Martin,1890-02-17,2,1912,1914,2,17,USA
Delphia Louis,1899-09-06,5,1928,1933,9,6,USA
Hiram Gabriel,1916-03-18,5,1942,1947,3,18,P.R.
Joseph Anthony,1964-02-12,1,1990,1991,2,12,USA
Jeffrey Scott,1962-04-13,3,1986,1989,4,13,USA
Henry Peter,1862-07-22,0,1889,1889,7,22,USA
James Nathaniel,1909-12-11,0,1935,1935,12,11,USA
Brian Joseph,1982-10-22,4,2008,2012,10,22,USA
George Anton,1956-08-26,0,1983,1983,8,26,USA
Tyson Michael,1990-10-20,3,2016,2019,10,20,USA
John William,1899-08-12,0,1924,1924,8,12,USA
Robert Benjamin,1862-12-10,0,1884,1884,12,10,USA
William Carroll,1932-07-09,4,1952,1956,7,9,USA
Harry Ralston,1957-06-30,14,1981,1995,6,30,USA
Foster Edwin,1895-01-06,6,1915,1921,1,6,USA
Charles Cobb,1986-07-01,8,2011,2019,7,1,USA
David,1893-11-08,9,1914,1923,11,8,USA
Donald Paul,1916-07-20,5,1943,1948,7,20,USA
Earl Stuart,1892-11-01,5,1912,1917,11,1,USA
Ethan Allen,1940-07-24,2,1962,1964,7,24,USA
Ewell,1922-10-23,13,1942,1955,10,23,USA
Frederick William,1891-09-07,2,1917,1919,9,7,USA
George W.,1869-09-21,0,1897,1897,9,21,USA
George Franklin,1903-11-18,0,1928,1928,11,18,USA
James Ray,1924-06-19,3,1948,1951,6,19,USA
John Falconor,1890-02-23,0,1911,1911,2,23,USA
Joseph,1924-02-08,5,1952,1957,2,8,USA
Russell Aubrey,1886-10-23,19,1910,1929,10,23,USA
Robert Nicholas,1982-02-24,5,2007,2012,2,24,USA
Paul Cady,1993-12-04,2,2017,2019,12,4,USA
Raymond Anthony,1990-06-26,1,2018,2019,6,26,USA
Ronald Hamilton,1935-04-23,1,1958,1959,4,23,USA
Timothy P.,1952-08-19,9,1974,1983,8,19,USA
Travis Jarred,1982-11-04,9,2004,2013,11,4,Australia
Victor Laurence,1988-05-23,1,2013,2014,5,23,USA
Francis Raymond,1896-08-06,10,1922,1932,8,6,USA
Richard Alan,1946-12-09,6,1969,1975,12,9,USA
George Franklin,1904-01-26,11,1925,1936,1,26,USA
Rae Bertrum,1911-02-08,0,1941,1941,2,8,USA
Aaron Daniel,1992-05-26,1,2016,2017,5,26,USA
William Ellsworth,1863-09-17,0,1888,1888,9,17,USA
Louis Nathan,1910-09-10,0,1942,1942,9,10,USA
Carson Reynolds,1989-10-18,0,2015,2015,10,18,USA
Dennis Herman,1954-06-05,6,1974,1980,6,5,USA
Clarence Vick,1900-07-13,2,1929,1931,7,13,USA
Paul L. D.,1944-02-01,16,1964,1980,2,1,USA
Walter Allen,1883-10-13,8,1907,1915,10,13,USA
William Allen,1965-12-18,11,1990,2001,12,18,USA
Howard Carleton,1862-06-18,0,1884,1884,6,18,USA
William Casey,1973-08-23,12,1999,2011,8,23,USA
Edward James,1925-12-23,6,1951,1957,12,23,USA
Harry Cooper,1874-06-16,5,1894,1899,6,16,USA
Lincoln Howard,1912-02-12,0,1934,1934,2,12,USA
John Frederick,1899-09-17,17,1920,1937,9,17,USA
John Robert,1855-10-02,2,1882,1884,10,2,USA
Hank Joe,1980-11-21,8,2002,2010,11,21,USA
Prosper Albert,1909-09-21,1,1935,1936,9,21,USA
Andres Eloy,1984-04-11,13,2004,2017,4,11,Venezuela
Damaso,1941-12-11,2,1972,1974,12,11,Venezuela
Gilbert Henry,1945-12-15,1,1965,1966,12,15,USA
Gregor Miguel,1983-12-24,10,2008,2018,12,24,Venezuela
Henry Ramon,1971-08-29,16,1997,2013,8,29,Venezuela
John Edwin,1933-02-26,10,1955,1965,2,26,USA
Oswaldo Carlos,1945-09-08,4,1970,1974,9,8,Venezuela
Tony Hemiphere,1981-11-10,0,2005,2005,11,10,D.R.
Alessandre,1992-11-06,1,2018,2019,11,6,USA
Frederick James,1888-02-08,4,1910,1914,2,8,USA
Nathan Garrett,1974-12-27,0,2003,2003,12,27,USA
Clifford Douglas,1880-04-10,4,1905,1909,4,10,USA
Frank Ignatz,1892-10-18,0,1909,1909,10,18,USA
Frederick August,1874-06-18,0,1894,1894,6,18,USA
Homer,1902-08-04,6,1922,1928,8,4,USA
Kevin DeWayne,1963-01-26,2,1988,1990,1,26,USA
Kyle Nathaniel,1986-09-11,6,2009,2015,9,11,USA
Larvell,1950-01-28,8,1972,1980,1,28,USA
Lance Robert,1963-12-06,5,1988,1993,12,6,USA
Clarence Matthew,1976-04-05,1,2000,2001,4,5,USA
Theodore,1901-05-10,8,1922,1930,5,10,USA
Darrell Elijah,1908-07-06,8,1934,1942,7,6,USA
Joseph Matthew,1980-12-11,13,2004,2017,12,11,USA
Jabari Jerell,1989-07-04,2,2016,2018,7,4,V.I.
Don Lee,1932-03-16,11,1955,1966,3,16,USA
Wade Allen,1943-11-22,9,1963,1972,11,22,USA
Stephen Robert,1942-04-18,10,1964,1974,4,18,USA
Stephen Lawrence,1944-03-20,4,1971,1975,3,20,USA
John Louis,1921-03-10,2,1948,1950,3,10,USA
Robert Garnett,1920-02-08,7,1942,1949,2,8,USA
Jeffrey Michael,1965-11-08,12,1987,1999,11,8,USA
Robert Edward,1935-06-28,3,1956,1959,6,28,USA
Gary Nelson,1931-10-11,0,1959,1959,10,11,USA
Marvin Edward,1929-09-30,7,1950,1957,9,30,USA
Michael Robert,1989-03-16,6,2013,2019,3,16,USA
Ronald Patrick,1971-07-30,1,1996,1997,7,30,USA
Curtis Leroy,1943-07-05,7,1965,1972,7,5,USA
Jeremy Michael,1987-06-18,0,2018,2018,6,18,USA
Richard Sidney,1987-04-16,3,2016,2019,4,16,USA
Raymond,1937-08-09,0,1960,1960,8,9,USA
Isaiah,1949-09-30,0,1972,1972,9,30,USA
Clarence Waldo,1893-07-11,6,1923,1929,7,11,USA
Jerry Richard,1983-09-06,12,2007,2019,9,6,USA
Robert Lawrence,1877-06-28,0,1902,1902,6,28,USA
Edwin Forrest,1864-06-30,4,1886,1890,6,30,USA
Elmer Ward,1875-03-09,1,1903,1904,3,9,USA
Frank Eugene,1852-12-10,0,1878,1878,12,10,USA
John Joseph Albert,1882-01-09,4,1908,1912,1,9,USA
James John,1885-03-13,7,1907,1914,3,13,USA
Seymour,1919-05-04,4,1942,1946,5,4,USA
Terry Fennell,1959-08-18,4,1985,1989,8,18,USA
Ronald Mark,1948-08-23,9,1969,1978,8,23,USA
Benjamin Earl,1970-12-30,0,1995,1995,12,30,USA
Joseph Myles,1853-09-17,2,1875,1877,9,17,USA
James Henry,1917-07-26,14,1937,1951,7,26,USA
Clyde Stalcup,1936-01-05,1,1963,1964,1,5,USA
William Paul,1977-11-27,13,2002,2015,11,27,USA
Gregory Brent,1971-06-26,1,1993,1994,6,26,USA
John Leonard,1902-08-24,0,1924,1924,8,24,USA
Michael Roy,1965-04-24,10,1989,1999,4,24,Germany
Bird Wayne,1877-12-09,0,1908,1908,12,9,USA
Oswald Louis,1900-10-24,17,1922,1939,10,24,USA
Otto Adam,1909-07-20,1,1932,1933,7,20,USA
James,1887-07-08,2,1914,1916,7,8,USA
Luzerne Atwell,1897-03-05,12,1921,1933,3,5,USA
Vida Rochelle,1949-07-28,17,1969,1986,7,28,USA
Harvey Fred,1894-06-27,0,1918,1918,6,27,USA
James Andrew,1972-05-18,0,1996,1996,5,18,USA
Clinton Willis,1898-10-17,1,1922,1923,10,17,USA
Geoffrey Edward,1973-04-26,13,1999,2012,4,26,USA
Rik Aalbert,1951-04-06,22,1970,1992,4,6,Netherlands
Michael John,1928-12-25,1,1953,1954,12,25,USA
Chester Robert,1935-06-19,1,1960,1961,6,19,USA
Charles Louis,1893-03-27,2,1913,1915,3,27,USA
Frederick Stanley,1851-02-18,0,1874,1874,2,18,USA
Mark Randall,1948-01-01,1,1968,1969,1,1,USA
Hiram Colon,1976-03-04,7,2000,2007,3,4,P.R.
John Dominic,1941-06-29,11,1963,1974,6,29,USA
Milton Francis,1912-07-16,1,1933,1934,7,16,USA
Bruce Anton,1950-11-12,12,1974,1986,11,12,USA
Douglas Eugene,1970-07-05,5,1995,2000,7,5,USA
Bruce Douglas,1955-04-16,9,1978,1987,4,16,France
Brett,1987-08-27,1,2014,2015,8,27,USA
Joseph Edward,1920-07-26,3,1946,1949,7,26,USA
Randy Walter,1960-10-05,3,1986,1989,10,5,USA
Brian William,1985-03-09,2,2008,2010,3,9,USA
Michael James,1957-08-23,13,1980,1993,8,23,USA
Frank Stephen,1887-10-08,10,1911,1921,10,8,USA
Norman Doxie,1892-08-25,6,1917,1923,8,25,USA
George Henry,1892-01-02,14,1912,1926,1,2,USA
John Joseph,1891-03-20,8,1912,1920,3,20,USA
Leonard Joseph Stephen,1941-06-28,4,1967,1971,6,28,USA
Brian Edward,1969-01-08,9,1995,2004,1,8,USA
Lawrence Hyer,1905-01-21,0,1932,1932,1,21,USA
Brennan Philip,1985-04-12,5,2010,2015,4,12,USA
Joseph Martin,1960-10-04,11,1985,1996,10,4,USA
Xander Jan,1992-10-01,6,2013,2019,10,1,Aruba
John Renzie,1900-09-21,0,1920,1920,9,21,USA
Timothy Paul,1966-10-28,8,1993,2001,10,28,USA
Terry Wayne,1955-09-28,0,1982,1982,9,28,USA
Brandon Kyle,1983-01-09,3,2008,2011,1,9,USA
Mitchell Thomas,1984-02-15,5,2008,2013,2,15,USA
Raymond Joseph,1904-12-12,0,1928,1928,12,12,USA
Thomas Winton,1955-10-25,9,1976,1985,10,25,USA
Wade Anthony,1958-06-15,17,1982,1999,6,15,USA
Warren Frederick,1946-10-19,0,1968,1968,10,19,USA
Brian Thomas,1984-02-18,5,2010,2015,2,18,USA
Brian Edward,1968-08-01,11,1990,2001,8,1,USA
Leo Ignatius,1890-09-30,1,1913,1914,9,30,USA
John Kelly,1961-01-18,0,1982,1982,1,18,USA
Samuel Arthur,1896-10-22,10,1916,1926,10,22,USA
Thomas Joseph,1980-01-17,2,2006,2008,1,17,USA
Bruce Armand,1952-12-09,5,1974,1979,12,9,USA
Danny Jon,1953-03-22,4,1978,1982,3,22,USA
Richard Werner,1926-10-26,2,1951,1953,10,26,USA
Robert Anthony,1908-02-23,1,1933,1934,2,23,USA
Joseph,1910-04-04,0,1936,1936,4,4,USA
Bernard Anthony,1892-01-21,6,1915,1921,1,21,USA
Edward John,1908-04-18,10,1934,1944,4,18,USA
Ronald,1996-08-23,0,2019,2019,8,23,Cuba
Charles Dickens,1894-10-27,0,1914,1914,10,27,Sweden
William Horace,1893-05-09,0,1919,1919,5,9,USA
Stewart O'Neal,1902-10-12,6,1926,1932,10,12,USA
Carl Theodore,1934-10-31,0,1962,1962,10,31,USA
John,1948-08-19,NA,NA,NA,8,19,USA
John Peter,1896-07-19,5,1927,1932,7,19,USA
James Cyril,1932-02-23,9,1950,1959,2,23,USA
Frank Charles,1966-06-28,5,1993,1998,6,28,USA
Bobby Donald,1939-01-29,12,1961,1973,1,29,USA
Frank Elmore,1931-11-16,12,1954,1966,11,16,USA
John Edward,1917-02-20,5,1939,1944,2,20,USA
Milton Joseph,1930-08-09,6,1952,1958,8,9,USA
Gregory Gene,1943-11-16,1,1965,1966,11,16,USA
Donald Raymond,1921-02-12,5,1950,1955,2,12,USA
Michael P.,1988-01-29,3,2014,2017,1,29,USA
Cecil Glenford,1904-02-13,0,1928,1928,2,13,USA
William Clifton,1907-04-10,10,1931,1941,4,10,USA
Rodney Earl,1968-09-23,2,1993,1995,9,23,USA
Thomas Edward,1962-05-06,7,1987,1994,5,6,USA
Skye Michael,1994-01-15,0,2019,2019,1,15,USA
Mark Vincent,1953-04-14,4,1978,1982,4,14,USA
Jeremy Allen,1982-10-28,10,2003,2013,10,28,USA
Barry Lamar,1964-07-24,21,1986,2007,7,24,USA
Bobby Lee,1946-03-15,13,1968,1981,3,15,USA
Thomas Henry,1856-04-02,10,1874,1884,4,2,Ireland
Walter Franklin,1937-10-19,7,1960,1967,10,19,USA
George Drummond,1874-08-28,0,1901,1901,8,28,USA
Ricardo Ricky,1969-04-07,10,1991,2001,4,7,P.R.
Julio Giacomo,1911-07-14,3,1937,1940,7,14,Italy
Henry Tate,1903-10-28,0,1927,1927,10,28,USA
Anthony Thomas,1911-12-21,1,1938,1939,12,21,USA
Jung Keun,1980-07-15,2,2002,2004,7,15,South Korea
William Gordon,1948-10-01,9,1971,1980,10,1,USA
Ernest Edward,1913-08-16,9,1940,1949,8,16,USA
Emilio Jose,1985-04-23,10,2007,2017,4,23,D.R.
Jorge Luis,1993-06-04,2,2017,2019,6,4,D.R.
Joseph Peter,1941-01-16,0,1962,1962,1,16,USA
Roberto Martin Antonio,1963-02-23,15,1986,2001,2,23,USA
Juan Guillermo,1956-01-12,6,1981,1987,1,12,P.R.
Lisalverto,1990-06-18,3,2014,2017,6,18,D.R.
Eddie Keith,1981-06-06,2,2008,2010,6,6,USA
Ernest Luther,1888-01-13,1,1913,1914,1,13,USA
Robert Barry,1953-10-27,9,1977,1986,10,27,USA
William John,1923-12-15,0,1944,1944,12,15,USA
Robert Averill,1956-08-12,3,1980,1983,8,12,USA
Frank J.,1869-08-20,9,1894,1903,8,20,USA
Adlai Wendell,1894-08-29,0,1920,1920,8,29,USA
Boof,1981-10-14,4,2006,2010,10,14,USA
Henry John,1908-09-20,6,1934,1940,9,20,USA
Everett Little,1891-09-28,1,1913,1914,9,28,USA
Richard Lee,1942-05-28,2,1966,1968,5,28,USA
Christopher Scott,1976-12-09,2,2005,2007,12,9,USA
Gregory Scott,1960-06-22,7,1983,1990,6,22,USA
Roderick Stewart,1958-09-04,4,1987,1991,9,4,USA
Albert,1897-08-24,3,1928,1931,8,24,USA
Seabron Jesse,1880-07-14,0,1909,1909,7,14,USA
Aaron John,1973-03-09,12,1997,2009,3,9,USA
Robert Raymond,1947-11-19,18,1972,1990,11,19,USA
Bret Robert,1969-04-06,13,1992,2005,4,6,USA
James Albert,1895-01-19,4,1919,1923,1,19,USA
Daniel Hugh,1954-01-14,9,1981,1990,1,14,USA
George Morris,1871-03-01,0,1891,1891,3,1,USA
Isaac Morgan,1897-02-17,10,1922,1932,2,17,USA
Lute Joseph,1890-05-06,5,1913,1918,5,6,USA
Raymond Otis,1923-07-27,12,1948,1960,7,27,USA
Christopher Brandon,1978-10-24,10,2003,2013,10,24,USA
Amos Smith,1848-09-04,6,1876,1882,9,4,USA
Joshua Gibson,1975-04-29,2,1996,1998,4,29,USA
John Morgan,1938-07-06,7,1962,1969,7,6,USA
Julio Alberto,1986-02-20,7,2009,2016,2,20,USA
Pedro,1946-12-02,11,1969,1980,12,2,D.R.
Pedro Felix,1967-11-15,11,1992,2003,11,15,D.R.
George Bernard,1869-04-18,7,1888,1895,4,18,USA
Joseph Edward,1978-11-25,5,2002,2007,11,25,USA
Stanley George,1910-01-03,11,1934,1945,1,3,USA
Joseph Emley,1854-05-09,1,1875,1876,5,9,USA
Patrick Lance,1963-05-14,17,1988,2005,5,14,USA
Michael Todd,1965-07-21,13,1990,2003,7,21,USA
Richard Albert,1959-04-18,8,1980,1988,4,18,USA
William Clarke,1958-01-09,0,1980,1980,1,9,USA
Glenn Dennis,1950-05-25,8,1972,1980,5,25,USA
Paul Stanley,1955-12-13,0,1982,1982,12,13,USA
Frank Bernard,1940-07-13,0,1964,1964,7,13,USA
Robert Vilarian,1926-01-27,5,1950,1955,1,27,USA
David Richard,1977-02-07,9,1999,2008,2,7,USA
Thomas Bruce,1933-02-14,1,1960,1961,2,14,USA
Toby Shawn,1969-05-29,10,1994,2004,5,29,USA
John William,1993-04-04,0,2017,2017,4,4,USA
Edward Jones,1915-10-30,1,1944,1945,10,30,USA
Stephen,1936-09-03,8,1957,1965,9,3,USA
Henry Ludwig,1916-05-12,9,1942,1951,5,12,USA
Joseph Thomas,1971-05-04,13,1995,2008,5,4,USA
William Baker,1888-08-14,4,1912,1916,8,14,USA
Ryan Joseph,1994-03-31,1,2018,2019,3,31,USA
Jean Carlos,1979-12-26,3,2010,2013,12,26,Venezuela
Wilfredo Jose,1989-10-26,0,2016,2016,10,26,Venezuela
Donald John,1942-07-15,3,1966,1969,7,15,USA
Richard Alan,1953-08-05,6,1976,1982,8,5,USA
Jeffrey Alan,1988-05-09,6,2013,2019,5,9,USA
Christopher Louis,1963-04-03,10,1986,1996,4,3,USA
Shawn Kealoha,1967-03-28,8,1990,1998,3,28,USA
Thaddis,1956-09-17,13,1977,1990,9,17,USA
Richard Allen,1944-02-17,10,1966,1976,2,17,USA
Melvin Edward,1914-02-08,0,1945,1945,2,8,USA
Elmer Harley,1908-11-19,5,1928,1933,11,19,USA
Christopher Michael,1993-03-24,1,2017,2018,3,24,USA
Henry Landers,1895-01-12,0,1915,1915,1,12,USA
Daryl Lamont,1963-01-04,10,1984,1994,1,4,USA
Lyman Wesley,1950-11-22,3,1975,1978,11,22,USA
Andrew Cottrell,1873-09-26,0,1895,1895,9,26,USA
David Wilson,1945-01-20,7,1964,1971,1,20,USA
Kenneth George,1946-02-23,10,1967,1977,2,23,USA
David C.,1993-04-07,1,2018,2019,4,7,USA
Derek Wayne,1956-08-02,3,1982,1985,8,2,USA
John Charles,1908-09-14,0,1937,1937,9,14,USA
Ricky Paul,1969-08-26,11,1994,2005,8,26,USA
Kent Dennis,1968-11-14,9,1992,2001,11,14,USA
Ralph Wayne,1955-05-12,1,1979,1980,5,12,USA
James Leroy,1900-04-23,15,1922,1937,4,23,USA
Jason Carl,1980-07-26,3,2005,2008,7,26,USA
Robert Allen,1935-04-28,0,1962,1962,4,28,USA
Alexander Francis,1881-11-13,0,1914,1914,11,13,USA
Denis,1968-03-07,3,1991,1994,3,7,CAN
Edward Francis,1933-03-07,6,1956,1962,3,7,USA
Medric Charles Francis,1886-03-12,0,1914,1914,3,12,USA
Louis,1917-07-17,14,1938,1952,7,17,USA
Carl Edward,1939-09-17,3,1961,1964,9,17,USA
Jacob John,1884-08-06,2,1907,1909,8,6,USA
Jason Jerrod,1982-01-04,7,2008,2015,1,4,USA
Steven James,1972-08-04,0,1996,1996,8,4,USA
Christopher,1954-10-16,0,1980,1980,10,16,USA
Peter Christopher,1987-03-31,9,2010,2019,3,31,USA
Justin James,1988-05-28,5,2014,2019,5,28,USA
Michael Ray,1982-12-27,10,2006,2016,12,27,USA
Rafael Antonio,1966-05-12,7,1992,1999,5,12,D.R.
James Buchanan,1993-07-09,0,2019,2019,7,9,USA
Patrick Daniel,1947-03-23,3,1971,1974,3,23,USA
James Alan,1939-03-08,16,1962,1978,3,8,USA
Michael Craig,1973-08-21,0,1997,1997,8,21,USA
Lawrence Robert,1945-12-06,15,1970,1985,12,6,USA
Benjamin James,1879-10-28,0,1903,1903,10,28,USA
Michael Matthew,1986-09-09,5,2008,2013,9,9,USA
David Timon,1891-08-15,0,1914,1914,8,15,USA
Emmons Joseph,1897-07-26,0,1919,1919,7,26,USA
Sutherland McCoy,1871-02-17,0,1896,1896,2,17,USA
Robert McClure,1981-02-24,5,2003,2008,2,24,USA
Ryan Eugene,1968-02-10,4,1991,1995,2,10,USA
Samuel Edward,1938-03-23,6,1963,1969,3,23,USA
Samuel Thomas,1952-09-18,3,1977,1980,9,18,USA
Grover Bill,1922-03-25,0,1949,1949,3,25,USA
Brent Raymond,1971-05-02,0,1996,1996,5,2,USA
Cedrick Jerome,1978-02-10,2,2008,2010,2,10,USA
Frank Eugene,1868-12-05,14,1895,1909,12,5,USA
Shane Patrick,1971-07-27,0,1997,1997,7,27,USA
Stewart Cole,1915-02-26,2,1935,1937,2,26,USA
James R.,1965-02-17,0,1994,1994,2,17,Japan
Micah Andrew,1974-11-10,9,1999,2008,11,10,USA
John Brite,1983-07-08,3,2008,2011,7,8,USA
Brian Christopher,1976-08-18,2,2001,2003,8,18,USA
Charles James,1917-03-15,2,1943,1945,3,15,USA
Emmett Jerome,1898-08-02,0,1922,1922,8,2,USA
Grant Tierney,1907-10-24,1,1931,1932,10,24,USA
Stephen Shaddon,1952-06-26,1,1976,1977,6,26,USA
Lois Weldon,1940-12-10,0,1967,1967,12,10,USA
Alvah Edson,1893-01-25,1,1914,1915,1,25,USA
William G.,1867-01-23,0,1891,1891,1,23,USA
Robert James,1910-10-03,3,1939,1942,10,3,USA
Robert Leroy,1931-05-10,4,1955,1959,5,10,USA
Elmari Wilhelm,1897-03-19,0,1920,1920,3,19,USA
Ernest Ferrell,1935-07-28,2,1961,1963,7,28,USA
Joseph Emil,1910-06-17,13,1932,1945,6,17,USA
Matthew Chou,1991-05-31,3,2016,2019,5,31,USA
Roger Clinton,1927-08-18,6,1949,1955,8,18,USA
Sumner Sallade,1867-02-09,1,1890,1891,2,9,USA
James Harvey,1881-09-20,0,1910,1910,9,20,USA
Edward Oliver,1935-01-10,6,1958,1964,1,10,CAN
Travis Charlton,1981-08-03,0,2005,2005,8,3,USA
Bradley George,1988-05-27,7,2012,2019,5,27,USA
William John,1852-12-22,3,1872,1875,12,22,USA
Robert Richard,1919-10-01,10,1951,1961,10,1,USA
Frank Jay,1868-04-02,0,1893,1893,4,2,USA
Gary Lee,1946-08-22,0,1969,1969,8,22,USA
Jacob Henry,1874-01-19,2,1894,1896,1,19,USA
Jason Pernell,1973-02-23,5,1999,2004,2,23,USA
Matthew Robert,1991-02-02,4,2015,2019,2,2,USA
Dennis Ray,1959-10-06,9,1982,1991,10,6,USA
Raymond C.,1887-02-11,1,1910,1911,2,11,USA
Blaine Thomas,1981-07-11,13,2005,2018,7,11,USA
Cloyd Victor,1927-09-01,6,1949,1955,9,1,USA
Cletis Leroy,1937-02-09,16,1955,1971,2,9,USA
Kenton Lloyd,1931-05-20,14,1955,1969,5,20,USA
Dorian Scott,1955-01-06,3,1978,1981,1,6,USA
Ralph Francis,1908-02-09,6,1929,1935,2,9,USA
Edward Joseph,1874-05-08,0,1896,1896,5,8,USA
Harry,1911-11-29,1,1938,1939,11,29,USA
Henry J.,1860-09-20,5,1884,1889,9,20,USA
John Anthony,1866-03-22,12,1886,1898,3,22,USA
John Bellew,1889-07-09,0,1912,1912,7,9,USA
James John,1904-01-19,0,1926,1926,1,19,USA
Marshall Wayne,1971-05-23,0,1996,1996,5,23,USA
Eugene Mathew,1941-08-16,4,1966,1970,8,16,USA
Brad,1986-04-12,8,2011,2019,4,12,USA
Silvino,1992-07-17,3,2015,2018,7,17,Venezuela
Andrew Warren,1985-12-04,0,2011,2011,12,4,USA
Gilbert Herman,1908-03-29,2,1937,1939,3,29,USA
John James,1881-04-14,0,1901,1901,4,14,USA
John Givler,1880-12-24,0,1904,1904,12,24,USA
William Zachary,1987-08-23,1,2010,2011,8,23,USA
Dallas Lee,1983-08-13,4,2007,2011,8,13,USA
Donald Eugene,1934-10-04,0,1964,1964,10,4,USA
William D.,1921-08-28,0,1956,1956,8,28,USA
Charles William,1944-07-25,10,1966,1976,7,25,USA
Chadwick Lee,1974-09-14,11,1998,2009,9,14,USA
Chasen David,1989-08-05,2,2017,2019,8,5,USA
Larry,1949-12-21,4,1977,1981,12,21,USA
Henry Victor,1915-03-05,0,1943,1943,3,5,USA
Albert Joseph,1856-05-23,0,1884,1884,5,23,USA
Archie N.,1992-08-10,4,2015,2019,8,10,USA
Steven Bert,1956-12-23,0,1983,1983,12,23,USA
William Joseph,1878-02-13,16,1899,1915,2,13,USA
Bobby,1996-05-29,0,2019,2019,5,29,USA
George H.,1855-07-01,0,1876,1876,7,1,USA
Fred Langdon,1920-07-31,1,1948,1949,7,31,USA
George Washington,1852-07-13,13,1875,1888,7,13,USA
George Washington,1914-04-01,0,1946,1946,4,1,USA
Herbert Theodore,1903-01-03,2,1927,1929,1,3,USA
Hugh Frederick,1885-05-23,5,1910,1915,5,23,USA
John Thomas,1893-09-20,0,1916,1916,9,20,USA
Jackie,1990-04-19,6,2013,2019,4,19,USA
Jedidiah Custer,1990-06-12,0,2016,2016,6,12,USA
Mark Allen,1956-12-03,2,1981,1983,12,3,USA
Milton Obelle,1978-04-15,11,2000,2011,4,15,USA
Philip Poole,1959-03-11,7,1983,1990,3,11,USA
Ryan J.,1975-10-26,0,1998,1998,10,26,USA
Scott William,1960-03-22,8,1984,1992,3,22,USA
Thomas William,1947-03-16,6,1969,1975,3,16,USA
Dallas Carl,1895-11-23,0,1917,1917,11,23,USA
George Thomas,1924-09-12,0,1952,1952,9,12,USA
Joseph Siah,1897-08-17,0,1929,1929,8,17,USA
Terry Leon,1969-02-03,1,1995,1996,2,3,USA
William Aloysius,1889-08-18,0,1912,1912,8,18,USA
Robert Jay,1922-11-08,1,1946,1947,11,8,USA
Brian Phelan,1962-07-11,0,1989,1989,7,11,USA
Clifford Francis,1897-03-06,0,1920,1920,3,6,USA
Stephen Douglas,1969-11-23,0,1995,1995,11,23,USA
James Joseph,1936-03-02,0,1956,1956,3,2,USA
James Ward,1881-05-28,7,1905,1912,5,28,USA
Michael James,1987-03-21,0,2017,2017,3,21,USA
Cornelius Joseph,1897-03-04,10,1915,1925,3,4,USA
Stephen A.,1851-07-14,12,1874,1886,7,14,USA
Robert Randall,1917-10-30,8,1940,1948,10,30,USA
Darren William,1969-09-07,10,1994,2004,9,7,USA
Richard Realf,1877-12-25,0,1901,1901,12,25,USA
Glenn Erick,1962-10-17,6,1986,1992,10,17,USA
David Leonard,1879-01-24,7,1901,1908,1,24,United Kingdom
Frederick F.,1892-02-17,2,1914,1916,2,17,USA
Alfred,1892-02-15,0,1915,1915,2,15,USA
Ervin Beckham,1901-10-12,4,1928,1932,10,12,USA
Arthur Washington,1909-02-22,0,1935,1935,2,22,USA
Albert,1919-05-29,6,1939,1945,5,29,USA
Harvey Alfred,1939-02-08,0,1962,1962,2,8,USA
Norman Downs,1915-03-22,1,1941,1942,3,22,USA
Ralph Theodore Joseph,1926-01-06,12,1944,1956,1,6,USA
Roy,1953-07-12,0,1979,1979,7,12,USA
William George,1915-03-21,2,1941,1943,3,21,USA
Darrell G.,1940-07-08,7,1966,1973,7,8,USA
Chester Milton,1887-03-31,7,1908,1915,3,31,USA
Edward Arthur,1905-02-17,10,1928,1938,2,17,USA
John George,1934-04-28,11,1956,1967,4,28,USA
Mark Clay,1970-07-14,2,1995,1997,7,14,USA
Ronald George,1940-01-13,8,1963,1971,1,13,USA
Michael J.,1851-10-25,4,1871,1875,10,25,USA
Otis Owen,1899-03-13,1,1928,1929,3,13,USA
Edgar Dudley,1897-11-30,0,1927,1927,11,30,USA
Jeffery Glenn,1967-01-26,9,1992,2001,1,26,USA
William Edward,1875-01-07,13,1898,1911,1,7,USA
Clifford,1968-04-12,1,1991,1992,4,12,USA
Jeffrey Hoke,1963-09-05,13,1988,2001,9,5,USA
Marshall Lee,1955-09-17,3,1980,1983,9,17,USA
Michael Charles,1961-06-17,3,1986,1989,6,17,USA
Michael Charles,1987-05-15,10,2009,2019,5,15,USA
Robert Jacob,1989-07-14,7,2012,2019,7,14,USA
Russell Oles,1975-12-19,13,1998,2011,12,19,USA
Norman Cobb,1877-08-27,0,1899,1899,8,27,USA
Roy Parks,1874-01-03,1,1902,1903,1,3,USA
Ryan David,1987-08-26,6,2013,2019,8,26,USA
Joseph Warwick,1898-07-22,0,1924,1924,7,22,USA
Frederick Oscar,1892-01-16,6,1921,1927,1,16,USA
Steven Joseph,1992-04-29,3,2016,2019,4,29,USA
John Paul,1939-12-26,0,1964,1964,12,26,USA
Ryan Zachary,1980-07-29,1,2006,2007,7,29,CAN
Ryan Joseph,1983-11-17,12,2007,2019,11,17,USA
Stephen Russell,1948-05-08,14,1971,1985,5,8,USA
Angel Alfonso,1942-08-04,2,1969,1971,8,4,Venezuela
Edgar Garland,1900-06-10,12,1921,1933,6,10,USA
William Paul,1983-06-05,6,2006,2012,6,5,USA
Clarence Wilbur,1913-04-01,0,1941,1941,4,1,USA
Craig Walter,1980-05-10,3,2004,2007,5,10,USA
Dewon Cortez,1980-06-16,4,2002,2006,6,16,USA
Frank Leo,1899-08-11,1,1921,1922,8,11,USA
Alpha Eugene,1913-10-19,11,1943,1954,10,19,USA
Yhency Jose,1980-06-11,7,2004,2011,6,11,D.R.
Lesli Guillermo,1973-10-12,1,2000,2001,10,12,D.R.
Sidney Eugene,1960-08-03,11,1983,1994,8,3,USA
James Leo,1949-10-03,9,1969,1978,10,3,USA
John Fulboam,1990-05-30,2,2017,2019,5,30,USA
Harry David,1914-10-14,13,1940,1953,10,14,USA
William Robertson,1907-10-16,0,1929,1929,10,16,USA
Brent David,1971-09-13,2,1996,1998,9,13,USA
Danny Richard,1942-06-27,2,1969,1971,6,27,USA
Harold Noel,1944-06-28,4,1971,1975,6,28,USA
Marvin Eugene,1934-03-08,3,1960,1963,3,8,USA
Alexander David,1994-03-30,3,2016,2019,3,30,USA
Fred Lawrence,1955-11-15,4,1980,1984,11,15,USA
Alonzo,1857-11-09,0,1883,1883,11,9,USA
Theodore J.,1869-06-01,10,1891,1901,6,1,USA
Herbert Frederick,1913-10-25,2,1937,1939,10,25,USA
Olaf Selmar,1890-09-01,0,1914,1914,9,1,USA
Robert Earl,1954-02-25,8,1981,1989,2,25,USA
Addison Foster,1887-07-18,8,1910,1918,7,18,USA
Delbert Henry,1887-07-18,0,1912,1912,7,18,USA
Brandon Sean Michael,1991-07-26,0,2019,2019,7,26,USA
James Donald,1903-12-02,4,1933,1937,12,2,USA
Jack,1863-09-15,6,1884,1890,9,15,USA
James Leroy,1941-02-13,0,1965,1965,2,13,USA
Thomas Martin,1952-10-30,4,1981,1985,10,30,USA
William Raymond,1963-01-15,5,1988,1993,1,15,USA
Bryce Everett,1988-12-30,2,2014,2016,12,30,USA
Lynn Davis,1889-10-07,8,1913,1921,10,7,USA
William Richard,1910-03-03,3,1932,1935,3,3,USA
Craig Andrew,1980-08-08,12,2005,2017,8,8,USA
Roger Philip,1879-06-11,18,1897,1915,6,11,USA
Edward Francis,1932-05-02,11,1956,1967,5,2,USA
Raymond Bloom,1894-10-23,18,1914,1932,10,23,USA
John Frederick,1891-07-15,2,1913,1915,7,15,USA
George Howard,1953-05-15,20,1973,1993,5,15,USA
Herbert James,1900-05-23,1,1924,1925,5,23,USA
Kenneth Alven,1948-09-18,14,1967,1981,9,18,USA
Ryan Duane,1991-10-09,0,2015,2015,10,9,USA
Marvin Howard,1914-04-29,4,1939,1943,4,29,USA
William Robert,1968-04-15,6,1993,1999,4,15,USA
Charles Robert,1988-04-07,0,2013,2013,4,7,USA
Colten B.,1992-10-29,1,2018,2019,10,29,USA
Jack Herndon,1918-04-21,2,1944,1946,4,21,USA
James Thomas,1937-11-14,16,1960,1976,11,14,USA
Michael Quinn,1959-10-24,0,1986,1986,10,24,USA
Rodney Lee,1966-02-24,3,1990,1993,2,24,USA
Thomas Austin,1931-09-03,7,1954,1961,9,3,USA
Anthony Bruce,1957-11-25,0,1984,1984,11,25,USA
Jamie Chancellor,1971-09-28,5,1995,2000,9,28,USA
Charles Lawrence,1916-12-27,3,1943,1946,12,27,USA
Alan Healey,1937-10-01,0,1961,1961,10,1,USA
Austin Robert,1992-06-19,3,2016,2019,6,19,Hong Kong
Jose,1992-09-19,0,2018,2018,9,19,Venezuela
George Frederick,1906-11-09,7,1926,1933,11,9,USA
Fritz Darrell,1935-03-19,3,1958,1961,3,19,USA
George Vincent,1894-07-19,0,1913,1913,7,19,USA
Ralph Harold,1925-05-02,0,1952,1952,5,2,USA
James Ehrenfeld,1927-02-13,6,1951,1957,2,13,USA
Marshall,1931-06-02,6,1959,1965,6,2,USA
Everett Lamar,1927-08-07,10,1951,1961,8,7,USA
Thomas Jefferson Davis,1906-12-28,16,1930,1946,12,28,USA
Albert Henry,1884-01-04,10,1905,1915,1,4,USA
Parker Alan,1991-08-02,2,2016,2018,8,2,USA
Anthony Vincent,1892-07-03,5,1912,1917,7,3,USA
Herbert Theodore,1875-07-08,9,1896,1905,7,8,USA
Dan Lee,1952-11-18,7,1975,1982,11,18,USA
Grant,1865-03-16,5,1890,1895,3,16,USA
Jonathan Tift,1934-01-24,4,1956,1960,1,24,USA
John Edward,1944-03-10,11,1964,1975,3,10,USA
Harry James,1929-09-22,7,1958,1965,9,22,USA
Jacob Daniel,1988-02-10,0,2015,2015,2,10,USA
Jeff John,1992-02-16,1,2018,2019,2,16,USA
Reid Michael,1986-01-16,8,2008,2016,1,16,USA
Gregory,1965-05-24,5,1988,1993,5,24,USA
Nelson Kelley,1943-08-05,13,1965,1978,8,5,USA
Francis Hasbrouck,1864-03-28,0,1884,1884,3,28,USA
James Benson,1903-09-28,9,1922,1931,9,28,USA
William Hutchinson,1883-08-30,0,1912,1912,8,30,USA
Bradford Albert,1965-01-20,2,1992,1994,1,20,USA
Charles Ernest,1944-09-16,5,1969,1974,9,16,USA
Edwin Albert,1941-12-08,14,1961,1975,12,8,USA
Leon Clarence,1926-10-20,0,1952,1952,10,20,USA
Lewis Lamont,1994-05-08,2,2017,2019,5,8,USA
Charles F.,1858-08-13,8,1880,1888,8,13,USA
John Eric,1967-09-22,5,1991,1996,9,22,USA
Leland Victor,1924-06-05,6,1947,1953,6,5,USA
James David,1933-06-23,NA,NA,NA,6,23,USA
George Gates,1870-05-13,0,1899,1899,5,13,USA
Bernardo,1963-12-04,3,1992,1995,12,4,D.R.
Eude Ezequiel,1978-08-19,1,2005,2006,8,19,D.R.
Jorge Manuel,1966-06-22,1,1995,1996,6,22,D.R.
Juan Ramon,1979-11-07,2,2002,2004,11,7,D.R.
Socrates Orel,1992-09-06,4,2015,2019,9,6,D.R.
Tilson Manuel,1972-05-28,1,1996,1997,5,28,D.R.
Christopher Daniel,1982-12-16,2,2006,2008,12,16,USA
John Drake,1989-05-22,1,2013,2014,5,22,USA
Stephen Gilbert,1891-09-21,0,1913,1913,9,21,USA
August Schuster,1909-11-29,0,1937,1937,11,29,USA
John Albert,1924-03-04,1,1950,1951,3,4,USA
James Allan,1944-03-25,4,1967,1971,3,25,USA
Zackary Grant,1987-12-22,8,2011,2019,12,22,USA
Anthony John,1957-01-14,5,1979,1984,1,14,USA
John Joseph,1909-10-03,5,1934,1939,10,3,USA
Lance Daniel,1983-08-20,2,2007,2009,8,20,USA
Michael Allen,1987-03-30,1,2015,2016,3,30,USA
Peter Sven,1950-03-02,7,1971,1978,3,2,USA
Douglas Keith,1967-05-16,17,1992,2009,5,16,USA
Terrence Christopher,1970-02-05,5,1997,2002,2,5,USA
Gregory Allen,1957-06-14,9,1982,1991,6,14,USA
John Roy,1896-10-16,1,1917,1918,10,16,USA
Lewis Albert,1880-07-23,4,1907,1911,7,23,USA
Louis Clark,1939-06-18,18,1961,1979,6,18,USA
Tarrik Jumaan,1973-12-25,0,2000,2000,12,25,USA
Brian Michael,1986-09-01,0,2011,2011,9,1,USA
Matthew Thomas,1877-12-01,0,1903,1903,12,1,USA
Walter Scott,1868-09-11,12,1890,1902,9,11,USA
Richard Stanley,1932-07-26,7,1952,1959,7,26,USA
Ernest Gilbert,1935-08-27,7,1959,1966,8,27,USA
Rico Joseph,1970-04-18,9,1992,2001,4,18,USA
John Anthony,1950-02-26,8,1972,1980,2,26,USA
Michael Troy,1973-01-14,2,2001,2003,1,14,USA
Kenneth Leroy,1921-10-17,0,1944,1944,10,17,USA
Herman Charles,1885-03-30,12,1910,1922,3,30,USA
Jacob Jeffery,1965-09-18,2,1993,1995,9,18,Afghanistan
James Warren,1936-06-22,5,1959,1964,6,22,USA
Aaron Lee,1990-04-27,5,2014,2019,4,27,USA
Robert,1945-11-01,4,1969,1973,11,1,USA
Frank J.,1978-09-06,1,2004,2005,9,6,USA
Frederick H.,1862-04-19,0,1886,1886,4,19,USA
Hubert,1956-09-24,14,1980,1994,9,24,USA
Edward Dwain,1949-01-03,0,1975,1975,1,3,USA
Jerome Edward,1967-03-23,3,1993,1996,3,23,USA
Jonathan,1897-08-18,1,1925,1926,8,18,USA
Thomas Dale,1953-08-10,11,1979,1990,8,10,USA
Scott David,1966-08-15,10,1991,2001,8,15,USA
Sigmund Theodore,1911-03-23,0,1940,1940,3,23,USA
James Patrick,1929-10-24,9,1954,1963,10,24,USA
Franklin Lee,1944-07-31,2,1969,1971,7,31,USA
Michael Dillon,1994-03-15,0,2019,2019,3,15,USA
Terrance Paul,1966-03-30,2,1991,1993,3,30,USA
Rex Colman,1987-12-18,7,2011,2018,12,18,USA
Anton Christian,1891-04-30,5,1916,1921,4,30,USA
Cecil Calvert,1860-12-28,5,1883,1888,12,28,USA
Mark Steven,1956-05-22,5,1980,1985,5,22,USA
Benjamin Isaac,1976-09-24,6,2002,2008,9,24,USA
Arthur Henry,1882-11-25,0,1906,1906,11,25,USA
Dennis Joseph,1858-05-08,25,1879,1904,5,8,USA
Joseph John,1922-02-18,0,1955,1955,2,18,USA
Robert Richard,1960-01-10,3,1986,1989,1,10,USA
Frank Willard,1893-03-26,4,1920,1924,3,26,USA
James Robert,1972-12-29,8,1999,2007,12,29,USA
Louis Lester,1900-07-01,0,1931,1931,7,1,USA
Adrian Demond,1974-02-07,9,1997,2006,2,7,USA
Alton Leo,1925-04-16,0,1951,1951,4,16,USA
Andrew Aaron,1981-02-17,2,2006,2008,2,17,USA
Andrew Marshall,1984-09-10,3,2011,2014,9,10,USA
Gary Barret,1984-12-28,0,2012,2012,12,28,USA
William Verna,1893-07-08,0,1912,1912,7,8,USA
Carroll William,1889-02-20,4,1911,1915,2,20,USA
Robert Murray,1911-04-01,6,1930,1936,4,1,USA
Robert William,1924-10-25,8,1946,1954,10,25,USA
Rogers Lee,1954-05-25,6,1979,1985,5,25,USA
Brant Michael,1971-06-22,4,1996,2000,6,22,USA
Brooks Steven,1985-06-20,1,2014,2015,6,20,USA
Charles Edward,1881-08-31,8,1905,1913,8,31,USA
Byron Ellis,1942-12-27,7,1965,1972,12,27,USA
Calvin Duane,1938-03-16,0,1960,1960,3,16,USA
Charles Edward,1871-08-17,0,1897,1897,8,17,USA
John Christopher,1961-08-15,5,1984,1989,8,15,USA
Clinton Harold,1903-07-08,14,1928,1942,7,8,USA
Corey Allen,1985-11-26,3,2011,2014,11,26,USA
Charles Roy,1888-12-09,4,1911,1915,12,9,USA
Curtis,1945-09-14,0,1973,1973,9,14,USA
Curtis Steven,1960-01-15,4,1983,1987,1,15,USA
Darrell Wayne,1955-10-29,3,1981,1984,10,29,USA
Daren Dwayne,1967-06-13,NA,NA,NA,6,13,USA
Delos Hight,1892-10-04,0,1914,1914,10,4,USA
Dermal Bram,1978-03-27,9,1998,2007,3,27,USA
Richard Ernest,1935-01-17,8,1957,1965,1,17,USA
Domonic Larun,1987-09-03,5,2010,2015,9,3,USA
Drummond Nicol,1885-01-31,2,1913,1915,1,31,USA
Dustin William,1982-06-19,2,2009,2011,6,19,USA
Earl James,1911-03-05,3,1935,1938,3,5,USA
Edward William,1891-07-17,8,1920,1928,7,17,USA
Elmer Young,1883-08-25,4,1911,1915,8,25,USA
Emil Quincy,1974-12-29,12,1997,2009,12,29,USA
Fred Herbert,1879-04-12,1,1901,1902,4,12,USA
Frank,1882-10-29,0,1910,1910,10,29,USA
Freeman,1845-01-31,NA,NA,NA,1,31,USA
William James,1939-05-02,12,1963,1975,5,2,USA
Gary Allen,1988-09-28,0,2014,2014,9,28,USA
George Edward,1876-01-12,11,1901,1912,1,12,USA
Hector Harold,1924-12-11,13,1951,1964,12,11,USA
Isaac,1942-04-13,5,1969,1974,4,13,USA
Jackie Gene,1943-05-31,7,1970,1977,5,31,USA
Jerald Ray,1948-03-22,0,1975,1975,3,22,USA
Jarvis Ardel,1967-03-26,4,1991,1995,3,26,USA
Jamie Monroe,1977-03-31,0,2004,2004,3,31,USA
Jerome Austin,1966-02-13,9,1986,1995,2,13,V.I.
Jeremy Scott,1979-10-25,0,2006,2006,10,25,USA
James W. H.,1860-12-12,2,1884,1886,12,12,USA
James Donaldson,1891-03-31,1,1915,1916,3,31,USA
James Roberson,1910-04-25,9,1937,1946,4,25,USA
Joseph E.,1859-04-04,1,1884,1885,4,4,CAN
John J.,1876-08-24,0,1897,1897,8,24,USA
Joseph Henry,1900-07-03,0,1927,1927,7,3,USA
Jophery Clifford,1945-01-22,0,1968,1968,1,22,USA
Jordan Cassidy,1983-12-18,3,2010,2013,12,18,USA
Walter George,1907-04-30,16,1925,1941,4,30,USA
James Kevin,1965-03-14,19,1986,2005,3,14,USA
Keith Edward,1964-02-14,4,1988,1992,2,14,USA
Kevin Dewayne,1966-03-05,2,1990,1992,3,5,USA
Kevin Lee,1973-04-21,6,1996,2002,4,21,USA
Larry Leslie,1940-03-01,11,1963,1974,3,1,USA
Lewis J.,1858-02-01,8,1876,1884,2,1,USA
Leon,1948-11-16,0,1976,1976,11,16,USA
John Lindsay,1911-07-22,0,1937,1937,7,22,USA
Lloyd Andrew,1904-12-25,15,1925,1940,12,25,USA
Mace Stanley,1909-05-21,11,1935,1946,5,21,USA
Mark Anthony,1959-07-13,1,1984,1985,7,13,USA
Marty Leo,1963-01-23,2,1988,1990,1,23,USA
Marshall Phillip,1975-06-17,2,1998,2000,6,17,USA
Matthew Benjamin,1982-08-08,1,2007,2008,8,8,USA
Michael Gary,1959-03-24,5,1982,1987,3,24,USA
Michael Charles,1959-12-29,5,1983,1988,12,29,USA
Mordecai Peter Centennial,1876-10-19,13,1903,1916,10,19,USA
Myrl Lincoln,1894-10-10,0,1922,1922,10,10,USA
Norman Ladelle,1919-02-01,3,1943,1946,2,1,USA
Oliver Edward,1849-05-03,3,1872,1875,5,3,USA
Ollie Lee,1944-02-11,12,1965,1977,2,11,USA
Oscar Lee,1946-02-08,4,1969,1973,2,8,USA
Paul Dwayne,1941-06-18,7,1961,1968,6,18,USA
Louis Rogers,1861-06-17,12,1882,1894,6,17,USA
Prentice Almont,1929-03-21,0,1962,1962,3,21,USA
Paul Percival,1889-01-31,0,1909,1909,1,31,USA
Edwin Randolph,1943-08-29,1,1969,1970,8,29,USA
Raymond C.,1908-02-23,NA,NA,NA,2,23,USA
Roosevelt Lawayne,1975-08-03,3,1999,2002,8,3,USA
Samuel Wakefield,1877-05-21,1,1906,1907,5,21,USA
Scott Edward,1956-08-30,0,1981,1981,8,30,USA
Seth William,1992-07-13,0,2019,2019,7,13,USA
Richard P.,1870-08-03,4,1893,1897,8,3,USA
Steven Elbert,1957-02-12,1,1983,1984,2,12,USA
Thomas Tarlton,1860-09-21,16,1882,1898,9,21,United Kingdom
Thomas Michael,1927-12-06,9,1944,1953,12,6,USA
Thomas William,1940-12-12,0,1963,1963,12,12,USA
Thomas Dale,1949-08-10,0,1978,1978,8,10,USA
Thomas Leo,1960-04-28,11,1984,1995,4,28,USA
Trevor Michael,1991-11-15,1,2015,2016,11,15,USA
Walter Irving,1915-04-23,0,1947,1947,4,23,USA
Willard Jessie,1915-06-26,0,1947,1947,6,26,USA
Scott John,1969-03-17,5,1993,1998,3,17,USA
Jonathan Roy,1984-06-16,12,2005,2017,6,16,USA
Keon Darell,1990-05-07,4,2015,2019,5,7,USA
Wilbur Lee,1910-11-07,11,1932,1943,11,7,USA
Bruce Ellsworth,1941-12-29,3,1967,1970,12,29,USA
Robert James,1933-05-16,8,1959,1967,5,16,USA
Jay Allen,1987-04-03,11,2008,2019,4,3,USA
Louis R.,1877-01-16,0,1904,1904,1,16,USA
Andrew,1882-01-01,0,1905,1905,1,1,USA
Earle Francis,1901-05-06,6,1937,1943,5,6,USA
Earle Francis,1925-08-25,0,1948,1948,8,25,USA
Frederick John,1938-05-27,0,1961,1961,5,27,USA
Joseph Timothy,1967-10-08,1,1992,1993,10,8,USA
Frank Leo,1891-05-04,4,1921,1925,5,4,USA
Jaycob Hull,1992-01-18,0,2017,2017,1,18,USA
Michael Edwin,1951-06-24,0,1978,1978,6,24,USA
Clifford Michael,1974-04-21,0,2001,2001,4,21,USA
Jacob Donnell,1965-05-27,7,1992,1999,5,27,USA
Duff Lechaun,1970-08-25,0,1994,1994,8,25,USA
Tony Mike,1938-07-10,2,1964,1966,7,10,USA
Anthony Michael,1963-04-09,8,1987,1995,4,9,USA
Glenn Edward,1954-11-23,4,1981,1985,11,23,USA
Gregory Scott,1967-04-20,0,1993,1993,4,20,USA
Tyson Colby,1984-08-15,0,2012,2012,8,15,USA
Thomas Andrew,1960-08-20,13,1981,1994,8,20,USA
Brian Anthony,1982-02-17,8,2004,2012,2,17,USA
George Stuart,1935-06-08,15,1956,1971,6,8,USA
Jack Raymond,1924-07-01,1,1949,1950,7,1,USA
Justin Thomas,1975-10-07,0,2000,2000,10,7,USA
Walter Roy,1917-02-10,2,1939,1941,2,10,USA
Thomas Michael,1953-01-26,3,1976,1979,1,26,USA
Arlo Adolph,1940-08-15,0,1966,1966,8,15,USA
William Donald,1970-03-20,1,1998,1999,3,20,USA
Eric Kevin,1978-03-29,6,2003,2009,3,29,USA
Robert,1875-03-08,0,1907,1907,3,8,USA
James Scott,1964-10-07,5,1995,2000,10,7,USA
Warren Scott,1952-02-02,8,1977,1985,2,2,USA
William Haron,1925-11-09,11,1953,1964,11,9,USA
Edward T.,1874-08-31,0,1901,1901,8,31,USA
William Ronald,1938-12-04,7,1961,1968,12,4,USA
Henry Claiborne,1911-11-16,5,1935,1940,11,16,USA
Derek Roszell,1951-10-09,0,1979,1979,10,9,USA
Donald Ray,1941-07-13,4,1966,1970,7,13,USA
George F.,1857-02-10,0,1885,1885,2,10,USA
Kristopher Lee,1992-01-04,4,2015,2019,1,4,USA
Ralph Wendell,1961-05-20,2,1985,1987,5,20,USA
Ronald Raymond,1947-11-12,8,1967,1975,11,12,USA
Thomas Ray,1959-01-17,0,1986,1986,1,17,USA
Stephen Robert,1949-02-04,8,1970,1978,2,4,USA
Charles Ruley,1863-07-30,3,1888,1891,7,30,USA
Jaime Lee,1978-06-06,0,2005,2005,6,6,USA
Harold Frederick,1895-09-28,0,1922,1922,9,28,USA
Robert Gordon,1961-05-03,4,1985,1989,5,3,USA
Brian James,1973-07-21,4,2000,2004,7,21,USA
David Andrew,1989-05-11,1,2014,2015,5,11,USA
Jake T.,1989-09-24,3,2014,2017,9,24,USA
James Forrest,1876-07-01,0,1905,1905,7,1,USA
John George,1925-01-22,5,1948,1953,1,22,USA
Gerald Peter,1942-05-09,7,1961,1968,5,9,USA
James Quinter,1911-03-24,11,1934,1945,3,24,USA
Clay Daniel,1984-08-14,12,2007,2019,8,14,USA
Taylor,1981-10-13,5,2006,2011,10,13,USA
Ryan James,1987-02-13,5,2014,2019,2,13,USA
Albert C.,1861-01-31,NA,NA,NA,1,31,USA
Garland Maires,1897-10-16,10,1918,1928,10,16,USA
Gary Scott,1965-07-22,0,1994,1994,7,22,USA
Frederick Bristol,1876-02-13,0,1895,1895,2,13,USA
Johnathan Richard,1980-07-07,10,2004,2014,7,7,USA
Richard D.,1858-09-21,7,1888,1895,9,21,USA
Jesse Robert,1890-05-20,0,1916,1916,5,20,USA
John Edward,1870-03-20,0,1890,1890,3,20,USA
Kevin John,1959-01-16,0,1984,1984,1,16,USA
William Joseph,1949-12-14,21,1969,1990,12,14,USA
William Jennings,1983-08-27,7,2007,2014,8,27,USA
Travis George,1983-11-18,5,2007,2012,11,18,USA
Mark David,1952-12-27,3,1978,1981,12,27,USA
Jay Cook,1865-12-04,0,1890,1890,12,4,USA
Ryan Dean,1979-08-15,3,2007,2010,8,15,USA
Donald Thomas,1934-05-05,6,1956,1962,5,5,USA
Michael Joseph,1970-12-12,4,1998,2002,12,12,USA
Michael Joe,1919-09-15,1,1946,1947,9,15,USA
Mark Joseph,1973-08-26,0,2003,2003,8,26,USA
Steven Bernard,1961-09-26,10,1985,1995,9,26,USA
Walker Anthony,1994-07-28,2,2017,2019,7,28,USA
Mark Alan,1979-03-23,15,2000,2015,3,23,USA
Charles John,1877-01-12,0,1901,1901,1,12,USA
Frederick William Alexander,1876-02-13,8,1899,1907,2,13,Germany
Francisley,1981-03-05,6,2008,2014,3,5,Cuba
Jay Phillip,1983-09-28,1,2010,2011,9,28,USA
Arthur Frederick,1888-03-03,1,1913,1914,3,3,USA
Charles G.,1861-06-14,10,1882,1892,6,14,USA
Damon Jackson,1970-06-12,8,1993,2001,6,12,USA
Don Alvin,1937-02-02,9,1963,1972,2,2,USA
Robert Ray,1928-08-12,14,1953,1967,8,12,USA
Jay Campbell,1964-08-13,14,1987,2001,8,13,USA
DeWayne Allison,1957-08-20,2,1987,1989,8,20,USA
Cyril Owen,1918-02-05,0,1945,1945,2,5,USA
Ryan Adrien,1978-05-13,6,2002,2008,5,13,USA
Jason Patrick,1978-12-06,6,2005,2011,12,6,USA
Morgan Gardner,1837-12-26,NA,NA,NA,12,26,USA
George Donald,1928-10-24,0,1954,1954,10,24,USA
Simeon Edward,1863-01-11,0,1884,1884,1,11,United Kingdom
Scott Douglas,1968-12-25,5,1991,1996,12,25,USA
Bryan Paul,1980-09-30,5,2005,2010,9,30,USA
Terry Charles,1952-12-15,6,1977,1983,12,15,USA
James Eric,1965-08-21,6,1992,1998,8,21,USA
Kirk Matthew,1969-10-28,6,1998,2004,10,28,USA
Eric Gerald,1960-02-16,7,1985,1992,2,16,USA
Malton Joseph,1911-10-12,0,1936,1936,10,12,USA
Alonza Benjamin,1947-04-21,13,1972,1985,4,21,USA
Madison Kyle,1989-08-01,10,2009,2019,8,1,USA
Aaron James,1993-09-21,2,2017,2019,9,21,USA
Nathan Louis,1976-07-24,2,2003,2005,7,24,USA
Joshua,1847-05-10,0,1877,1877,5,10,USA
Melvin Lynn,1971-11-04,4,1995,1999,11,4,USA
Dylan Matthew,1992-11-15,7,2012,2019,11,15,USA
Wallace Edward,1945-01-25,8,1963,1971,1,25,USA
James Paul David,1931-10-23,16,1955,1971,10,23,USA
Daniel James,1988-12-30,0,2015,2015,12,30,USA
William David,1947-08-22,2,1969,1971,8,22,USA
David Allen,1966-07-07,14,1990,2004,7,7,USA
Nelson Edward,1921-12-28,0,1955,1955,12,28,USA
Albert William,1883-10-07,5,1906,1911,10,7,USA
Ernest A.,1856-09-09,3,1884,1887,9,9,USA
Frederick Duff,1879-07-14,6,1903,1909,7,14,USA
Larry Wayne,1946-02-08,0,1969,1969,2,8,USA
Edward Robert,1938-07-16,10,1962,1972,7,16,USA
Freddie Thomason,1936-09-15,2,1962,1964,9,15,USA
Selva Lewis,1926-11-22,17,1950,1967,11,22,USA
William Byron,1859-10-11,1,1888,1889,10,11,USA
Nicholas Edward,1993-01-19,1,2018,2019,1,19,USA
Forrest Harrill,1927-02-06,18,1949,1967,2,6,USA
Thomas Roland,1927-09-01,8,1954,1962,9,1,CAN
Joseph Peter,1882-06-04,0,1910,1910,6,4,USA
Thomas Henry,1943-08-02,16,1968,1984,8,2,USA
Ambiorix,1984-04-19,2,2005,2007,4,19,D.R.
William Ross,1919-11-15,1,1943,1944,11,15,USA
Enrique,1965-10-07,2,1993,1995,10,7,Panama
Enrique,1990-11-23,1,2015,2016,11,23,Panama
Hiram Alexis,1987-08-04,0,2013,2013,8,4,P.R.
William Max,1918-05-29,4,1942,1946,5,29,USA
Chauncey DePew,1892-10-13,0,1915,1915,10,13,USA
Elmer Robert,1917-02-01,3,1936,1939,2,1,USA
William Ignatius,1889-07-11,1,1910,1911,7,11,USA
Robert James,1907-01-23,10,1927,1937,1,23,USA
Brock,1996-08-04,0,2019,2019,8,4,USA
Christopher Allen,1980-03-11,5,2004,2009,3,11,USA
Daniel L.,1868-10-25,2,1890,1892,10,25,USA
Edward D.,1866-10-06,7,1890,1897,10,6,USA
Frank Aloysius,1880-02-16,1,1906,1907,2,16,USA
Glenn Lawrence,1952-11-16,3,1976,1979,11,16,USA
Gregory Francis,1982-09-21,4,2009,2013,9,21,USA
James Eugene,1971-09-24,9,2001,2010,9,24,USA
Jesse Cail,1868-12-04,15,1890,1905,12,4,USA
James Timothy,1874-10-12,7,1898,1905,10,12,USA
Joseph Aloysius,1867-12-07,1,1890,1891,12,7,USA
John Patrick,1877-01-27,0,1902,1902,1,27,USA
John David,1964-11-28,16,1987,2003,11,28,USA
John C.,1970-02-09,1,1996,1997,2,9,USA
Leslie Kingston,1902-12-18,3,1923,1926,12,18,USA
Leo Patrick,1934-05-06,7,1958,1965,5,6,USA
Patrick Edward,1901-05-13,0,1924,1924,5,13,USA
Steven Michael,1955-03-05,1,1977,1978,3,5,USA
Timothy Philip,1959-02-19,7,1985,1992,2,19,USA
Kenneth William,1916-11-18,4,1945,1949,11,18,USA
Morgan,1972-01-29,3,2000,2003,1,29,USA
Mack Edwin,1935-04-21,2,1956,1958,4,21,USA
Charles Sanford,1887-04-22,5,1910,1915,4,22,USA
Ellis Rena,1964-09-11,17,1987,2004,9,11,USA
Richard Paul,1951-04-29,13,1974,1987,4,29,USA
Allan James,1977-01-03,16,1999,2015,1,3,USA
Alex James,1987-07-26,3,2010,2013,7,26,USA
Corbin Brian,1994-10-22,1,2018,2019,10,22,USA
Hercules H.,1865-08-13,7,1888,1895,8,13,USA
John Jeirus,1879-12-16,0,1907,1907,12,16,USA
John Henderson,1904-11-01,8,1927,1935,11,1,USA
Sean Richard,1982-09-17,12,2004,2016,9,17,USA
Wallace Harper,1929-06-20,2,1956,1958,6,20,USA
George Walter,1860-05-20,NA,NA,NA,5,20,USA
Jeromy Neal,1969-04-15,13,1993,2006,4,15,USA
Andrew David,1990-08-07,0,2016,2016,8,7,USA
William Thomas,1880-01-27,4,1908,1912,1,27,USA
William John,1989-08-30,3,2014,2017,8,30,USA
Robert Britt,1959-06-08,7,1978,1985,6,8,USA
Charles Brittingham,1879-05-15,0,1902,1902,5,15,USA
Cory Wade,1987-10-09,1,2012,2013,10,9,USA
Dennis,1898-05-24,1,1923,1924,5,24,USA
Richard Simon,1863-12-26,2,1883,1885,12,26,USA
Edward James,1887-10-31,6,1912,1918,10,31,USA
James Joseph,1876-06-02,0,1901,1901,6,2,USA
George Joseph,1889-11-24,14,1911,1925,11,24,USA
George Henry,1893-01-31,15,1914,1929,1,31,USA
John Joseph,1878-05-13,1,1903,1904,5,13,United Kingdom
John Irving,1907-08-31,6,1930,1936,8,31,USA
Joseph Francis,1889-03-26,3,1910,1913,3,26,USA
Joseph Francis,1900-02-25,0,1924,1924,2,25,USA
Joseph James,1916-06-17,2,1943,1945,6,17,USA
Michael John,1978-07-14,4,2005,2009,7,14,USA
Thomas P.,1864-09-06,11,1884,1895,9,6,USA
Peter Willits,1930-07-02,8,1955,1963,7,2,USA
Sheldon John,1954-12-22,2,1978,1980,12,22,USA
Thomas Everett,1857-03-30,12,1880,1892,3,30,USA
Todd Edward,1963-07-06,5,1988,1993,7,6,USA
George Harvie,1922-06-19,0,1946,1946,6,19,USA
Alexander Thomson,1893-11-01,0,1914,1914,11,1,USA
Brian James,1981-04-08,5,2006,2011,4,8,USA
Frank Andrew,1866-12-22,6,1891,1897,12,22,USA
Harry J.,1867-05-26,0,1891,1891,5,26,USA
Patrick Brian,1976-10-10,11,2000,2011,10,10,USA
Alva Burton,1874-01-28,0,1894,1894,1,28,USA
Emmanuel Allen,1985-01-17,8,2008,2016,1,17,USA
Larry Allen,1937-07-10,2,1962,1964,7,10,USA
Paul Robert,1923-07-21,5,1948,1953,7,21,USA
Bertram Ray,1950-08-22,14,1973,1987,8,22,USA
Henry S.,1845-02-03,1,1871,1872,2,3,USA
Jeffrey Alan,1951-03-07,15,1970,1985,3,7,USA
John,1913-10-30,1,1943,1944,10,30,USA
Sean Patrick,1980-09-12,10,2002,2012,9,12,USA
Terry Dale,1968-11-28,3,1994,1997,11,28,USA
Ryan Matthew,1994-05-28,1,2018,2019,5,28,USA
Maurice Lennon,1898-01-29,9,1919,1928,1,29,USA
Ellis Narrington,1936-08-12,7,1958,1965,8,12,USA
Levi Jared,1981-06-02,7,2007,2014,6,2,USA
Jim Scott,1949-10-27,2,1975,1977,10,27,USA
Edward Frank,1922-04-18,6,1950,1956,4,18,USA
Dennis Allen,1957-11-29,1,1985,1986,11,29,USA
William Edwin,1895-03-27,8,1920,1928,3,27,USA
Richard Matthew,1940-01-23,1,1960,1961,1,23,USA
James Franklin,1927-01-08,12,1950,1962,1,8,USA
Michael James,1972-12-27,3,1996,1999,12,27,USA
Paul Miller,1918-08-25,2,1941,1943,8,25,USA
Steven Lee,1949-09-29,8,1972,1980,9,29,USA
Brian Phillip,1981-04-18,2,2007,2009,4,18,USA
Donald Lee,1946-04-29,0,1965,1965,4,29,USA
Edgar John,1917-11-16,2,1943,1945,11,16,USA
Matthew David,1984-02-13,0,2016,2016,2,13,USA
Michael Anthony,1968-07-07,1,1995,1996,7,7,USA
Alan Paul,1990-08-22,1,2017,2018,8,22,USA
David Thomas,1979-11-09,9,2004,2013,11,9,USA
Owen Joseph,1887-10-08,15,1908,1923,10,8,USA
Francis Clyde,1906-08-01,3,1927,1930,8,1,USA
John Francis,1886-08-29,3,1909,1912,8,29,USA
Guy Terrell,1901-08-23,22,1923,1945,8,23,USA
Homer Giles,1972-11-12,7,1997,2004,11,12,USA
Christopher Shaun,1967-11-04,0,1993,1993,11,4,USA
Leslie Ambrose,1892-11-27,16,1912,1928,11,27,USA
Matthew Brian,1986-02-08,2,2016,2018,2,8,USA
Albert John,1856-09-15,15,1875,1890,9,15,USA
Robert Randall,1958-10-05,11,1982,1993,10,5,USA
Joseph Henry,1902-12-18,0,1926,1926,12,18,USA
Michael Thomas,1949-01-13,0,1977,1977,1,13,USA
Thomas William,1947-02-20,7,1973,1980,2,20,USA
Raymond Edward,1948-09-25,3,1971,1974,9,25,USA
Nicholas Gregory,1986-12-15,3,2013,2016,12,15,USA
Henry Joseph,1886-07-12,1,1911,1912,7,12,USA
John Daniel,1957-03-08,6,1980,1986,3,8,USA
Albert Maxwell,1910-09-21,9,1936,1945,9,21,USA
Michael Dana,1965-05-10,3,1992,1995,5,10,USA
Andrew Edward,1983-08-09,9,2010,2019,8,9,USA
Salvatore Philip,1952-09-25,8,1980,1988,9,25,USA
Edward Luke,1916-01-07,1,1943,1944,1,7,USA
Wilburn Rue,1918-03-22,7,1940,1947,3,22,USA
Adam Christopher,1973-08-17,0,1998,1998,8,17,USA
Arthur Edward,1887-12-19,5,1911,1916,12,19,USA
William Franklin,1947-03-12,8,1969,1977,3,12,USA
Billy Ray,1986-04-18,9,2007,2016,4,18,USA
Brett Morgan,1957-06-15,16,1981,1997,6,15,USA
Justin Brent,1978-02-11,2,2001,2003,2,11,USA
Cecil Dean,1937-10-23,2,1962,1964,10,23,USA
Charles Thomas,1906-05-12,0,1933,1933,5,12,USA
Daniel John,1986-10-17,4,2014,2018,10,17,USA
Timothy Edward,1991-03-13,4,2014,2018,3,13,USA
Frank B.,1866-07-18,0,1895,1895,7,18,USA
Isaac Burr,1873-08-22,0,1902,1902,8,22,USA
John Albert,1879-07-26,6,1901,1907,7,26,USA
John Stephen,1893-03-20,3,1926,1929,3,20,USA
Joshua James,1984-12-11,0,2009,2009,12,11,USA
Joseph Frank,1986-03-12,2,2013,2015,3,12,USA
Keith Allen,1989-01-30,1,2013,2014,1,30,USA
Willis Everett,1887-08-09,0,1907,1907,8,9,USA
Ormond Hook,1854-11-18,NA,NA,NA,11,18,USA
Richard Dwight,1973-05-01,2,1997,1999,5,1,CAN
Robert Frank John,1970-04-10,6,1993,1999,4,10,CAN
Frank,1851-05-13,0,1872,1872,5,13,USA
Thomas Arden,1938-04-08,3,1962,1965,4,8,USA
Ty Douglas,1993-03-31,1,2018,2019,3,31,USA
Byron Keiron,1993-12-18,4,2015,2019,12,18,USA
Ralph Stanley,1911-06-07,11,1938,1949,6,7,CAN
Joseph John,1919-10-02,0,1945,1945,10,2,USA
John William,1936-08-17,10,1958,1968,8,17,USA
Eldred William,1919-10-26,17,1943,1960,10,26,USA
James William,1877-10-03,0,1904,1904,10,3,USA
Christopher Andy,1875-12-19,0,1899,1899,12,19,USA
Randall Parker,1964-10-02,1,1987,1988,10,2,USA
Freddie Lee,1980-03-15,3,2005,2008,3,15,USA
Michael Alan,1978-03-20,2,2002,2004,3,20,USA
Timothy Christopher,1973-10-31,15,1998,2013,10,31,USA
Harry Gladwin,1925-02-03,7,1950,1957,2,3,USA
Jeffrey Alan,1956-11-11,0,1977,1977,11,11,USA
James Edward,1968-10-03,0,1993,1993,10,3,USA
Marlon Jerrard,1977-08-30,14,2002,2016,8,30,USA
Paul Gregory,1970-12-03,14,1995,2009,12,3,USA
Samuel Dewey,1907-10-15,7,1929,1936,10,15,USA
Robert Matthew,1884-12-31,10,1907,1917,12,31,USA
Eric James,1976-02-16,10,2000,2010,2,16,USA
Gerald Wilford,1907-02-02,0,1929,1929,2,2,USA
James Joseph,1880-01-05,0,1906,1906,1,5,USA
Milton John,1916-11-15,2,1943,1945,11,15,USA
Thomas Joseph,1919-12-31,14,1943,1957,12,31,USA
Martin Eugene,1958-07-26,5,1980,1985,7,26,USA
Ralph Joseph,1927-11-05,8,1944,1952,11,5,USA
Enos Milton,1949-10-08,14,1972,1986,10,8,USA
Cesar Augusto,1989-02-11,2,2013,2015,2,11,D.R.
Alfredo A.,1881-05-11,0,1913,1913,5,11,Spain
Alexander Alberto,1971-12-24,0,2000,2000,12,24,Venezuela
Alberto Antonio,1988-10-25,1,2012,2013,10,25,D.R.
Asdrubal Jose,1985-11-13,12,2007,2019,11,13,Venezuela
Daniel Alberto,1981-05-28,5,2004,2009,5,28,D.R.
Edwar Alfonso,1987-10-20,0,2012,2012,10,20,D.R.
Everth,1986-11-17,6,2009,2015,11,17,Nicaragua
Fernando Jose,1981-11-16,6,2004,2010,11,16,P.R.
Francisco,1966-10-10,4,1989,1993,10,10,D.R.
Genesis,1996-10-10,0,2019,2019,10,10,D.R.
Jose Alberto,1972-03-24,5,1997,2002,3,24,D.R.
Jolbert Alexis,1972-12-08,10,1998,2008,12,8,Colombia
Mauricio Adolfo,1993-09-22,0,2016,2016,9,22,D.R.
Melky,1984-08-11,14,2005,2019,8,11,D.R.
Jose Miguel,1983-04-18,16,2003,2019,4,18,Venezuela
Orlando Luis,1974-11-02,14,1997,2011,11,2,Colombia
Ramon Salvador,1989-11-05,1,2015,2016,11,5,Venezuela
Craig Thomas,1954-09-10,0,1977,1977,9,10,USA
Edgar Fidel,1964-06-06,0,1995,1995,6,6,Venezuela
Gregory James,1962-02-27,11,1987,1998,2,27,USA
Leon Joseph,1891-11-20,9,1915,1924,11,20,USA
Charles Brayton,1864-12-22,1,1883,1884,12,22,USA
Forrest Leroy,1886-01-26,7,1912,1919,1,26,USA
Thomas,1911-08-21,0,1937,1937,8,21,USA
Joseph Clifford,1931-02-14,1,1956,1957,2,14,USA
Benjamin Thomas,1879-02-10,0,1906,1906,2,10,USA
Wayne Levell,1951-11-23,1,1978,1979,11,23,USA
John Patrick Parnell,1865-04-30,3,1884,1887,4,30,USA
Trevor John,1988-03-01,10,2009,2019,3,1,USA
Robert Max,1924-10-16,5,1949,1954,10,16,USA
Leslie,1948-01-13,4,1968,1972,1,13,USA
Lorenzo Lamar,1986-04-13,9,2010,2019,4,13,USA
Matthew Thomas,1984-10-01,12,2005,2017,10,1,USA
Merritt Patrick,1907-04-05,6,1932,1938,4,5,USA
Cameron,1972-05-11,0,2000,2000,5,11,Australia
Miguel Jesus,1974-05-04,16,1996,2012,5,4,Venezuela
George Theodore,1910-07-22,0,1934,1934,7,22,USA
Ivan,1962-03-19,9,1984,1993,3,19,P.R.
Samuel Francis,1926-02-06,4,1950,1954,2,6,USA
Bruce,1906-02-08,4,1928,1932,2,8,USA
Charles William,1901-08-02,0,1925,1925,8,2,USA
Earl Welton,1905-04-09,20,1928,1948,4,9,USA
Ralph Michael,1949-01-22,13,1971,1984,1,22,USA
Ralph Grant,1884-01-18,1,1904,1905,1,18,USA
Raymond Benjamin,1888-04-26,11,1910,1921,4,26,USA
Enrique Nomar,1975-01-09,6,2003,2009,1,9,P.R.
William Davitte,1890-06-23,0,1913,1913,6,23,USA
John Charles,1879-12-14,0,1902,1902,12,14,USA
Jeffrey Wilton,1958-04-11,4,1984,1988,4,11,USA
Kole Alan,1987-10-14,7,2012,2019,10,14,USA
Willie Shawn Lamont,1994-11-04,2,2017,2019,11,4,USA
Carmen Salvatore,1978-11-04,3,2004,2007,11,4,USA
Frederick John,1918-10-22,1,1941,1942,10,22,USA
Orlando,1992-02-03,2,2015,2017,2,3,D.R.
Alberto Jose,1983-04-19,9,2006,2015,4,19,Venezuela
Benjamin Franklin,1957-05-19,0,1983,1983,5,19,USA
David Joseph,1888-07-20,1,1910,1911,7,20,USA
Edward Joseph,1857-12-11,0,1884,1884,12,11,USA
Frank Burnett,1898-02-26,1,1921,1922,2,26,USA
James Douglas,1994-08-24,0,2017,2017,8,24,USA
James Timothy,1881-01-12,0,1902,1902,1,12,USA
Joseph Thomas,1916-10-08,1,1939,1940,10,8,USA
John William,1874-10-03,0,1898,1898,10,3,USA
Leo David,1890-08-09,6,1913,1919,8,9,USA
Martin Francis,1900-06-09,8,1922,1930,6,9,USA
Michael Christopher,1975-05-13,5,1999,2004,5,13,USA
James Joseph,1874-03-18,19,1894,1913,3,18,USA
Raymond James,1891-08-29,0,1915,1915,8,29,USA
Wese LeRoy,1888-07-03,0,1913,1913,7,3,USA
John Wesley,1939-03-12,15,1958,1973,3,12,USA
Ronald Isiah,1976-09-04,1,2003,2004,9,4,USA
Richard Lee,1944-01-07,4,1963,1967,1,7,USA
Mark,1956-09-29,1,1983,1984,9,29,USA
Paul Leo Emile,1917-10-06,9,1942,1951,10,6,CAN
Jacinto,1894-06-11,7,1913,1920,6,11,Cuba
Napoleon,1977-02-09,0,2005,2005,2,9,D.R.
Ernest Carlos,1955-02-01,10,1980,1990,2,1,USA
Johan Valentin,1993-12-13,2,2017,2019,12,13,Panama
Frederick Dennis,1948-01-22,0,1970,1970,1,22,USA
Henry Richard,1914-12-09,4,1943,1947,12,9,USA
John Stanley,1884-09-22,0,1906,1906,9,22,CAN
Kevin John,1979-12-15,2,2007,2009,12,15,USA
Michael Terrance,1973-01-08,16,1995,2011,1,8,USA
Adolph Louis,1907-04-23,12,1933,1945,4,23,USA
Douglas Joseph,1936-09-22,9,1960,1969,9,22,USA
Louis Steven,1946-09-24,3,1969,1972,9,24,USA
Arquimedes Euclides,1987-06-16,3,2013,2016,6,16,D.R.
Kenneth Gene,1963-04-21,14,1987,2001,4,21,USA
Eric Wade,1975-08-14,0,2000,2000,8,14,USA
Henry Richardson,1884-10-26,2,1909,1911,10,26,USA
Samuel Howard,1881-08-22,11,1904,1915,8,22,USA
Alexander Sebastian,1916-11-02,0,1943,1943,11,2,Greece
Dagoberto,1942-03-09,19,1964,1983,3,9,Cuba
Charles Columbus,1863-10-17,6,1888,1894,10,17,USA
James Alexander,1944-02-09,7,1966,1973,2,9,USA
Roy,1921-11-19,9,1948,1957,11,19,USA
Anthony Edward,1986-05-30,3,2011,2014,5,30,USA
Archibald Stewart,1903-10-20,2,1928,1930,10,20,USA
William James,1873-11-05,4,1905,1909,11,5,USA
William Richard,1948-08-09,14,1973,1987,8,9,USA
Bruce Douglas,1909-10-20,12,1930,1942,10,20,USA
Richard Brett,1981-10-17,0,2006,2006,10,17,USA
David Wilson,1942-01-14,7,1967,1974,1,14,USA
David Alan,1951-09-03,1,1977,1978,9,3,USA
Eric Singleton,1987-04-09,2,2014,2016,4,9,USA
William Gilthorpe,1908-02-13,5,1933,1938,2,13,USA
Marc Thaddeus,1884-11-29,0,1907,1907,11,29,USA
James Robert,1937-06-24,1,1962,1963,6,24,USA
James Robert,1943-01-10,0,1970,1970,1,10,USA
James Marcus,1966-05-19,0,1990,1990,5,19,USA
John Millard,1907-09-13,0,1933,1933,9,13,USA
Joseph Earl,1944-03-10,0,1967,1967,3,10,USA
Kevin Wade,1964-12-06,4,1991,1995,12,6,USA
Michael Thomas,1964-02-17,9,1987,1996,2,17,USA
Michael,1850-08-01,0,1873,1873,8,1,Ireland
Paul McLaughlin,1917-09-01,9,1941,1950,9,1,USA
Ronald Thomas,1940-04-05,2,1964,1966,4,5,USA
Clarence,1915-03-07,1,1940,1941,3,7,USA
Arthur Vincent,1888-01-30,7,1908,1915,1,30,USA
Cardell,1952-07-06,0,1977,1977,7,6,USA
William Holton,1868-02-19,0,1896,1896,2,19,USA
Howard Lee,1893-07-01,0,1917,1917,7,1,USA
Jorge Hidalgo,1978-08-10,4,2005,2009,8,10,Mexico
Salvatore John,1942-08-11,2,1969,1971,8,11,USA
Winfield Scott,1869-12-08,2,1892,1894,12,8,USA
Robert Plantagenet Llewellan,1868-02-23,2,1892,1894,2,23,USA
Francisco Jose,1924-05-11,2,1951,1953,5,11,Cuba
Jose Vicente,1992-07-27,0,2016,2016,7,27,Venezuela
Leonel Enrique,1987-07-17,3,2014,2017,7,17,Venezuela
Rick Lamar,1953-06-10,9,1976,1985,6,10,USA
Shawn Anthony,1975-11-18,10,2004,2014,11,18,USA
Silvestre,1965-12-31,3,1988,1991,12,31,D.R.
George Anthony,1965-08-11,2,1989,1991,8,11,USA
William Emisael,1971-12-11,0,1993,1993,12,11,Venezuela
Hugh Edward,1897-05-13,0,1918,1918,5,13,USA
James Edward,1866-11-26,6,1891,1897,11,26,USA
Robinson Castro,1976-05-04,12,1999,2011,5,4,P.R.
Casey Todd,1961-01-12,11,1986,1997,1,12,USA
Jeimer,1993-11-24,3,2016,2019,11,24,USA
John Robert,1953-11-06,18,1975,1993,11,6,USA
Milo Cain,1917-08-03,8,1943,1951,8,3,USA
Thomas Caesar,1957-08-31,16,1983,1999,8,31,USA
John Cascaes,1952-10-07,1,1977,1978,10,7,USA
John Anthony,1963-03-10,14,1985,1999,3,10,USA
Mark David,1989-02-15,4,2015,2019,2,15,USA
Barbaro Rafael,1979-11-21,0,2009,2009,11,21,Cuba
Jason Kyle,1973-07-04,6,1996,2002,7,4,USA
Wirt Virgin,1880-01-23,1,1904,1905,1,23,USA
Andrew Lee,1978-12-19,2,2006,2008,12,19,USA
Christopher John,1938-05-03,14,1960,1974,5,3,USA
Griffin Alexander,1996-05-11,0,2019,2019,5,11,USA
Joseph Jerome,1953-07-13,3,1977,1980,7,13,USA
Joselito,1962-03-07,0,1989,1989,3,7,D.R.
Robinson Jose,1982-10-22,14,2005,2019,10,22,D.R.
Jose,1964-07-02,16,1985,2001,7,2,Cuba
Osvaldo,1964-07-02,3,1990,1993,7,2,Cuba
Joseph D.,1861-08-19,NA,NA,NA,8,19,USA
Guy Dewey,1904-04-09,5,1925,1930,4,9,USA
Jorge Luis,1982-01-30,7,2004,2011,1,30,USA
Benjamin Caldwell,1902-04-13,10,1927,1937,4,13,USA
Michael Joseph,1894-06-15,4,1916,1920,6,15,USA
Thomas Aloysius,1888-12-23,1,1909,1910,12,23,USA
Bartholomew L.,1860-01-29,2,1888,1890,1,29,USA
Russell Michael,1986-04-11,1,2011,2012,4,11,USA
Jose Francisco,1981-01-13,4,2004,2008,1,13,D.R.
Michael Lee,1961-10-13,3,1988,1991,10,13,USA
Douglas Edmund,1952-01-07,5,1976,1981,1,7,USA
Carter Lewis,1990-08-07,5,2012,2017,8,7,USA
Matthew Dicus,1983-09-03,7,2005,2012,9,3,USA
George Angelo,1954-01-15,1,1981,1982,1,15,USA
Lee William,1947-10-01,6,1971,1977,10,1,USA
Nick Lee,1958-03-08,9,1982,1991,3,8,USA
Patrick Nicholas,1918-11-27,0,1944,1944,11,27,USA
Ralph Earl,1889-06-16,1,1912,1913,6,16,USA
Christopher Frank,1978-08-19,13,2003,2016,8,19,USA
Ramon,1969-05-23,2,1993,1995,5,23,D.R.
Matthew Joseph,1991-07-23,3,2016,2019,7,23,USA
Victor Manuel,1993-08-17,2,2017,2019,8,17,P.R.
Cecil Bradford Patrick,1905-09-26,2,1930,1932,9,26,USA
John C.,1855-10-12,1,1875,1876,10,12,USA
Bernardo,1947-08-05,11,1969,1980,8,5,USA
Adrian,1987-10-10,0,2012,2012,10,10,USA
John Bruton,1921-05-19,0,1946,1946,5,19,USA
Jose Rosario Domec,1943-10-07,17,1963,1980,10,7,Cuba
Leonardo Lazaro,1938-12-17,15,1960,1975,12,17,Cuba
Conrad Seth,1942-03-30,0,1963,1963,3,30,USA
Armand Joseph,1920-08-21,2,1943,1945,8,21,USA
Javier Peterson,1975-09-15,2,2000,2002,9,15,P.R.
Stephen Andrew,1987-08-31,1,2016,2017,8,31,USA
Donald Eugene,1935-12-07,13,1957,1970,12,7,USA
Rodney Cline,1945-10-01,18,1967,1985,10,1,Panama
Andrew Arthur,1931-10-18,10,1952,1962,10,18,USA
Max George,1890-01-11,19,1910,1929,1,11,USA
Paul Stephan,1968-01-08,0,1993,1993,1,8,USA
George C.,1870-12-04,8,1895,1903,12,4,USA
Thomas Joseph,1846-11-02,8,1871,1879,11,2,USA
Thomas Francis Aloysius,1906-10-11,11,1935,1946,10,11,USA
Edwin M.,1863-07-28,0,1890,1890,7,28,USA
Esmailin Manuel,1983-10-28,1,2009,2010,10,28,D.R.
Gary Andrew,1986-07-23,1,2011,2012,7,23,USA
Frederick Behlmer,1881-11-14,20,1903,1923,11,14,USA
James Leslie,1848-08-20,1,1871,1872,8,20,USA
Shane Taylor,1991-08-30,2,2017,2019,8,30,USA
James Otto,1906-08-19,8,1932,1940,8,19,USA
Frederick E.,1858-09-08,0,1889,1889,9,8,USA
James Arthur,1918-02-23,0,1941,1941,2,23,USA
Lucas Christopher,1980-12-20,4,2008,2012,12,20,USA
Walter,1881-07-06,0,1908,1908,7,6,United Kingdom
Lewis Adolph,1832-02-25,0,1874,1874,2,25,USA
Francisco Manuel,1940-09-17,3,1967,1970,9,17,USA
Daniel Steven,1970-01-26,3,1996,1999,1,26,USA
Donald Herbert,1926-10-15,4,1948,1952,10,15,USA
Harold Gust,1892-05-17,13,1917,1930,5,17,USA
Jesse Craig,1980-12-31,2,2008,2010,12,31,USA
Leon Alton,1895-02-17,0,1920,1920,2,17,USA
Albin Oscar,1886-10-26,0,1911,1911,10,26,USA
Steven Norman,1944-12-22,23,1965,1988,12,22,USA
Earl L.,1977-12-21,16,1999,2015,12,21,USA
Hiram Cleo,1902-09-07,0,1927,1927,9,7,USA
Roy Edward,1900-12-10,1,1925,1926,12,10,USA
Donald Wayne,1959-08-14,9,1983,1992,8,14,USA
George Wartman,1866-03-29,0,1890,1890,3,29,USA
Leon James,1937-04-23,6,1959,1965,4,23,USA
Chester Keller,1888-01-09,0,1909,1909,1,9,USA
Roberto,1980-08-30,10,2006,2016,8,30,D.R.
Rafael,1972-10-02,4,1995,1999,10,2,P.R.
William John,1874-03-25,0,1904,1904,3,25,USA
Edwin Elliott,1916-10-21,4,1941,1945,10,21,USA
John Joseph,1866-11-10,2,1889,1891,11,10,USA
Patrick Joseph,1876-08-07,3,1901,1904,8,7,USA
Andrew James Rudolph,1985-05-18,4,2008,2012,5,18,USA
Robert Louis,1917-12-12,7,1940,1947,12,12,USA
Charles Sydney,1968-07-23,0,2000,2000,7,23,USA
Christopher John,1975-04-27,15,1997,2012,4,27,USA
Christopher John,1985-12-26,1,2011,2012,12,26,USA
Cris Howell,1965-04-05,8,1988,1996,4,5,USA
Darrell David,1985-07-15,8,2011,2019,7,15,USA
David Lee,1987-09-01,3,2012,2015,9,1,USA
Warren William,1855-08-16,13,1879,1892,8,16,USA
Lewis Emmett,1913-08-16,0,1943,1943,8,16,USA
Matthew Martin,1985-11-26,8,2011,2019,11,26,USA
Paul Calvin,1894-08-12,0,1916,1916,8,12,USA
Ryan Nicholas,1990-08-22,1,2018,2019,8,22,USA
Frank Dominic,1938-09-14,1,1965,1966,9,14,USA
Christopher Michael,1986-06-30,5,2009,2014,6,30,USA
Alejandro Eloy,1912-07-24,10,1939,1949,7,24,Venezuela
Carlos Luis,1987-03-21,10,2009,2019,3,21,Venezuela
Alfonso,1926-01-23,9,1950,1959,1,23,Venezuela
Daniel,1977-04-12,9,2003,2012,4,12,USA
Giovanni,1968-03-04,11,1995,2006,3,4,Venezuela
Hector,1969-10-22,13,1994,2007,10,22,D.R.
Charles Carbitt,1876-12-27,16,1898,1914,12,27,USA
Charles Lee Glenn,1967-08-10,7,1990,1997,8,10,USA
Amalio Rafael,1964-04-11,0,1991,1991,4,11,Venezuela
Camilo,1937-08-06,7,1959,1966,8,6,USA
Ezequiel Manuel,1987-06-11,6,2011,2017,6,11,Venezuela
Joel Fernando,1987-03-07,1,2011,2012,3,7,D.R.
Mark Steven,1963-07-19,9,1987,1996,7,19,USA
William Martin,1873-09-05,4,1898,1902,9,5,USA
William Francis,1883-10-22,10,1906,1916,10,22,USA
Cesar,1984-04-29,0,2009,2009,4,29,USA
Donald George,1949-09-15,7,1970,1977,9,15,USA
Matias,1963-02-24,3,1991,1994,2,24,Mexico
Lewis Smith,1872-08-15,0,1901,1901,8,15,USA
Brett Michael,1982-10-03,5,2007,2012,10,3,USA
Samuel Clifford,1859-10-18,11,1882,1893,10,18,USA
Clay Palmer,1941-05-02,14,1964,1978,5,2,USA
Cody Mark,1992-10-15,0,2018,2018,10,15,USA
Richard Thomas,1884-07-21,0,1909,1909,7,21,USA
Dorsey Lee,1891-05-19,0,1919,1919,5,19,USA
Ralph Arthur,1891-12-28,0,1916,1916,12,28,USA
Edgar Fleischer,1907-07-27,0,1929,1929,7,27,USA
Frederick Herbert,1864-07-02,7,1884,1891,7,2,USA
Jamey Blake,1974-02-18,11,2002,2013,2,18,USA
Owen Thomas,1902-11-11,9,1925,1934,11,11,USA
John E.,1860-08-27,3,1884,1887,8,27,USA
Scott Alexander,1984-09-24,2,2014,2016,9,24,USA
Thomas Edward,1936-09-17,4,1955,1959,9,17,USA
Thomas Michael,1952-11-05,1,1974,1975,11,5,USA
Wilfred,1872-10-22,10,1891,1901,10,22,USA
Albert James,1882-08-22,0,1910,1910,8,22,USA
Walter Lloyd,1912-11-15,1,1934,1935,11,15,USA
Matthew Reese,1981-07-01,4,2009,2013,7,1,USA
Robert N.,1989-01-23,1,2012,2013,1,23,USA
Frank Willis,1919-11-06,0,1953,1953,11,6,USA
Andrew Godfrey,1968-11-09,1,1994,1995,11,9,USA
Arnold Lee,1918-03-14,1,1944,1945,3,14,USA
Otis Leonard,1902-09-30,1,1925,1926,9,30,USA
William Christopher,1982-09-16,2,2008,2010,9,16,USA
Vernon Christopher,1986-12-18,7,2010,2017,12,18,USA
Gary Edmund,1954-04-08,18,1974,1992,4,8,USA
John Howard,1904-10-13,0,1926,1926,10,13,USA
Jeffrey Allen,1964-12-03,0,1991,1991,12,3,USA
Joseph Chris,1960-03-07,15,1983,1998,3,7,USA
Larry Gene,1965-05-22,0,1992,1992,5,22,USA
Lance David,1974-12-18,7,1999,2006,12,18,USA
Conrad Powell,1879-05-19,0,1908,1908,5,19,USA
Paul Warren,1894-05-01,6,1914,1920,5,1,USA
Solomon Mobley,1908-12-23,0,1931,1931,12,23,USA
Steven Jerome,1964-12-03,1,1989,1990,12,3,USA
Alexander Joy,1820-04-17,NA,NA,NA,4,17,USA
Edward Charles,1859-10-06,7,1890,1897,10,6,USA
Ricardo Adolfo Jacobo,1939-09-01,16,1963,1979,9,1,D.R.
Michael John,1977-05-27,4,1998,2002,5,27,USA
Robert Lee,1864-01-05,9,1884,1893,1,5,USA
Marcos Jose,1984-08-19,2,2005,2007,8,19,Venezuela
Charles Douglas,1960-03-03,8,1985,1993,3,3,USA
Scott Russell,1923-04-11,0,1947,1947,4,11,USA
Curtis Michael,1988-11-09,5,2014,2019,11,9,USA
Gennaro Joseph,1933-09-27,4,1958,1962,9,27,USA
Paulino,1941-12-21,9,1965,1974,12,21,Cuba
Raul,1972-08-23,12,1996,2008,8,23,P.R.
Joseph Thomas,1907-06-28,4,1934,1938,6,28,USA
Charles Emmett,1879-09-07,5,1901,1906,9,7,USA
George Washington,1915-11-11,10,1937,1947,11,11,USA
Orrin Robinson,1859-01-26,0,1882,1882,1,26,CAN
Daniel Maurice,1862-11-20,6,1884,1890,11,20,USA
Dennis Patrick,1858-03-30,1,1884,1885,3,30,USA
James Patrick,1870-03-15,9,1898,1907,3,15,USA
Hugh Thomas,1913-10-14,14,1935,1949,10,14,USA
Joseph Felix,1887-08-15,9,1909,1918,8,15,USA
Sean Thomas,1974-07-02,11,1997,2008,7,2,USA
David,1948-06-11,11,1969,1980,6,11,USA
Jay Carl,1889-06-04,3,1911,1914,6,4,USA
Kevin Forrest,1977-12-06,8,2002,2010,12,6,USA
Andrew Burton,1986-09-11,9,2010,2019,9,11,USA
Norman Dalton,1933-11-10,16,1958,1974,11,10,USA
Ronald Forrest,1949-11-20,1,1973,1974,11,20,USA
Lawrence Paul,1965-10-28,8,1990,1998,10,28,USA
Alexi,1984-07-20,8,2006,2014,7,20,D.R.
Carlos Rafael,1976-11-08,0,2000,2000,11,8,D.R.
Craig Douglas,1949-12-11,0,1973,1973,12,11,USA
Edward James,1851-12-30,7,1879,1886,12,30,USA
Harry Delbert,1880-07-20,1,1904,1905,7,20,USA
Robert Alan,1985-09-11,2,2010,2012,9,11,USA
Joseph Buren,1980-08-08,1,2007,2008,8,8,USA
Edward T.,1867-11-28,0,1891,1891,11,28,USA
Jack Dempsey,1919-10-26,0,1949,1949,10,26,USA
Joseph Philip,1883-02-08,1,1904,1905,2,8,USA
Peter Francis,1873-04-08,3,1896,1899,4,8,USA
Scott Robert,1975-10-03,4,2002,2006,10,3,USA
Alejandro Luis,1986-08-04,1,2012,2013,8,4,USA
George Jasper,1907-08-04,12,1934,1946,8,4,USA
Nicholas A.,1992-03-04,6,2013,2019,3,4,USA
Pedro Orlando,1970-03-11,3,1993,1996,3,11,Venezuela
Alberto Terrero,1970-02-10,12,1995,2007,2,10,D.R.
Alberto,1975-07-05,3,2008,2011,7,5,Cuba
Robert Ernie,1955-04-18,8,1977,1985,4,18,USA
Braulio Robinson Medrano,1968-05-13,1,1991,1992,5,13,D.R.
Monte Carmelo,1958-06-08,9,1982,1991,6,8,D.R.
Carlos,1975-04-21,4,1997,2001,4,21,USA
Diego,1994-01-18,1,2018,2019,1,18,D.R.
Fabio,1989-02-19,0,2017,2017,2,19,D.R.
Frank Anthony,1969-04-01,14,1991,2005,4,1,USA
James Vincent,1918-09-30,0,1942,1942,9,30,USA
John Anthony,1954-10-23,5,1979,1984,10,23,USA
Jose Rondon,1981-03-19,4,2004,2008,3,19,Venezuela
Jose Gregorio,1996-01-10,1,2018,2019,1,10,Venezuela
Juan,1962-01-25,3,1986,1989,1,25,D.R.
Juan Francisco,1970-06-23,0,1994,1994,6,23,Venezuela
Lendy Enrique,1989-04-08,0,2012,2012,4,8,D.R.
Luis Antonio,1975-09-12,14,1996,2010,9,12,D.R.
Luis Miguel,1992-12-12,2,2017,2019,12,12,D.R.
Esteban Manuel Antonio,1957-04-01,3,1980,1983,4,1,D.R.
Martin Horace,1957-01-16,4,1981,1985,1,16,USA
Peter Paul,1921-02-13,7,1947,1954,2,13,USA
Rusney,1987-07-09,2,2014,2016,7,9,Cuba
Anthony,1957-06-14,0,1978,1978,6,14,USA
Antonio Jose,1963-03-01,10,1988,1998,3,1,Venezuela
Vincent Charles,1917-10-11,2,1943,1945,10,11,USA
Vinicio,1967-07-04,15,1991,2006,7,4,Mexico
Welington Andres,1987-04-24,9,2010,2019,4,24,D.R.
Wilkin Alexis,1984-06-01,11,2008,2019,6,1,D.R.
Donald Hardy,1950-02-01,0,1973,1973,2,1,USA
Foster Ephraim,1931-01-01,4,1954,1958,1,1,USA
John Francis,1879-06-01,0,1910,1910,6,1,USA
Royal Eugene,1885-07-26,3,1907,1910,7,26,USA
Clydell,1913-09-08,5,1934,1939,9,8,USA
Paul Henry,1897-02-16,0,1923,1923,2,16,USA
Kory Christopher,1981-12-08,1,2007,2008,12,8,USA
Angel M.,1982-11-14,0,2015,2015,11,14,D.R.
Bernabel,1979-07-14,1,2005,2006,7,14,D.R.
William Radhames,1952-03-29,9,1974,1983,3,29,D.R.
Daniel Alejandro,1992-11-14,3,2015,2018,11,14,Mexico
Fabio Enrique,1985-01-20,1,2006,2007,1,20,D.R.
Harold Arnaldo,1993-11-30,1,2018,2019,11,30,Venezuela
Jason Michael,1987-06-18,9,2010,2019,6,18,USA
Juan Gabriel,1972-06-20,16,1995,2011,6,20,Mexico
Luis Miguel,1876-11-25,0,1902,1902,11,25,Colombia
Miguel Angel,1994-12-24,4,2015,2019,12,24,D.R.
Ramon Abraham,1976-03-01,12,1999,2011,3,1,P.R.
Ramon Alfredo,1979-10-23,0,2004,2004,10,23,Venezuela
Simon,1988-04-09,4,2013,2017,4,9,D.R.
Starlin DeJesus,1990-03-24,9,2010,2019,3,24,D.R.
Willi Rafael,1997-04-24,0,2019,2019,4,24,P.R.
Frank John,1974-04-27,13,1997,2010,4,27,USA
Danny Anderson,1940-02-25,11,1964,1975,2,25,USA
Eli Eldo,1877-01-26,0,1908,1908,1,26,USA
Troy Patrick,1980-10-21,0,2007,2007,10,21,USA
Hardin Abner,1919-07-06,0,1942,1942,7,6,USA
Michael Peter,1970-12-17,2,1997,1999,12,17,USA
Theodore Physick,1889-05-20,3,1912,1915,5,20,USA
John Keefe,1958-05-06,1,1983,1984,5,6,USA
James Howard,1894-07-16,3,1917,1920,7,16,USA
John Leckie,1863-05-10,0,1884,1884,5,10,USA
Thomas Henry,1884-08-25,1,1908,1909,8,25,USA
William Holland,1956-07-13,8,1979,1987,7,13,USA
John Joseph,1917-11-23,0,1946,1946,11,23,USA
Cecil Algerton,1893-08-11,4,1918,1922,8,11,USA
James Wayne,1936-12-26,13,1955,1968,12,26,USA
John Joseph,1900-06-05,0,1919,1919,6,5,USA
Philip Joseph,1916-07-19,21,1934,1955,7,19,USA
Andres,1981-01-05,0,2007,2007,1,5,USA
Andrew Jacob,1992-12-04,1,2018,2019,12,4,USA
James Christopher,1894-12-10,3,1922,1925,12,10,USA
Tillar H.,1889-12-26,4,1911,1915,12,26,USA
Oliver Perry,1849-12-14,NA,NA,NA,12,14,USA
Dylan Edward,1995-12-28,0,2019,2019,12,28,USA
Arthur Edward,1930-04-02,5,1955,1960,4,2,USA
Garin Glenn,1991-04-20,1,2014,2015,4,20,USA
Gavin Glenn Christopher Joseph,1993-12-22,1,2016,2017,12,22,USA
Jose Isabel,1963-08-20,0,1988,1988,8,20,Mexico
Brett Aarion,1986-07-02,9,2009,2018,7,2,USA
Darrell Albert,1990-06-22,2,2015,2017,6,22,USA
Rex Ralston,1916-10-08,1,1944,1945,10,8,USA
Jose Marti,1987-01-28,1,2010,2011,1,28,D.R.
Andujar,1969-08-21,6,1990,1996,8,21,D.R.
Cesar,1951-02-25,16,1970,1986,2,25,D.R.
Domingo Antonio,1968-11-04,6,1993,1999,11,4,D.R.
Roger Leandro,1974-08-16,10,1995,2005,8,16,Venezuela
Ronny Alexander,1983-02-02,9,2005,2014,2,2,Venezuela
Xavier,1986-08-26,8,2011,2019,8,26,P.R.
Juan C.,1989-11-16,6,2013,2019,11,16,P.R.
Marvin Earl,1912-04-22,4,1942,1946,4,22,USA
Orlando Manuel,1937-09-17,16,1958,1974,9,17,P.R.
Matthew William,1977-11-10,4,2002,2006,11,10,USA
Jaime Magana,1978-10-26,3,2002,2005,10,26,USA
Edward Hugo,1881-07-23,0,1901,1901,7,23,USA
Richard Aldo,1954-05-19,17,1975,1992,5,19,USA
R. Juan,1976-09-25,0,2003,2003,9,25,Mexico
John Joseph,1960-04-28,6,1985,1991,4,28,USA
Robert Henry,1925-05-05,11,1951,1962,5,5,USA
Francisco,1986-03-06,11,2008,2019,3,6,Venezuela
Colby Hunter,1990-01-03,1,2016,2017,1,3,USA
Michael Christopher,1976-08-17,0,2008,2008,8,17,USA
Yoenis,1985-10-18,6,2012,2018,10,18,Cuba
Luis Enrique,1992-04-25,3,2016,2019,4,25,Mexico
Ronald Charles,1948-02-15,16,1971,1987,2,15,USA
David Alejandro,1993-06-24,0,2017,2017,6,24,Venezuela
Gustavo Adolfo,1980-12-04,6,2004,2010,12,4,Venezuela
Jhoulys Jose,1988-01-07,10,2009,2019,1,7,Venezuela
Elio,1936-10-26,2,1960,1962,10,26,Venezuela
Shawn Anthony,1977-12-23,7,2001,2008,12,23,USA
Chester James,1884-10-28,12,1906,1918,10,28,USA
Henry,1824-10-05,NA,NA,NA,10,5,United Kingdom
Ray Charles,1962-11-17,0,1986,1986,11,17,USA
Andrew Gregory,1990-06-17,5,2014,2019,6,17,USA
Leon Wilbur,1902-09-28,6,1929,1935,9,28,USA
Robert Edward,1927-08-10,6,1951,1957,8,10,USA
David Lee,1950-08-30,8,1973,1981,8,30,USA
George W.,1888-06-07,6,1910,1916,6,7,United Kingdom
Adron Lamar,1986-10-08,2,2011,2013,10,8,USA
Albert Eugene,1961-03-24,2,1983,1985,3,24,USA
William Christopher,1888-09-05,0,1910,1910,9,5,USA
William Vincent,1909-04-21,0,1932,1932,4,21,USA
Carroll Christopher,1948-12-26,17,1971,1988,12,26,USA
Clifford Day,1922-01-10,5,1948,1953,1,10,USA
Craig Phillip,1957-02-02,1,1979,1980,2,2,USA
Elton P.,1867-11-05,10,1886,1896,11,5,USA
James Nathaniel,1975-05-06,0,2003,2003,5,6,USA
Joseph Jeremiah,1910-05-10,0,1934,1934,5,10,USA
Johnnie Monroe,1911-09-10,0,1937,1937,9,10,USA
Justin Louis,1985-09-23,9,2007,2016,9,23,USA
Richard Jerome,1875-08-31,0,1900,1900,8,31,USA
Wesley Polk,1966-04-13,5,1990,1995,4,13,USA
Buford Billy,1947-09-18,7,1969,1976,9,18,USA
Robert Michael,1955-02-10,2,1976,1978,2,10,USA
Robert,1940-09-10,6,1963,1969,9,10,USA
Wilmer Dean,1941-06-01,10,1961,1971,6,1,USA
Frank Leroy,1876-09-09,16,1898,1914,9,9,USA
Edward Oliver,1917-02-17,0,1947,1947,2,17,USA
Albert Benjamin,1898-07-14,NA,NA,NA,7,14,USA
Spurgeon Ferdinand,1907-09-12,10,1937,1947,9,12,USA
Darrel Lee,1948-03-09,10,1969,1979,3,9,USA
Esty Clyon,1891-01-29,1,1913,1914,1,29,USA
Yu-Cheng,1995-08-18,0,2019,2019,8,18,Taiwan
Lester Clark,1886-03-03,4,1910,1914,3,3,USA
Charles Joseph,1951-08-07,1,1975,1976,8,7,USA
Darrin John,1966-02-01,1,1991,1992,2,1,USA
Bert Edgar,1893-09-25,2,1920,1922,9,25,USA
James Bailey,1905-07-13,8,1928,1936,7,13,USA
Albertin Aroldis,1988-02-28,9,2010,2019,2,28,Cuba
William Benjamin,1908-12-25,16,1930,1946,12,25,USA
Calvin Louis,1910-12-20,1,1935,1936,12,20,USA
Edwin Volney,1905-11-28,0,1933,1933,11,28,USA
William Fred,1916-07-17,2,1939,1941,7,17,USA
Glenn Justice,1906-01-21,0,1934,1934,1,21,USA
Harry Edward,1885-10-26,4,1912,1916,10,26,USA
John Curtis,1843-05-08,2,1874,1876,5,8,USA
Jaye Lawrence,1987-05-22,0,2012,2012,5,22,USA
John Joseph,1899-10-15,0,1924,1924,10,15,USA
Kelvin Keith,1956-06-02,6,1979,1985,6,2,USA
Kevin Allen,1988-02-19,3,2013,2016,2,19,USA
Matt James,1993-04-28,2,2017,2019,4,28,USA
Raymond Johnson,1891-01-15,8,1912,1920,1,15,USA
Samuel Blake,1916-04-11,13,1938,1951,4,11,USA
Travis Adrian,1978-06-05,0,2003,2003,6,5,USA
William Hogan,1881-03-22,6,1908,1914,3,22,USA
Harry Perry,1957-10-26,2,1978,1980,10,26,USA
LaVerne Ashford,1890-02-19,4,1913,1917,2,19,USA
Joseph,1955-06-17,2,1980,1982,6,17,USA
Jon Thomas,1990-12-03,3,2016,2019,12,3,USA
Raymond,1881-03-25,2,1908,1910,3,25,USA
Edwin Douglas,1933-04-29,7,1962,1969,4,29,USA
Franklin Scott,1969-02-23,0,2000,2000,2,23,USA
Norman Wood,1963-01-06,13,1988,2001,1,6,USA
Oscar McKinley,1896-10-14,NA,NA,NA,10,14,USA
Michael George,1916-04-28,4,1940,1944,4,28,USA
Frank Lane,1942-12-21,0,1964,1964,12,21,USA
Harold Homer,1883-02-13,14,1905,1919,2,13,USA
Kendall Fay,1913-10-06,7,1936,1943,10,6,USA
Charles Lorenzo,1901-12-25,1,1930,1931,12,25,USA
James Martin,1864-10-14,0,1884,1884,10,14,USA
Tyler Cole,1989-12-16,8,2011,2019,12,16,USA
Osvaldo,1940-08-05,1,1966,1967,8,5,Panama
Anthony Francisco,1970-10-22,0,1997,1997,10,22,USA
Angel Aristides,1981-07-22,0,2005,2005,7,22,Panama
Endy de Jesus,1978-02-07,13,2001,2014,2,7,Venezuela
Eric Cesar,1977-12-07,16,1998,2014,12,7,USA
Jesse David,1983-08-21,11,2008,2019,8,21,USA
Nestor Isaias,1947-07-06,0,1967,1967,7,6,Venezuela
Raul Alexander,1973-03-17,13,1996,2009,3,17,Venezuela
Michael Scott,1995-08-11,0,2019,2019,8,11,USA
David Baird,1952-02-19,0,1973,1973,2,19,USA
Charles William,1878-04-27,4,1905,1909,4,27,USA
Robinson,1971-09-09,2,1997,1999,9,9,D.R.
Harry Gordon,1879-04-23,0,1910,1910,4,23,USA
Virgil Earl,1901-02-12,7,1920,1927,2,12,USA
Italo Vincent,1914-10-10,2,1935,1937,10,10,USA
Bruce Kastulo,1977-06-19,17,1998,2015,6,19,Panama
Chin-Feng,1977-10-28,3,2002,2005,10,28,Taiwan
Laurence Russell,1886-05-02,8,1911,1919,5,2,USA
Thomas Edgar,1934-10-14,9,1957,1966,10,14,USA
Wei-Yin,1985-07-21,7,2012,2019,7,21,Taiwan
Rocky Ty,1979-08-19,1,2007,2008,8,19,USA
Paul,1910-07-23,1,1937,1938,7,23,USA
John Dwight,1874-06-05,10,1899,1909,6,5,USA
Robert Vincent,1921-05-06,2,1948,1950,5,6,USA
Mitchell,1917-07-21,0,1945,1945,7,21,USA
Silvio Antonio,1953-06-20,0,1977,1977,6,20,Nicaragua
Scott Michael,1966-08-22,2,1990,1992,8,22,USA
Scott Christopher,1977-08-14,1,2001,2002,8,14,USA
Travis Cole,1984-06-10,0,2006,2006,6,10,USA
Matthew Bryan,1983-06-10,3,2007,2010,6,10,USA
Floyd John,1956-04-20,2,1982,1984,4,20,USA
Clarence Lemuel,1867-08-08,13,1888,1901,8,8,USA
Harry Stephen Patrick,1905-05-23,0,1930,1930,5,23,USA
Jason Lee,1975-01-13,0,2006,2006,1,13,USA
Matthew Wilkie,1978-12-03,3,2002,2005,12,3,USA
Peter Pierre,1871-11-15,1,1901,1902,11,15,USA
Rodney Osborne,1962-02-18,3,1985,1988,2,18,USA
Samuel Beresford,1861-11-06,0,1883,1883,11,6,USA
Pearce Nuget,1867-05-28,1,1899,1900,5,28,USA
Richard Francis,1949-11-22,7,1971,1978,11,22,USA
Dino Joseph,1912-06-30,0,1935,1935,6,30,USA
Louis Peo,1910-05-17,5,1934,1939,5,17,USA
Robert Howard,1918-10-11,11,1941,1952,10,11,USA
Walter John,1918-09-26,0,1945,1945,9,26,USA
Robinson David,1984-06-05,8,2011,2019,6,5,Venezuela
Yonny Enrique,1993-12-26,1,2018,2019,12,26,Venezuela
Lonnie David,1988-10-04,7,2011,2018,10,4,USA
Thomas Raymond,1954-05-09,0,1979,1979,5,9,USA
Harry,1932-11-16,12,1950,1962,11,16,USA
Stephen Vincent,1967-06-08,1,1990,1991,6,8,Japan
Nelson Boyd,1933-03-25,2,1958,1960,3,25,USA
Robert Joseph,1945-09-16,1,1970,1971,9,16,USA
Donald Leon,1938-07-02,0,1960,1960,7,2,USA
Randol Doyle,1975-09-05,15,2000,2015,9,5,USA
Michael Blair,1989-11-10,2,2013,2015,11,10,USA
Hee-Seop,1979-03-16,3,2002,2005,3,16,South Korea
Ji-Man,1991-05-19,3,2016,2019,5,19,South Korea
Jin Ho,1975-08-16,1,1998,1999,8,16,South Korea
Shin-Soo,1982-07-13,14,2005,2019,7,13,South Korea
Robert William,1972-05-01,5,1996,2001,5,1,Philippines
Felix George,1887-10-05,5,1910,1915,10,5,USA
William,1888-09-02,0,1910,1910,9,2,USA
Harry,1915-09-27,0,1937,1937,9,27,USA
Robert Charles,1945-10-17,2,1968,1970,10,17,USA
Bruce Ray,1948-02-22,0,1971,1971,2,22,USA
Clay C.,1958-06-28,0,1984,1984,6,28,USA
Walter Neils,1899-10-24,1,1926,1927,10,24,USA
Gary Richard,1953-05-05,1,1979,1980,5,5,USA
Jason Samuel,1969-09-21,10,1995,2005,9,21,USA
Joseph O'Neal,1935-12-13,7,1959,1966,12,13,V.I.
John Lawrence,1960-09-15,4,1984,1988,9,15,USA
Justin Barnett,1980-04-03,4,2008,2012,4,3,USA
Larry Richard,1953-11-10,10,1973,1983,11,10,USA
Lloyd Reid,1893-10-19,3,1919,1922,10,19,USA
Loyd Eugene,1919-12-31,2,1945,1947,12,31,USA
Marquette Joseph,1913-10-21,11,1938,1949,10,21,USA
McKay Andrew,1975-08-14,3,1999,2002,8,14,USA
Michael,1957-10-08,4,1979,1983,10,8,USA
Michael Wayne,1963-11-03,5,1991,1996,11,3,USA
Barbra O'Neil,1931-12-16,4,1957,1961,12,16,USA
Nicholas John,1987-07-17,1,2013,2014,7,17,USA
Russell Ormand,1917-09-12,6,1942,1948,9,12,USA
Ryan Alan,1974-03-28,5,1998,2003,3,28,USA
Stephen Randall,1957-12-09,3,1983,1986,12,9,USA
Timothy Arthur,1975-03-31,0,2001,2001,3,31,USA
Charles Vincent,1978-12-19,9,2003,2012,12,19,USA
Emory Nicholas,1924-09-12,5,1950,1955,9,12,USA
Hiram Lincoln,1863-11-23,0,1890,1890,11,23,USA
Leonard,1942-03-21,0,1966,1966,3,21,USA
Ryan Matthew,1978-10-14,6,2004,2010,10,14,USA
Clarence Nottingham,1930-02-01,2,1957,1959,2,1,USA
John,1900-11-26,3,1924,1927,11,26,USA
Nestor George,1922-05-11,NA,NA,NA,5,11,USA
Lawrence Thomas,1924-08-17,0,1951,1951,8,17,USA
Angelo Dominic,1966-10-06,6,1992,1998,10,6,USA
Mark Thomas,1961-08-19,0,1987,1987,8,19,USA
Darryl Richard,1957-04-23,0,1983,1983,4,23,USA
Joseph John,1910-11-18,16,1929,1945,11,18,USA
Alva Warren,1929-12-23,5,1957,1962,12,23,USA
Edgar Victor,1884-06-19,15,1905,1920,6,19,USA
Thaddeus Walter,1912-11-22,0,1944,1944,11,22,USA
Albert Joseph,1924-05-07,0,1945,1945,5,7,USA
Edward Joseph,1907-05-09,1,1932,1933,5,9,USA
Adam Christian,1990-08-15,1,2018,2019,8,15,USA
Peter William,1942-10-17,3,1965,1968,10,17,USA
Gino Nicholas,1929-12-18,9,1956,1965,12,18,USA
Frank Thomas,1968-08-02,0,1994,1994,8,2,USA
Anthony Michael,1989-07-05,6,2012,2018,7,5,USA
Alexander,1978-12-17,8,2001,2009,12,17,P.R.
Louis Alexander,1922-09-06,0,1943,1943,9,6,USA
Frank Dominick,1941-04-14,0,1961,1961,4,14,USA
Pedro Joel,1985-09-27,5,2010,2015,9,27,D.R.
Jeffrey Howard,1969-09-23,13,1994,2007,9,23,USA
George Joseph,1910-08-25,0,1937,1937,8,25,USA
Galen Bernard,1936-03-07,8,1961,1969,3,7,USA
Steven R.,1986-06-18,9,2010,2019,6,18,USA
Jose Luis,1989-04-11,6,2013,2019,4,11,D.R.
Chalmer William,1904-01-03,10,1928,1938,1,3,USA
Ralph Alexander,1958-02-07,4,1983,1987,2,7,USA
Nicholas Anthony,1995-03-07,1,2018,2019,3,7,USA
Aaron James,1995-06-12,0,2019,2019,6,12,USA
John William,1901-11-13,0,1926,1926,11,13,USA
Robert Suter,1850-06-13,2,1874,1876,6,13,United Kingdom
Anthony Paul,1984-07-15,0,2009,2009,7,15,USA
Preston Michael,1988-01-21,4,2013,2017,1,21,USA
David Matthew,1897-11-17,0,1920,1920,11,17,USA
Albert Harrison,1888-08-14,0,1911,1911,8,14,USA
William Edward,1879-04-12,0,1905,1905,4,12,USA
John William,1900-09-15,10,1924,1934,9,15,USA
James,1955-12-18,14,1977,1991,12,18,USA
Eucal,1898-02-19,0,1922,1922,2,19,USA
Christopher Alan,1971-08-20,1,1999,2000,8,20,USA
John Edgar,1851-07-15,11,1872,1883,7,15,USA
Richard Keith,1973-02-24,0,2001,2001,2,24,CAN
Douglas William,1954-04-20,0,1976,1976,4,20,USA
Alfred Aloysius,1923-06-16,6,1947,1953,6,16,USA
Arthur Franklin,1865-05-06,1,1890,1891,5,6,USA
William Henry,1898-09-27,2,1927,1929,9,27,USA
Robert H.,1863-05-18,7,1886,1893,5,18,USA
William Jones,1868-10-18,12,1893,1905,10,18,USA
Robert William,1897-08-22,1,1920,1921,8,22,USA
Robert Cale,1955-06-13,6,1979,1985,6,13,USA
Bryan Donald,1956-07-12,9,1981,1990,7,12,USA
Brady William,1973-04-18,8,2000,2008,4,18,USA
James Buster,1915-03-13,0,1952,1952,3,13,USA
John Carroll,1906-09-19,0,1938,1938,9,19,USA
Douglas Cody,1981-09-14,0,2013,2013,9,14,USA
William H.,1865-01-07,10,1888,1898,1,7,USA
Arthur Hamilton,1866-08-31,5,1891,1896,8,31,USA
Alfred Robert,1873-07-16,0,1902,1902,7,16,USA
Daniel Curren,1894-01-18,5,1922,1927,1,18,USA
David Earl,1962-09-03,12,1986,1998,9,3,USA
Darren Lawrence,1981-03-18,0,2007,2007,3,18,USA
Douglas Dwyer,1976-03-05,1,2005,2006,3,5,USA
Bailey Earl,1907-11-06,7,1927,1934,11,6,USA
Fred Clifford,1872-10-03,21,1894,1915,10,3,USA
George Myron,1891-05-19,0,1913,1913,5,19,USA
Harvey Daniel,1879-03-07,0,1902,1902,3,7,USA
Glen Ester,1941-03-07,0,1967,1967,3,7,USA
Richard Grey,1912-09-26,0,1944,1944,9,26,USA
Harry Corson,1861-01-13,0,1889,1889,1,13,USA
Henry Tefft,1875-08-04,1,1897,1898,8,4,USA
Horace Meredith,1940-06-02,9,1965,1974,6,2,V.I.
Howard Roddy,1974-02-13,6,2002,2008,2,13,USA
Jack Anthony,1955-11-10,17,1975,1992,11,10,USA
Jerald Dwayne,1963-08-10,7,1988,1995,8,10,USA
Jermaine Marcel,1976-09-29,4,2001,2005,9,29,USA
James Francis,1887-12-26,1,1911,1912,12,26,USA
James,1927-09-21,0,1948,1948,9,21,USA
James Edward,1947-04-30,0,1971,1971,4,30,USA
John Gibson,1861-07-01,12,1882,1894,7,1,USA
Joshua Baldwin,1879-03-08,13,1898,1911,3,8,USA
Alan Thomas,1896-03-08,0,1921,1921,3,8,USA
Mark Willard,1968-05-12,9,1991,2000,5,12,USA
Matthew Terry,1986-12-10,0,2014,2014,12,10,USA
Melvin Earl,1924-07-07,6,1951,1957,7,7,USA
Michael John,1922-02-12,1,1952,1953,2,12,USA
Jay Justin,1882-12-15,15,1905,1920,12,15,CAN
William Otis,1915-05-22,0,1945,1945,5,22,USA
Harry,1883-03-20,0,1903,1903,3,20,USA
Philip James,1932-10-03,1,1958,1959,10,3,USA
Phillip Benjamin,1968-05-06,4,1992,1996,5,6,USA
Rickey Charles,1946-03-21,5,1967,1972,3,21,USA
Roy Elliott,1874-05-11,0,1902,1902,5,11,USA
Ronald Bruce,1943-01-14,9,1966,1975,1,14,USA
Rufus Rivers,1900-04-13,1,1923,1924,4,13,USA
Owen F.,1867-09-16,1,1889,1890,9,16,USA
William Stuart,1906-01-24,1,1929,1930,1,24,USA
Stanley Marten,1960-08-09,7,1983,1990,8,9,USA
Sumpter Mills,1897-10-18,4,1920,1924,10,18,USA
Taylor James,1993-05-13,0,2019,2019,5,13,USA
Terry Lee,1960-10-18,9,1988,1997,10,18,USA
Thomas Aloysius,1888-05-09,9,1909,1918,5,9,USA
Anthony Christopher,1972-06-15,14,1995,2009,6,15,USA
Walter Hamilton,1878-11-03,4,1904,1908,11,3,USA
William Watson,1902-05-16,13,1924,1937,5,16,USA
Vibert Ernesto,1928-06-08,0,1955,1955,6,8,Panama
William Otis,1870-08-16,4,1895,1899,8,16,USA
William Nuschler,1964-03-13,14,1986,2000,3,13,USA
William Winfield,1875-04-11,0,1897,1897,4,11,USA
Zachary Higgins,1983-07-11,0,2013,2013,7,11,USA
Ellis,1916-09-11,3,1942,1945,9,11,USA
Martin Keith,1962-04-03,3,1987,1990,4,3,USA
Emmanuel,1998-03-18,0,2019,2019,3,18,D.R.
Gowell Sylvester,1907-11-26,0,1933,1933,11,26,USA
Alexander,1992-01-31,5,2014,2019,1,31,P.R.
Albert Stanley,1891-06-23,0,1913,1913,6,23,USA
Brandon Allen Falker,1979-05-01,3,2003,2006,5,1,USA
Frederick William,1869-04-26,4,1892,1896,4,26,USA
Frederick C.,1874-11-23,0,1902,1902,11,23,USA
Dain Elmer,1919-07-10,3,1943,1946,7,10,USA
Danny Bruce,1961-10-24,0,1988,1988,10,24,USA
Kenneth Earl,1954-04-06,4,1977,1981,4,6,USA
Royce Spencer,1970-01-02,16,1991,2007,1,2,USA
Joseph Christopher,1918-12-03,0,1945,1945,12,3,Ireland
Mark Alan,1956-05-27,11,1979,1990,5,27,USA
William Melville,1919-06-20,7,1939,1946,6,20,USA
Robert Baxter,1886-08-09,0,1914,1914,8,9,USA
Chester Spurgeon,1917-05-10,5,1939,1944,5,10,USA
Clement Lambert,1886-11-02,2,1914,1916,11,2,USA
Douglas Horace,1939-06-09,8,1960,1968,6,9,USA
Frederick Garwood,1867-05-21,0,1890,1890,5,21,USA
Edgard Alexis Velazquez,1975-12-15,2,1998,2000,12,15,P.R.
John J.,1864-07-24,16,1884,1900,7,24,USA
Jeffrey Burton,1983-08-21,5,2007,2012,8,21,USA
Matthew Paul,1974-08-12,8,1998,2006,8,12,USA
Patrick Brian,1962-02-02,7,1985,1992,2,2,USA
Paul Arthur,1988-02-14,3,2013,2016,2,14,USA
Roberto,1934-08-18,17,1955,1972,8,18,P.R.
William Roger,1962-08-04,23,1984,2007,8,4,USA
Wallace Oakes,1881-07-21,1,1908,1909,7,21,USA
Christopher Hale,1972-10-31,0,1997,1997,10,31,USA
Lance Levis,1947-07-06,3,1971,1974,7,6,USA
Verne James,1891-09-08,8,1916,1924,9,8,USA
Donn Alvin,1935-07-15,11,1961,1972,7,15,USA
Maikel Jose,1989-05-01,3,2011,2014,5,1,D.R.
Elmer Ellsworth,1862-09-15,7,1884,1891,9,15,USA
Reginald Leslie,1948-05-23,12,1969,1981,5,23,CAN
Steven Scott,1986-04-05,5,2011,2016,4,5,USA
Truman Eugene,1932-07-09,8,1954,1962,7,9,USA
Michael Anthony,1990-12-21,3,2016,2019,12,21,USA
Brent Aaron,1983-10-27,4,2006,2010,10,27,USA
Stanley Gene,1956-12-19,0,1980,1980,12,19,USA
Stewart Walker,1956-12-19,4,1984,1988,12,19,USA
Herman Earl,1908-12-12,3,1934,1937,12,12,USA
Harlond Benton,1912-08-12,11,1934,1945,8,12,USA
Eugene Anthony,1946-10-06,9,1970,1979,10,6,USA
John P.,1858-03-03,9,1882,1891,3,3,USA
Tyrone Alexander,1939-06-15,11,1960,1971,6,15,USA
William Frederick,1869-11-21,13,1890,1903,11,21,USA
James Lawrence,1850-08-10,14,1872,1886,8,10,USA
Luciean Louis,1937-10-13,7,1960,1967,10,13,USA
Tyler Lee,1985-02-14,12,2007,2019,2,14,USA
Tony Lee,1940-08-13,11,1961,1972,8,13,USA
John Bradley,1971-04-25,5,1995,2000,4,25,USA
Jeffrey Darrin,1980-01-15,2,2004,2006,1,15,USA
Alan Edward,1943-06-15,7,1966,1973,6,15,USA
Kenneth Brian,1975-01-09,2,1997,1999,1,9,USA
Edgar George,1906-10-28,2,1924,1926,10,28,USA
William Perry,1898-08-14,0,1926,1926,8,14,USA
Tyler James,1987-05-16,6,2012,2018,5,16,USA
Bryan Richard,1959-12-17,3,1986,1989,12,17,USA
Danny,1974-04-06,2,1997,1999,4,6,USA
David Eugene,1955-04-22,6,1973,1979,4,22,USA
Thomas Knox,1923-08-17,0,1943,1943,8,17,USA
William Johnston,1872-12-18,0,1891,1891,12,18,USA
Otis Edgar,1876-01-27,8,1905,1913,1,27,USA
Bobby Dean,1961-11-11,0,1990,1990,11,11,USA
Andrew James,1882-11-20,9,1902,1911,11,20,USA
Gilbert Fitzgerald,1922-05-18,10,1946,1956,5,18,USA
James Alton,1932-08-04,11,1956,1967,8,4,USA
Buck,1982-06-09,2,2006,2008,6,9,USA
Jason Leavell,1990-02-24,0,2016,2016,2,24,USA
Alexander Miller,1987-10-07,8,2011,2019,10,7,USA
George Woodworth,1865-09-25,0,1892,1892,9,25,USA
Herbert Edward,1904-08-06,0,1929,1929,8,6,USA
Joseph Stanley,1895-01-24,0,1918,1918,1,24,USA
Tyrus Raymond,1886-12-18,23,1905,1928,12,18,USA
David Lamar,1912-12-24,0,1939,1939,12,24,USA
James Stanley,1957-02-14,3,1983,1986,2,14,P.R.
David Carter,1963-01-31,6,1986,1992,1,31,USA
George Leslie,1889-02-12,0,1918,1918,2,12,USA
Alvah Jackson,1890-01-31,0,1915,1915,1,31,USA
Gordon Stanley,1903-04-06,12,1925,1937,4,6,USA
James,1873-04-26,0,1905,1905,4,26,CAN
Atlee Alan,1962-12-05,0,1996,1996,12,5,USA
Pasqual,1977-09-08,2,2000,2002,9,8,D.R.
Eugene,1884-11-14,2,1913,1915,11,14,USA
Christopher Allen,1958-03-26,8,1982,1990,3,26,USA
Robert,1984-11-23,3,2010,2013,11,23,USA
John Francis,1887-01-28,9,1909,1918,1,28,USA
Justin Todd,1980-09-09,7,2005,2012,9,9,USA
Ivanon Angelino,1977-05-16,0,2000,2000,5,16,Curacao
Samuel Richard,1906-12-18,18,1927,1945,12,18,USA
Kevin Reese,1965-01-19,3,1987,1990,1,19,USA
George David,1910-12-11,3,1937,1940,12,11,USA
Richard Henry,1871-12-05,3,1897,1900,12,5,USA
Anthony Michael,1976-12-21,0,2001,2001,12,21,USA
David Raymond,1976-10-30,2,2000,2002,10,30,USA
Franklin,1944-05-22,5,1967,1972,5,22,USA
Richard Allen,1950-12-07,4,1972,1976,12,7,USA
Christopher B.,1985-06-18,8,2009,2017,6,18,USA
Edward,1854-02-25,3,1879,1882,2,25,United Kingdom
Alta Albert,1908-12-25,2,1931,1933,12,25,USA
Andrew Howard,1904-10-25,3,1926,1929,10,25,USA
Hyman,1931-01-29,0,1955,1955,1,29,USA
Sydney Harry,1906-05-07,3,1934,1937,5,7,USA
Phillip Douglas,1982-07-19,8,2008,2016,7,19,USA
Jimmie Goodwin,1936-03-28,9,1958,1967,3,28,USA
Christopher Adrian,1983-10-24,3,2013,2016,10,24,USA
Michael Gus,1976-10-22,3,1999,2002,10,22,USA
Rocco Domenico,1933-08-10,13,1955,1968,8,10,USA
Craig Charles,1965-02-13,1,1992,1993,2,13,USA
Michael Malloy,1955-04-19,1,1978,1979,4,19,USA
Nathan,1946-04-09,10,1966,1976,4,9,USA
Vincent Norman,1945-12-20,2,1970,1972,12,20,USA
James William,1946-05-22,9,1969,1978,5,22,USA
Gregory Joseph,1969-07-26,12,1992,2004,7,26,USA
Thomas Bernard,1870-10-08,6,1893,1899,10,8,USA
Andrew Jordan,1992-01-05,4,2015,2019,1,5,USA
Alexander,1965-08-17,6,1990,1996,8,17,USA
Albert George,1896-07-01,6,1921,1927,7,1,USA
David Bruce,1930-08-29,5,1950,1955,8,29,USA
Richard Roy,1926-05-06,6,1951,1957,5,6,USA
Edward William,1909-03-22,1,1938,1939,3,22,USA
Gerrit Alan,1990-09-08,6,2013,2019,9,8,USA
Leonard Leslie,1886-04-15,6,1909,1915,4,15,USA
Robert Hunter,1890-09-26,3,1913,1916,9,26,USA
Joseph Casey,1987-07-03,4,2010,2014,7,3,USA
Clarence,1935-08-25,5,1961,1966,8,25,USA
Curtis Hancock,1887-02-18,0,1912,1912,2,18,USA
David Lee,1950-10-26,0,1977,1977,10,26,USA
Dustin Michael,1987-04-20,2,2015,2017,4,20,USA
Parke Edward,1901-12-01,4,1932,1936,12,1,USA
Gordon Calvin,1934-07-05,8,1959,1967,7,5,USA
Gerald Francis,1924-09-14,8,1949,1957,9,14,USA
John Francis,1863-03-06,7,1883,1890,3,6,USA
John W.,1860-01-29,0,1890,1890,1,29,USA
Walter Lee,1873-06-13,0,1895,1895,6,13,USA
Joseph Patrick,1922-07-30,13,1942,1955,7,30,USA
Joseph Howard,1947-02-03,14,1965,1979,2,3,USA
Harold Louis,1986-04-04,7,2011,2018,4,4,USA
Michael Donnell,1975-08-16,4,1997,2001,8,16,USA
Pierce Devon,1876-10-15,1,1897,1898,10,15,USA
Raymond Leroy,1922-06-04,5,1947,1952,6,4,USA
Walter Gary,1931-07-31,5,1955,1960,7,31,USA
Vincent Maurice,1961-09-22,12,1985,1997,9,22,USA
Cadwallader,1886-01-17,0,1914,1914,1,17,USA
Charles Edward,1931-06-27,0,1958,1958,6,27,USA
Darnell,1962-06-02,14,1983,1997,6,2,USA
Stewart Bryan,1966-02-07,0,1991,1991,2,7,USA
Taylor James,1989-08-20,2,2017,2019,8,20,USA
Christopher Michael,1944-08-02,0,1972,1972,8,2,USA
Victor Alexander,1968-01-23,0,1992,1992,1,23,Russia
Willis Russell,1882-01-06,1,1909,1910,1,6,USA
Alvin Enrique,1981-12-26,0,2006,2006,12,26,Venezuela
Allan Edward,1887-06-05,4,1911,1915,6,5,USA
Earl Clinton,1898-08-29,3,1927,1930,8,29,USA
William,1979-11-07,0,2007,2007,11,7,P.R.
William Shirley,1882-03-27,4,1910,1914,3,27,USA
Charles Augustine,1857-10-12,1,1884,1885,10,12,CAN
Daniel Thomas,1853-09-27,2,1874,1876,9,27,USA
David S.,1952-10-20,15,1975,1990,10,20,USA
Donald Edward,1952-09-15,3,1977,1980,9,15,USA
Edward Trowbridge,1887-05-02,24,1906,1930,5,2,USA
Edward Trowbridge,1916-11-23,3,1939,1942,11,23,USA
James Harry,1869-03-11,0,1899,1899,3,11,USA
Hubert B.,1864-04-15,6,1886,1892,4,15,USA
James Joseph,1870-01-16,13,1895,1908,1,16,USA
Joseph Edward,1922-12-03,9,1948,1957,12,3,USA
Kevin Michael,1946-08-04,6,1965,1971,8,4,USA
Louis Keith,1973-08-21,7,1997,2004,8,21,USA
Orth Stein,1880-04-27,5,1904,1909,4,27,USA
Orlin Edward,1907-02-17,0,1931,1931,2,17,USA
Tharon Patrick,1896-09-13,10,1919,1929,9,13,USA
Philip Eugene,1901-08-27,12,1923,1935,8,27,USA
Ray Williston,1887-02-11,6,1909,1915,2,11,USA
Harry Warren,1896-02-26,11,1920,1931,2,26,USA
James Anthony,1904-03-30,10,1931,1941,3,30,USA
Robert Joseph,1909-09-18,4,1940,1944,9,18,USA
John Francis,1885-12-04,15,1910,1925,12,4,USA
Terry Lee,1949-05-27,NA,NA,NA,5,27,USA
Timothy Michael,1989-08-21,8,2011,2019,8,21,USA
Tyler James,1990-06-06,3,2014,2017,6,6,USA
Cyril Wilson,1889-05-07,1,1913,1914,5,7,USA
Zachary Allen,1995-02-06,0,2019,2019,2,6,USA
John Edgar,1892-05-04,7,1914,1921,5,4,USA
Joshua Michael,1986-02-07,6,2011,2017,2,7,USA
Jack Dean,1927-06-21,11,1951,1962,6,21,USA
William J.,1867-03-21,0,1885,1885,3,21,USA
Frank Lloyd,1918-03-02,5,1942,1947,3,2,CAN
Alexander Manuel,1988-12-31,6,2013,2019,12,31,D.R.
Jesus,1977-12-23,9,2001,2010,12,23,D.R.
Bartolo,1973-05-24,21,1997,2018,5,24,D.R.
Christian Anthony,1989-05-14,5,2014,2019,5,14,P.R.
Cristobal,1969-01-03,0,1992,1992,1,3,Venezuela
Joseph,1990-02-18,0,2016,2016,2,18,P.R.
Roman Benedicto,1979-08-13,8,2004,2012,8,13,D.R.
Richard Charles,1944-01-03,0,1970,1970,1,3,USA
Loyd Albert,1947-11-04,0,1970,1970,11,4,USA
Lawrence Robert,1942-06-08,0,1968,1968,6,8,USA
Robert Pasquali,1951-10-02,5,1973,1978,10,2,USA
Tyler Eugene,1985-09-05,5,2009,2014,9,5,USA
Stephen Edward,1979-02-22,4,2003,2007,2,22,USA
Geoffrey Wade,1956-02-01,1,1980,1981,2,1,USA
Earle Bryan,1899-05-14,11,1924,1935,5,14,USA
Merrill Russell,1919-12-11,5,1947,1952,12,11,USA
Patrick Dennis,1966-10-29,3,1989,1992,10,29,USA
Jorge,1916-12-07,0,1945,1945,12,7,Cuba
Steven Michael,1954-01-13,6,1978,1984,1,13,USA
Harry Wayne,1944-02-03,5,1967,1972,2,3,USA
Charles Albert,1859-08-15,12,1882,1894,8,15,USA
James Dalton,1928-10-15,1,1954,1955,10,15,USA
Adam Anthony,1904-12-09,9,1926,1935,12,9,USA
Robert Clinton,1950-11-01,0,1972,1972,11,1,USA
Harry Leroy,1882-03-09,0,1911,1911,3,9,USA
Michael Lynn,1944-08-15,0,1970,1970,8,15,USA
Anna Sebastian,1889-09-28,7,1911,1918,9,28,USA
Keith Martin,1955-12-23,7,1984,1991,12,23,USA
Ralph Remick,1890-11-24,5,1913,1918,11,24,USA
Clinton Astor,1921-07-24,1,1948,1949,7,24,USA
David Ismael,1948-06-17,18,1970,1988,6,17,Venezuela
Gerardo,1992-02-29,0,2016,2016,2,29,Cuba
Onix Cardona,1957-10-05,7,1980,1987,10,5,P.R.
Ramon Luis,1934-12-29,0,1962,1962,12,29,P.R.
Clayton Lee,1975-11-19,7,2002,2009,11,19,USA
Robert Earl,1894-02-27,0,1915,1915,2,27,USA
David Brian,1963-01-02,17,1986,2003,1,2,USA
Michael Thomas,1993-03-01,4,2015,2019,3,1,USA
William Millar,1875-01-24,5,1902,1907,1,24,CAN
Richard,1921-04-03,3,1940,1943,4,3,USA
Hyun Choi,1988-01-29,6,2010,2016,1,29,USA
William Michael,1947-08-15,4,1969,1973,8,15,USA
Anthony Richard,1945-01-07,11,1964,1975,1,7,USA
Jeffrey Guy,1966-06-27,17,1990,2007,6,27,USA
Allen Howard,1896-12-04,0,1920,1920,12,4,USA
John Bertrand,1899-12-06,1,1934,1935,12,6,USA
Adam Michael,1990-05-24,4,2015,2019,5,24,USA
Robert Burns,1934-02-01,0,1958,1958,2,1,USA
Edward J.,1864-07-10,0,1884,1884,7,10,USA
Donald Eugene,1930-11-10,11,1952,1963,11,10,USA
James Patrick Michael,1892-04-25,4,1914,1918,4,25,USA
Arthur Joseph,1897-12-10,0,1923,1923,12,10,USA
Patrick Joshua,1993-11-11,0,2018,2018,11,11,United Kingdom
Broadus Milburn,1902-09-19,1,1931,1932,9,19,USA
Frank Henry,1869-01-01,12,1894,1906,1,1,USA
Fritzie Lee,1958-05-19,2,1983,1985,5,19,USA
George Walter,1898-08-31,13,1921,1934,8,31,USA
Albert Thomas,1879-09-22,3,1898,1901,9,22,USA
William Wirt,1925-06-29,8,1945,1953,6,29,USA
Eugene Joseph,1906-05-10,0,1931,1931,5,10,USA
Joseph Bernard,1902-01-16,0,1926,1926,1,16,USA
Steven Lee,1974-04-27,0,1998,1998,4,27,USA
Terence G.,1855-06-17,0,1874,1874,6,17,USA
Thomas Martin,1897-10-20,1,1920,1921,10,20,USA
William Joseph,1941-11-02,2,1966,1968,11,2,USA
Mervin Thomas,1901-05-25,0,1925,1925,5,25,USA
Kevin Joseph Aloysius,1921-04-10,2,1949,1951,4,10,USA
Edward Joseph,1908-07-17,3,1929,1932,7,17,USA
Edward Joseph,1939-12-03,3,1964,1967,12,3,USA
James Matthew,1863-05-11,7,1892,1899,5,11,USA
Joseph Francis,1874-12-08,10,1895,1905,12,8,USA
Joseph Francis,1884-02-01,3,1913,1916,2,1,USA
Joseph Henry,1894-06-27,3,1921,1924,6,27,USA
Mervin James,1914-01-23,1,1937,1938,1,23,USA
Roger,1857-07-01,17,1880,1897,7,1,USA
Thomas Francis,1892-12-30,0,1915,1915,12,30,USA
Thomas Henry,1870-12-31,NA,NA,NA,12,31,United Kingdom
Theodore,1868-03-10,0,1889,1889,3,10,USA
Brooks Litchfield,1980-01-16,6,2008,2014,1,16,USA
Bernard Patrick,1871-03-14,0,1890,1890,3,14,USA
William Frederick,1899-01-09,0,1923,1923,1,9,USA
William Gordon,1915-02-26,9,1935,1944,2,26,USA
Timothy James,1960-04-03,9,1978,1987,4,3,USA
William Edward,1877-04-05,10,1901,1911,4,5,USA
William Angelo,1934-08-18,9,1953,1962,8,18,USA
Jimmy Lee,1933-06-14,7,1956,1963,6,14,USA
Jose G.,1983-09-01,3,2011,2014,9,1,D.R.
Sandalio Simeon,1920-09-03,7,1950,1957,9,3,Cuba
Stanley Jason,1975-01-27,4,2000,2004,1,27,USA
Carlos Manuel,1991-01-08,1,2014,2015,1,8,D.R.
Jose Ariel,1971-12-06,10,2003,2013,12,6,Cuba
Arnaldo Juan,1951-09-19,0,1980,1980,9,19,USA
Willson Eduardo,1992-05-13,3,2016,2019,5,13,Venezuela
James Daniel,1971-08-17,4,1993,1997,8,17,USA
William F.,1861-11-28,2,1884,1886,11,28,USA
Charles Connell,1886-04-28,0,1911,1911,4,28,USA
Richard Butler,1866-04-25,2,1886,1888,4,25,USA
Jack Clements,1918-07-30,7,1941,1948,7,30,USA
Jerome Patrick,1901-06-07,0,1920,1920,6,7,USA
James P.,1858-10-08,5,1884,1889,10,8,USA
Owen Sylvester,1889-10-23,0,1915,1915,10,23,USA
Peter J.,1866-10-30,4,1885,1889,10,30,USA
Richard Daniel,1896-04-18,0,1918,1918,4,18,USA
Edward James,1890-01-29,0,1911,1911,1,29,USA
Herbert Leroy,1921-01-08,0,1950,1950,1,8,USA
Joseph Harrison,1889-07-14,2,1913,1915,7,14,USA
Daniel George,1875-02-16,0,1895,1895,2,16,USA
Dale Roger,1930-08-14,0,1950,1950,8,14,USA
Aaron Lane,1979-02-08,10,2002,2012,2,8,USA
Andrew Bernard,1967-08-30,0,1993,1993,8,30,USA
Raymond Clifford,1936-08-20,4,1959,1963,8,20,USA
Dennis Bryan,1962-10-04,14,1988,2002,10,4,USA
Luther Almus,1886-06-24,3,1913,1916,6,24,USA
Earl Davis,1908-12-10,0,1941,1941,12,10,CAN
Allen Lindsey,1907-06-23,8,1930,1938,6,23,USA
Steven Montague,1970-01-14,6,1992,1998,1,14,USA
Glen Patrick,1959-09-08,0,1985,1985,9,8,USA
James Fitchie,1879-11-10,0,1903,1903,11,10,USA
Michael Horace,1963-08-14,7,1986,1993,8,14,USA
Paul,1863-05-05,7,1884,1891,5,5,USA
Rollin Edward,1890-10-05,0,1915,1915,10,5,USA
Ronald Wayne,1947-07-11,1,1970,1971,7,11,USA
Ryan William,1987-06-30,7,2011,2018,6,30,USA
Brent Adam,1969-09-07,4,1995,1999,9,7,USA
Michael Robert,1972-06-05,1,2001,2002,6,5,USA
Scott Robert,1966-06-13,5,1989,1994,6,13,USA
Duff Gordon,1873-03-29,12,1893,1905,3,29,USA
Raymond Franklin,1908-02-02,10,1933,1943,2,2,USA
Cecil Lysander,1888-03-18,0,1914,1914,3,18,USA
Daniel Bernard,1942-03-23,8,1963,1971,3,23,USA
John Wesley,1882-11-18,14,1906,1920,11,18,USA
Ronald Bryan,1966-11-18,8,1995,2003,11,18,USA
William Ambrose,1883-04-07,1,1909,1910,4,7,USA
Robert Daniel,1907-07-12,1,1931,1932,7,12,USA
James Joseph,1865-07-09,2,1890,1892,7,9,USA
James Edward,1894-08-24,11,1917,1928,8,24,USA
John Walter,1901-03-18,23,1921,1944,3,18,USA
Philip Clarence,1882-09-14,0,1905,1905,9,14,USA
Timothy Manus,1990-12-19,0,2015,2015,12,19,USA
Samuel Timothy,1992-09-22,0,2019,2019,9,22,USA
William K.,1855-03-21,1,1875,1876,3,21,USA
Andrew Lewis,1898-04-24,NA,NA,NA,4,24,USA
Brian John,1974-08-19,6,1999,2005,8,19,USA
Calvin Asa,1922-08-11,0,1948,1948,8,11,USA
Cecil Celester,1949-12-20,16,1971,1987,12,20,USA
Claude William,1892-04-01,4,1913,1917,4,1,USA
David Fletcher,1987-02-12,1,2011,2012,2,12,USA
Donald James,1956-01-15,4,1981,1985,1,15,USA
Gary Nathaniel,1956-12-22,0,1980,1980,12,22,USA
Gary Clifton,1964-08-13,0,1991,1991,8,13,USA
Garrett Nicholas,1990-12-25,2,2017,2019,12,25,USA
Guy Evans,1893-01-28,1,1914,1915,1,28,USA
Morton Cecil,1913-03-02,11,1938,1949,3,2,USA
Orge Patterson,1917-11-26,1,1946,1947,11,26,USA
Scott Kendrick,1967-10-13,7,1990,1997,10,13,USA
William Walker,1915-01-08,17,1940,1957,1,8,USA
Arley Wilbur,1892-02-24,14,1912,1926,2,24,USA
Mays,1913-08-31,0,1935,1935,8,31,USA
Scott Reast,1987-12-15,3,2015,2018,12,15,USA
John Thomas,1974-03-19,5,1996,2001,3,19,USA
Henry Peter,1912-08-04,1,1935,1936,8,4,USA
Trace Robert,1974-06-04,1,1999,2000,6,4,USA
Jose Alexander,1975-10-18,13,1998,2011,10,18,P.R.
Jose Manuel,1965-05-14,11,1987,1998,5,14,P.R.
Douglas Mitchell,1952-11-04,7,1980,1987,11,4,USA
Eugene Louis,1913-10-25,2,1936,1938,10,25,USA
Joseph Aloysius,1875-12-04,9,1895,1904,12,4,USA
Sherman Stanley,1962-11-03,2,1988,1990,11,3,USA
Archie Ray,1967-12-30,8,1991,1999,12,30,USA
Claude Elliott,1915-07-21,4,1945,1949,7,21,USA
Patrick Alan,1989-07-19,7,2012,2019,7,19,USA
Alton Ray,1949-02-12,4,1971,1975,2,12,USA
Daniel,1990-08-26,4,2014,2018,8,26,D.R.
Arthur Andrew,1894-11-23,0,1915,1915,11,23,USA
John H.,1858-05-15,0,1884,1884,5,15,USA
Lawrence J.,1859-08-10,7,1880,1887,8,10,USA
Michael J.,1858-10-10,0,1884,1884,10,10,USA
Michael Joseph,1882-08-26,0,1910,1910,8,26,USA
Roy Elliot,1980-05-11,6,2003,2009,5,11,USA
Timothy Michael,1953-03-19,9,1977,1986,3,19,USA
Timothy Hugh,1978-04-15,2,2005,2007,4,15,USA
Thomas William,1869-01-04,17,1890,1907,1,4,USA
Chad Patrick,1982-03-18,7,2003,2010,3,18,USA
Francisco Javier,1975-05-11,13,1999,2012,5,11,D.R.
Franchy,1994-09-02,2,2017,2019,9,2,D.R.
Jimmy Gerard,1991-10-19,1,2018,2019,10,19,D.R.
Ryan Thomas,1992-03-31,1,2018,2019,3,31,USA
Wilfredo,1971-10-03,13,1992,2005,10,3,P.R.
Erik Michael,1986-02-25,1,2014,2015,2,25,USA
Allen Octavio,1995-12-06,0,2017,2017,12,6,Panama
Francisco,1972-04-26,4,1996,2000,4,26,Mexico
Martin Kevin,1969-07-10,8,1995,2003,7,10,USA
Bryan Scott,1973-10-21,10,1998,2008,10,21,USA
Edward Norman,1894-07-13,0,1918,1918,7,13,USA
Mark Mundell,1955-11-03,2,1979,1981,11,3,USA
Mark Franklin,1974-11-16,3,2001,2004,11,16,USA
Charles Howard,1902-12-04,2,1925,1927,12,4,USA
Roy George,1887-10-21,5,1911,1916,10,21,USA
John Stewart,1858-04-11,9,1883,1892,4,11,USA
Michael Patrick,1946-05-25,5,1969,1974,5,25,USA
Lance Robert,1980-08-19,7,2004,2011,8,19,USA
Rheal Paul,1967-04-23,16,1991,2007,4,23,CAN
Brad Byron,1969-02-04,1,1994,1995,2,4,USA
Jeffrey Ray,1957-02-10,0,1984,1984,2,10,USA
John Francis,1989-05-17,0,2015,2015,5,17,USA
Nieves Mardie,1951-08-05,0,1978,1978,8,5,USA
Nathan John,1979-09-24,3,2001,2004,9,24,USA
Jonathan Reid,1970-06-02,5,1995,2000,6,2,USA
Terry Stanton,1952-10-02,1,1977,1978,10,2,USA
Manuel,1982-12-03,7,2006,2013,12,3,Panama
Carlos Fernando,1984-01-07,6,2009,2015,1,7,P.R.
Patrick,1941-03-20,9,1964,1973,3,20,USA
Carlos Javier,1994-09-22,4,2015,2019,9,22,P.R.
Edwin Josue,1966-04-29,2,1985,1987,4,29,P.R.
Kevin John,1980-08-24,12,2003,2015,8,24,USA
Ronald Douglas,1967-09-13,2,1993,1995,9,13,USA
Victor Crosby,1946-02-05,8,1972,1980,2,5,USA
Francis Joseph,1880-11-25,6,1904,1910,11,25,USA
John Michael,1918-01-06,0,1946,1946,1,6,USA
Philip F.,1858-08-19,0,1884,1884,8,19,USA
John Michael,1887-09-04,5,1910,1915,9,4,USA
James Bernard,1961-09-09,11,1988,1999,9,9,USA
John Francis,1904-09-26,0,1923,1923,9,26,USA
Barry Lee,1956-04-15,0,1977,1977,4,15,CAN
David Cardenas,1973-10-15,7,1999,2006,10,15,Mexico
Daniel Adam,1987-03-04,1,2010,2011,3,4,USA
Fernando,1981-08-10,2,2005,2007,8,10,USA
Nestor,1994-12-10,1,2018,2019,12,10,Cuba
Elmer Nathan,1926-12-03,4,1951,1955,12,3,USA
Jarred Lynn,1990-05-25,4,2013,2017,5,25,USA
Joseph Marvin,1909-11-18,1,1935,1936,11,18,USA
Peter Joseph,1913-06-16,8,1938,1946,6,16,USA
Donald Ray,1956-02-15,0,1980,1980,2,15,USA
Michael John,1951-02-17,4,1972,1976,2,17,USA
James Henry,1943-02-19,4,1966,1970,2,19,USA
Michael A.,1983-09-09,0,2012,2012,9,9,USA
Shane Jeremy,1981-12-12,2,2005,2007,12,12,USA
Christopher Robert,1973-02-04,3,2006,2009,2,4,USA
Daniel Francis,1891-09-09,3,1913,1916,9,9,USA
John Reilly,1960-12-24,3,1988,1991,12,24,USA
Timothy Roger,1969-02-16,1,1992,1993,2,16,USA
Humberto Figueroa,1979-02-07,6,2001,2007,2,7,Mexico
Henry Joseph,1864-02-19,1,1894,1895,2,19,USA
Warren Peter,1902-08-30,0,1926,1926,8,30,USA
Caleb Kent,1987-11-06,1,2015,2016,11,6,USA
Daniel Joseph,1867-04-14,0,1890,1890,4,14,USA
Richard Raphael,1889-10-12,1,1911,1912,10,12,USA
Edward Christopher,1904-07-04,0,1926,1926,7,4,USA
Harvey Louis,1900-05-22,2,1922,1924,5,22,USA
Thomas Benedict,1866-09-30,0,1891,1891,9,30,USA
Charles Keith,1936-01-18,10,1959,1969,1,18,USA
Henry,1961-01-05,9,1984,1993,1,5,USA
Jharel Leandre,1992-01-19,1,2016,2017,1,19,V.I.
Ensign Stover,1888-08-29,4,1911,1915,8,29,USA
Neal James,1980-03-25,12,2003,2015,3,25,USA
John Daniel,1891-03-31,8,1917,1925,3,31,USA
Michael Eugene,1957-12-04,0,1983,1983,12,4,USA
William Paul,1878-07-12,9,1899,1908,7,12,USA
Edward E.,1861-08-05,0,1884,1884,8,5,USA
James Marlan,1934-09-11,2,1960,1962,9,11,USA
William Edward,1868-03-15,1,1890,1891,3,15,USA
Daniel Paul,1989-10-26,4,2014,2018,10,26,USA
Robert Jackson,1887-06-17,6,1908,1914,6,17,USA
Thomas Lee,1945-06-05,0,1969,1969,6,5,USA
Frederick Nicholas,1889-12-13,7,1914,1921,12,13,USA
Craig John,1970-08-21,16,1995,2011,8,21,USA
Clinton Dawson,1927-03-16,10,1951,1961,3,16,USA
Edward Ernest,1875-01-20,6,1902,1908,1,20,USA
Henry Seymour,1898-11-19,3,1919,1922,11,19,USA
John Charles,1970-05-30,0,1995,1995,5,30,USA
Ryan A.,1988-05-28,0,2019,2019,5,28,USA
Edward Thomas,1898-12-16,2,1923,1925,12,16,USA
Scott Michael,1985-01-22,3,2010,2013,1,22,USA
Jonathan Thomas,1980-10-21,0,2007,2007,10,21,USA
Harry Frank,1886-04-23,11,1907,1918,4,23,USA
Stanley Anthony,1889-07-13,16,1912,1928,7,13,USA
John Patrick,1880-06-10,0,1903,1903,6,10,USA
Dylan Charles,1991-08-14,2,2017,2019,8,14,USA
Chester Rogers,1910-11-06,0,1944,1944,11,6,USA
Clarence Calvert,1894-11-18,5,1913,1918,11,18,USA
William Wilkes,1887-03-19,1,1911,1912,3,19,USA
John Wesley,1932-03-27,10,1956,1966,3,27,USA
Billy Rolland,1938-08-28,9,1963,1972,8,28,USA
Kaleb Bryant,1992-06-02,4,2015,2019,6,2,USA
Alfred Edward,1951-10-25,12,1974,1986,10,25,USA
Collin Brannen,1986-05-22,5,2011,2016,5,22,USA
Joseph Alan,1958-08-15,5,1982,1987,8,15,USA
William Donald,1913-06-23,4,1936,1940,6,23,USA
William Richard,1919-08-29,14,1941,1955,8,29,USA
Robert Joe,1941-05-21,1,1968,1969,5,21,USA
Joseph Casey,1941-07-03,7,1966,1973,7,3,USA
Danny Bradford,1959-09-21,12,1983,1995,9,21,United Kingdom
James Darron,1967-11-21,0,1999,1999,11,21,USA
Elmer Joseph,1895-09-30,1,1925,1926,9,30,USA
Ernest Thompson,1894-02-19,0,1922,1922,2,19,USA
Francis Bernard,1857-08-29,0,1884,1884,8,29,USA
George Melvin,1904-11-15,0,1928,1928,11,15,USA
Glenn Melvin,1931-02-03,3,1955,1958,2,3,USA
Jeffrey Lindon,1955-11-09,1,1980,1981,11,9,USA
James Charles,1950-05-28,3,1973,1976,5,28,USA
Larry Eugene,1947-09-11,9,1973,1982,9,11,USA
Leslie Warren,1904-08-14,0,1926,1926,8,14,USA
Plateau Preston Rex,1895-02-16,0,1920,1920,2,16,USA
Charles Steven,1974-10-31,3,1999,2002,10,31,USA
Terry Lee,1949-03-30,0,1970,1970,3,30,USA
William Ted,1955-01-24,4,1977,1981,1,24,USA
William Claude,1871-09-20,0,1893,1893,9,20,USA
Martin Albert,1894-10-20,0,1914,1914,10,20,USA
Charles Rhubin,1919-10-17,0,1945,1945,10,17,USA
Zachary Warren,1985-08-12,8,2011,2019,8,12,USA
Dylan Wallace,1994-05-31,1,2018,2019,5,31,USA
Callix Sadeaq,1983-02-14,0,2008,2008,2,14,V.I.
James Roy,1890-08-23,0,1912,1912,8,23,USA
George Elmer,1885-01-09,0,1910,1910,1,9,USA
Estel Crayton,1903-08-19,15,1929,1944,8,19,USA
Timothy Lyle,1969-10-13,6,1995,2001,10,13,USA
Walter Anderson,1932-03-25,3,1955,1958,3,25,USA
Rickey Nelson,1973-06-20,0,1998,1998,6,20,USA
Harry Francis,1915-04-19,5,1937,1942,4,19,USA
Maurice Montague,1895-11-28,3,1916,1919,11,28,USA
Howard Oliver,1908-05-25,2,1931,1933,5,25,USA
Allen Thomas,1984-07-18,5,2010,2015,7,18,USA
George McCarty,1883-11-15,0,1907,1907,11,15,USA
Peter Joel,1940-07-10,2,1964,1966,7,10,CAN
Roger Lee,1930-02-17,11,1955,1966,2,17,USA
Rodney Paul,1958-01-12,7,1979,1986,1,12,USA
Jesse Alan,1981-07-05,9,2004,2013,7,5,CAN
William Wendell,1891-05-22,0,1912,1912,5,22,USA
Robert Thomas,1979-10-28,1,2010,2011,10,28,USA
Edward,1855-08-18,0,1883,1883,8,18,USA
Roger Maxwell,1905-07-22,19,1929,1948,7,22,USA
Gerald Allen,1947-12-09,7,1969,1976,12,9,USA
Delmar Wesley,1930-03-05,17,1949,1966,3,5,USA
James Otis,1887-10-08,10,1908,1918,10,8,USA
Edward Nicholas,1862-05-27,9,1884,1893,5,27,USA
Frederick William Hotchkiss,1840-11-04,2,1873,1875,11,4,USA
Samuel Newhall,1854-01-02,10,1880,1890,1,2,USA
Samuel Byrem,1894-09-13,8,1914,1922,9,13,USA
Clifford Carlton,1881-03-23,12,1908,1920,3,23,USA
Tyler Jay,1989-07-13,1,2015,2016,7,13,USA
Brandon Michael,1987-01-21,8,2011,2019,1,21,USA
Carlos Lamonte,1971-10-04,0,1996,1996,10,4,USA
Carl Demonte,1981-08-05,14,2002,2016,8,5,USA
Evan Shane,1986-09-02,0,2012,2012,9,2,USA
Forrest A.,1881-05-10,1,1906,1907,5,10,USA
Glenn Martin,1913-12-02,1,1945,1946,12,2,USA
Rufus,1928-03-20,0,1952,1952,3,20,USA
James Frederick,1950-09-29,5,1973,1978,9,29,USA
Joseph Randal,1970-05-02,0,1997,1997,5,2,USA
John Paul,1995-01-11,2,2017,2019,1,11,USA
Kenneth Daniel,1894-10-31,0,1915,1915,10,31,USA
Charles Lowrie,1914-04-27,0,1937,1937,4,27,USA
Clifford Rankin,1902-01-28,5,1929,1934,1,28,USA
Paxton Keith,1977-08-04,1,2000,2001,8,4,USA
Samuel Earl,1880-04-18,18,1899,1917,4,18,USA
Steven Ray,1958-04-29,11,1980,1991,4,29,USA
Willie Murphy,1946-09-07,13,1964,1977,9,7,USA
Joseph,1978-04-26,9,2000,2009,4,26,USA
William Franklin,1882-10-23,7,1908,1915,10,23,USA
Cornelius Stephen,1915-07-21,0,1943,1943,7,21,USA
Patrick Francis,1906-05-23,0,1931,1931,5,23,USA
Mark,1864-07-31,0,1884,1884,7,31,USA
Paul Douglas,1969-03-01,10,1995,2005,3,1,USA
August L.,1870-06-06,0,1890,1890,6,6,USA
Jack Dalton,1916-04-23,0,1945,1945,4,23,USA
Steven Keith,1959-02-04,5,1982,1987,2,4,USA
Peter James,1875-04-13,4,1899,1903,4,13,USA
Bernard Odell,1927-03-21,0,1947,1947,3,21,USA
Robert Anthony,1906-02-15,0,1927,1927,2,15,USA
Cesar Antonio,1979-05-23,3,2001,2004,5,23,P.R.
Frank Angelo Joseph,1918-02-16,4,1938,1942,2,16,USA
Felipe Javier,1973-03-05,5,1996,2001,3,5,P.R.
John Baptiste,1975-05-13,4,2000,2004,5,13,USA
Walker James,1917-03-06,1,1948,1949,3,6,USA
Stanley Timothy,1961-04-03,5,1987,1992,4,3,USA
Stefan Brook,1992-02-29,2,2017,2019,2,29,USA
Kyle Daniel,1992-11-30,2,2017,2019,11,30,USA
Jerry Stephen,1941-09-02,1,1969,1970,9,2,USA
Louis,1872-02-03,16,1896,1912,2,3,USA
Charles Robert,1961-07-23,7,1987,1994,7,23,USA
John Melvin,1926-02-17,6,1951,1957,2,17,USA
David Gordon,1951-04-07,0,1978,1978,4,7,USA
David Gerald,1951-09-02,0,1977,1977,9,2,USA
Anthony Paul,1915-07-09,2,1942,1944,7,9,USA
Patrick J.,1877-06-04,0,1899,1899,6,4,USA
Covelli Loyce,1979-11-01,14,2002,2016,11,1,USA
Joseph Shelby,1885-07-08,1,1910,1911,7,8,USA
Dode,1885-03-12,3,1908,1911,3,12,USA
William Arthur,1875-09-12,0,1901,1901,9,12,Russia
Chester Arthur,1882-02-10,0,1906,1906,2,10,USA
Dante Leo,1926-12-10,4,1951,1955,12,10,USA
Morris Arthur,1850-03-26,0,1882,1882,3,26,USA
Hugh Melville,1900-09-17,11,1924,1935,9,17,USA
Claude Arthur,1924-07-20,1,1944,1945,7,20,USA
David Solomon,1875-10-05,0,1901,1901,10,5,USA
Kyle Richard,1991-12-15,4,2014,2018,12,15,USA
Arthur F.,1855-01-23,3,1875,1878,1,23,USA
Henry T.,1875-08-01,2,1899,1901,8,1,USA
Frederick Joseph,1876-12-16,1,1901,1902,12,16,USA
Warren Livingston,1953-09-29,17,1974,1991,9,29,USA
David Thomas,1971-03-19,1,2000,2001,3,19,USA
Roy Bunyan,1967-11-21,10,1993,2003,11,21,USA
Herbert Bryan,1911-11-07,8,1937,1945,11,7,USA
Edward,1889-02-13,1,1909,1910,2,13,United Kingdom
Christopher John,1964-03-31,1,1991,1992,3,31,USA
Christopher John,1990-01-05,5,2014,2019,1,5,USA
Raymond Hayes,1931-08-07,4,1954,1958,8,7,USA
William Patrick,1902-12-26,3,1928,1931,12,26,USA
Daniel T.,1857-04-01,0,1884,1884,4,1,USA
John J.,1874-05-26,9,1895,1904,5,26,USA
James John,1905-08-07,0,1929,1929,8,7,USA
Joseph Edward,1906-10-12,19,1926,1945,10,12,USA
Kevin Scott,1993-02-17,0,2019,2019,2,17,USA
Charles John,1865-11-09,9,1889,1898,11,9,USA
Thomas Aloysius,1884-07-26,1,1909,1910,7,26,USA
Robert Edward,1980-01-12,7,2003,2010,1,12,USA
Richard Stephen,1976-08-11,3,2003,2006,8,11,USA
Casey W.,1988-09-17,0,2012,2012,9,17,USA
Edward Carlton,1949-05-26,6,1970,1976,5,26,USA
Kenneth Stewart,1947-12-15,1,1975,1976,12,15,CAN
Frank Peter Joseph,1910-10-04,16,1932,1948,10,4,USA
Clarence M.,1856-03-04,3,1884,1887,3,4,USA
Frank Atwell,1873-01-20,0,1901,1901,1,20,USA
Frank Patrick,1891-06-15,2,1912,1914,6,15,USA
Joffre James,1918-08-28,6,1942,1948,8,28,USA
Joseph A.,1858-01-06,NA,NA,NA,1,6,USA
Lafayette Napoleon,1866-05-12,20,1887,1907,5,12,USA
George Lewis,1872-01-09,1,1893,1894,1,9,USA
Montford Montgomery,1869-08-31,15,1892,1907,8,31,USA
Douglass,1859-11-16,1,1884,1885,11,16,USA
Joseph P.,1859-12-24,4,1882,1886,12,24,USA
Michael John,1984-09-25,0,2011,2011,9,25,USA
William Henry,1886-12-03,0,1910,1910,12,3,USA
William Elmer,1907-08-20,6,1939,1945,8,20,USA
Frank Donald,1914-07-23,3,1939,1942,7,23,USA
Jack Albert,1903-10-12,3,1930,1933,10,12,USA
Zachary Quinn,1965-10-26,0,1988,1988,10,26,USA
Clyde Ellsworth,1897-01-06,7,1923,1930,1,6,USA
Richard Steven,1970-08-07,2,1998,2000,8,7,USA
Aaron James,1986-11-10,3,2011,2014,11,10,USA
Alvin Floyd,1899-01-11,10,1926,1936,1,11,USA
Paul Dean,1972-08-21,0,1998,1998,8,21,USA
Donald Leroy,1958-08-18,0,1982,1982,8,18,USA
William Theodore,1865-11-06,1,1887,1888,11,6,USA
Minot Joy,1892-09-05,1,1915,1916,9,5,USA
George Daniel,1921-03-22,9,1952,1961,3,22,USA
James Everette,1974-05-14,8,1997,2005,5,14,USA
Trevor Thornton,1983-11-17,4,2009,2013,11,17,USA
William Michael,1857-04-08,10,1875,1885,4,8,USA
Edgar Jewel,1906-08-06,0,1928,1928,8,6,USA
John A.,1862-01-12,0,1884,1884,1,12,USA
Terrence Michael,1947-02-16,14,1969,1983,2,16,USA
Thomas Woodrow,1918-09-09,0,1945,1945,9,9,USA
Eric Le Roi,1978-08-11,0,2004,2004,8,11,USA
Francisco Alberto,1981-07-04,4,2004,2008,7,4,D.R.
Michael Christopher,1977-01-03,1,2002,2003,1,3,USA
Walton Edwin,1890-05-06,10,1914,1924,5,6,USA
Clarence Newton,1889-07-27,1,1917,1918,7,27,USA
Eugene Leon,1922-04-05,0,1945,1945,4,5,USA
Arthur Elliott,1901-11-29,0,1924,1924,11,29,USA
Roy Maxton,1896-07-08,5,1920,1925,7,8,USA
Richard Luther,1889-11-25,1,1914,1915,11,25,USA
Charles Preston,1890-09-08,1,1913,1914,9,8,USA
Deivi,1972-11-06,8,1997,2005,11,6,D.R.
Enrique Michael,1981-11-21,4,2003,2007,11,21,D.R.
Fausto,1972-05-01,2,1994,1996,5,1,D.R.
Hector Louis,1953-04-02,9,1973,1982,4,2,P.R.
Henry,1952-02-27,3,1975,1978,2,27,V.I.
Luis Ivan,1968-05-03,5,1997,2002,5,3,P.R.
Jacob,1973-01-28,9,1996,2005,1,28,USA
Jose,1947-08-08,18,1970,1988,8,8,P.R.
Jose Luis,1974-04-19,11,1997,2008,4,19,P.R.
Julio Louis,1954-12-02,9,1977,1986,12,2,USA
Juan Carlos,1978-10-15,11,2001,2012,10,15,D.R.
Luis Alfonso,1984-02-10,5,2008,2013,2,10,Mexico
Nelson,1972-09-13,6,1997,2003,9,13,D.R.
Nelson Ramon,1980-07-01,14,2005,2019,7,1,D.R.
Rhiner Allen,1986-11-01,6,2012,2018,11,1,D.R.
Cirilo,1951-02-15,4,1973,1977,2,15,P.R.
Todd Ruben,1955-11-23,6,1978,1984,11,23,USA
Arnoldi Anthony,1986-08-18,7,2011,2018,8,18,USA
Victor Manuel,1957-12-24,5,1978,1983,12,24,D.R.
Michael Lee,1950-07-21,7,1974,1981,7,21,USA
Darwin Harrikson,1972-11-15,4,2000,2004,11,15,Venezuela
Alfred Edward,1914-08-26,0,1935,1935,8,26,USA
Anthony Francis,1907-11-08,15,1930,1945,11,8,USA
Arthur Joseph,1918-02-08,2,1943,1945,2,8,USA
Michael Brent,1979-03-27,14,2001,2015,3,27,USA
James Alaric,1858-08-22,0,1884,1884,8,22,USA
Robert,1952-08-20,0,1977,1977,8,20,USA
Jesus Patracis,1917-09-24,0,1950,1950,9,24,USA
Miguel Angel,1937-05-08,18,1959,1977,5,8,Cuba
Dagoberto,1937-08-14,0,1961,1961,8,14,Cuba
Johnny,1986-02-15,11,2008,2019,2,15,D.R.
Manuel,1892-02-08,5,1914,1919,2,8,Cuba
Noel A.,1991-10-02,1,2018,2019,10,2,P.R.
William Enrique,1990-10-14,2,2016,2018,10,14,Venezuela
John Patrick,1864-07-26,0,1884,1884,7,26,USA
Charles Edward,1989-04-10,7,2012,2019,4,10,USA
Delbert Leon,1918-08-06,5,1943,1948,8,6,USA
Richard Broadus,1915-01-15,13,1936,1949,1,15,USA
John Patrick,1939-10-06,4,1962,1966,10,6,USA
John Joseph,1854-07-09,0,1884,1884,7,9,USA
Roy Joseph,1913-10-18,9,1938,1947,10,18,USA
Timothy Leo,1942-02-16,6,1966,1972,2,16,USA
Bernard Aloysius,1896-05-19,1,1925,1926,5,19,USA
Norman Andrew,1887-09-17,8,1913,1921,9,17,USA
Henry Nicholas,1900-10-16,5,1926,1931,10,16,USA
Wilfred Hillard,1957-11-11,0,1983,1983,11,11,Bahamas
Benjamin Baldy,1914-01-19,2,1942,1944,1,19,USA
William Edward,1887-06-11,0,1910,1910,6,11,USA
Raymond Leonard,1941-08-06,10,1963,1973,8,6,USA
George Raymond,1943-07-08,8,1966,1974,7,8,USA
John Sheldon,1947-05-10,6,1968,1974,5,10,USA
William Arthur,1848-10-18,5,1872,1877,10,18,USA
John William,1904-04-01,3,1926,1929,4,1,USA
John Russell,1969-05-10,4,1993,1997,5,10,USA
Midre Almeric,1971-10-14,12,1993,2005,10,14,V.I.
Steven Brent,1964-07-15,1,1989,1990,7,15,USA
Brandon Tyler,1988-11-16,5,2013,2018,11,16,USA
William Joseph,1974-04-24,7,1997,2004,4,24,USA
Aaron R.,1986-04-24,4,2008,2012,4,24,USA
Elmer Ellsworth,1865-11-25,14,1887,1901,11,25,USA
William James,1886-06-09,2,1910,1912,6,9,USA
William Aloysius,1894-07-30,3,1921,1924,7,30,USA
Bruce Lee,1905-09-29,3,1929,1932,9,29,USA
Brandon Michael,1988-10-07,1,2015,2016,10,7,USA
George Harold,1894-07-13,5,1916,1921,7,13,USA
Joseph Robert,1931-08-27,12,1954,1966,8,27,USA
Mody,1882-06-14,0,1906,1906,6,14,USA
Raymond Lee,1905-01-17,1,1931,1932,1,17,USA
Thomas David,1989-03-20,3,2013,2016,3,20,USA
George Joseph,1869-07-03,9,1892,1901,7,3,USA
Walter James,1874-03-12,0,1899,1899,3,12,USA
Simon Francis,1874-10-30,0,1902,1902,10,30,USA
Delancey Lafayette,1951-12-03,0,1975,1975,12,3,USA
William Cleveland,1926-11-29,0,1955,1955,11,29,USA
Clarence Franklin,1878-12-30,1,1902,1903,12,30,CAN
Archibald Murphy,1893-08-31,0,1916,1916,8,31,USA
Perry Gilmore,1928-09-27,0,1947,1947,9,27,USA
George James,1888-12-23,0,1911,1911,12,23,USA
James L.,1886-03-10,9,1909,1918,3,10,USA
Stephen Thomas,1965-09-13,0,1988,1988,9,13,USA
George Anthony,1937-12-22,6,1960,1966,12,22,Bahamas
Wesley,1860-04-01,0,1884,1884,4,1,USA
Chad David,1968-11-06,9,1992,2001,11,6,USA
Clifton Garfield,1881-07-03,4,1909,1913,7,3,USA
Colin Benedict,1985-02-01,0,2010,2010,2,1,USA
Edwin Russell,1843-08-29,NA,NA,NA,8,29,USA
Ervin Duane,1861-12-27,0,1891,1891,12,27,USA
Frederick Marion,1880-10-30,0,1905,1905,10,30,USA
Eugene Holmes,1883-05-05,0,1903,1903,5,5,USA
Harry Albert,1883-02-19,0,1907,1907,2,19,USA
Jack Patrick,1937-01-11,2,1961,1963,1,11,USA
Jermaine Antwann,1987-07-10,0,2013,2013,7,10,USA
John Duffield,1948-03-09,14,1970,1984,3,9,USA
John Pickens,1993-04-05,2,2017,2019,4,5,USA
Vernon Eugene,1920-05-24,3,1943,1946,5,24,USA
Zachary Aaron,1992-07-04,2,2016,2018,7,4,USA
Guy Paxton,1912-10-18,3,1943,1946,10,18,USA
Charles H.,1850-05-25,NA,NA,NA,5,25,USA
Edgar Leander,1852-03-27,7,1883,1890,3,27,USA
Harvey Barnes,1877-07-05,0,1902,1902,7,5,USA
John Peter,1928-06-12,1,1951,1952,6,12,USA
John Joseph,1979-01-16,10,2001,2011,1,16,USA
Cheslor Jesly,1992-11-16,4,2015,2019,11,16,Nicaragua
Edgar Edward,1845-06-20,13,1871,1884,6,20,USA
George William,1886-07-29,11,1912,1923,7,29,USA
Hazen Shirley,1898-08-30,17,1921,1938,8,30,USA
Milton,1968-10-07,8,1990,1998,10,7,USA
Michael John,1900-12-01,7,1922,1929,12,1,USA
Alfred Boyd,1889-08-08,0,1914,1914,8,8,USA
Eric,1979-02-11,0,2002,2002,2,11,CAN
James Mark,1963-12-18,0,1994,1994,12,18,USA
Omar Jesus,1972-03-01,10,1993,2003,3,1,Venezuela
John Francis,1951-12-24,9,1973,1982,12,24,USA
Lonnie Paul,1951-12-07,5,1975,1980,12,7,USA
John Douglas,1917-04-25,0,1943,1943,4,25,USA
Peter George,1906-02-28,0,1932,1932,2,28,USA
Angelo George,1934-08-22,0,1955,1955,8,22,USA
David Martin,1994-04-01,3,2016,2019,4,1,USA
William Frederick,1870-01-05,20,1891,1911,1,5,USA
Ellsworth Tenney,1912-06-15,11,1935,1946,6,15,USA
Jay Steven,1945-12-06,0,1963,1963,12,6,USA
Jerome Alexander,1929-06-08,0,1956,1956,6,8,USA
Sean Casey,1981-04-04,6,2004,2010,4,4,USA
William Garland,1935-03-13,3,1961,1964,3,13,USA
John J.,1853-10-26,0,1875,1875,10,26,USA
Samuel Lawrence,1904-03-31,0,1929,1929,3,31,USA
Vincent Perry,1864-12-25,0,1890,1890,12,25,USA
Cornelius F.,1864-09-11,11,1885,1896,9,11,USA
Edward M.,1862-09-07,6,1885,1891,9,7,USA
Hugh Ignatius,1847-07-17,5,1882,1887,7,17,Ireland
George R.,1857-03-09,0,1884,1884,3,9,USA
John Bruce,1941-06-15,10,1967,1977,6,15,USA
James Carl,1972-12-07,0,1999,1999,12,7,USA
Emmett Eugene,1889-06-16,5,1911,1916,6,16,USA
Peter Martin,1960-06-26,0,1989,1989,6,26,USA
Mark Anthony,1968-05-14,7,1994,2001,5,14,USA
William,1868-06-27,2,1889,1891,6,27,USA
Leavitt Leo,1932-10-07,9,1955,1964,10,7,USA
John Francis,1887-05-25,0,1912,1912,5,25,USA
Judson Lawrence,1884-03-14,1,1911,1912,3,14,USA
Matthew Thomas,1982-06-23,5,2009,2014,6,23,USA
Peter Harvey,1930-01-14,6,1955,1961,1,14,USA
Thomas Francis,1884-11-13,7,1908,1915,11,13,USA
Nicholas Dominic,1913-10-03,10,1937,1947,10,3,USA
Brian Scott,1973-11-15,1,2004,2005,11,15,USA
Abner Frank,1857-09-09,13,1878,1891,9,9,USA
William Dunn,1891-02-07,0,1915,1915,2,7,USA
Clayton Errol,1936-12-03,11,1960,1971,12,3,USA
Tolbert Percy,1885-07-03,6,1910,1916,7,3,USA
Michael Edward,1963-03-27,0,1991,1991,3,27,USA
Albert Joseph,1881-04-08,0,1903,1903,4,8,USA
George Josephs,1887-07-28,0,1909,1909,7,28,USA
Joseph John,1868-09-21,2,1890,1892,9,21,USA
James J.,1865-01-06,0,1892,1892,1,6,USA
Thomas Peter,1866-02-07,19,1884,1903,2,7,USA
Thomas Daniel,1891-12-12,8,1913,1921,12,12,CAN
Jack Lloyd,1937-08-21,0,1963,1963,8,21,USA
Elbridge Rust,1885-04-04,0,1909,1909,4,4,USA
Jeffrey Charles,1975-12-27,8,1996,2004,12,27,USA
Jeffrey Michael,1974-11-09,0,2000,2000,11,9,USA
William Henry,1872-08-09,2,1897,1899,8,9,USA
Johnny David,1973-11-05,17,1995,2012,11,5,USA
Harry Robert,1890-09-11,0,1915,1915,9,11,USA
Raymond Emmett,1913-08-31,NA,NA,NA,8,31,USA
Patrick Rees,1976-01-14,0,1999,1999,1,14,USA
Arthur Lee,1904-07-09,0,1928,1928,7,9,USA
David Charles,1890-03-07,14,1911,1925,3,7,USA
Bernard Elmer,1882-10-31,4,1910,1914,10,31,USA
Bennie,1932-06-17,8,1957,1965,6,17,USA
Charles L.,1861-07-01,0,1884,1884,7,1,USA
Charles Edward,1933-09-17,0,1957,1957,9,17,USA
Handley Jacob,1911-04-22,0,1937,1937,4,22,USA
Harold Jack,1927-12-21,0,1952,1952,12,21,USA
Kalvoski,1963-08-20,6,1986,1992,8,20,USA
Lawrence Long,1862-07-14,1,1887,1888,7,14,USA
Peter J.,1864-04-08,8,1890,1898,4,8,Ireland
Frederick Clinton,1923-12-28,0,1945,1945,12,28,USA
Tyler Michael,1994-09-12,2,2016,2018,9,12,USA
John William,1985-04-15,9,2007,2016,4,15,USA
Jordan Cooper,1986-08-07,3,2012,2015,8,7,USA
Henry Frederick,1891-06-08,0,1915,1915,6,8,USA
Harry,1911-09-06,9,1933,1942,9,6,USA
Isaac,1905-01-20,0,1928,1928,1,20,USA
John James,1918-12-31,1,1944,1945,12,31,USA
James Joseph,1982-05-12,0,2008,2008,5,12,USA
Harold Paul,1887-04-30,0,1909,1909,4,30,USA
Clifford Roland,1920-01-02,0,1942,1942,1,2,USA
George William,1869-02-06,0,1893,1893,2,6,USA
Patrick Leonard,1950-05-12,2,1974,1976,5,12,USA
Victor Anthony,1970-11-13,7,1998,2005,11,13,USA
Clifford Clarence,1885-04-10,0,1914,1914,4,10,USA
Rolla Harrison,1888-11-15,1,1914,1915,11,15,USA
Alvin Ralph,1922-01-07,14,1946,1960,1,7,USA
Conrad,1861-12-21,8,1883,1891,12,21,USA
Ronald Maurice,1960-08-19,12,1983,1995,8,19,USA
Chase Jonathan,1987-01-21,7,2011,2018,1,21,USA
Travis E.,1989-02-10,6,2013,2019,2,10,USA
Robert Jack,1930-11-06,2,1954,1956,11,6,USA
James Thomas,1987-01-19,1,2011,2012,1,19,USA
Logan Reece,1989-02-02,0,2014,2014,2,2,USA
James S.,1866-07-17,0,1891,1891,7,17,USA
Michael Edward,1956-03-23,0,1977,1977,3,23,USA
Michael Curtis,1976-03-21,2,1999,2001,3,21,USA
George Oliver,1903-07-12,0,1934,1934,7,12,USA
Sefat Farid Yu,1986-08-16,7,2012,2019,8,16,Japan
Arthur Bobby Lee,1943-02-16,15,1962,1977,2,16,USA
Daniel Wayne,1955-10-25,20,1978,1998,10,25,USA
Jeffrey Scott,1969-07-06,3,1994,1997,7,6,USA
Douglas Craig,1964-06-30,8,1988,1996,6,30,USA
John Wallace,1902-05-09,0,1924,1924,5,9,USA
Lee Claire,1887-04-25,0,1913,1913,4,25,USA
Francis Joseph Nicholas,1917-08-31,1,1945,1946,8,31,USA
Jeffrey William,1959-11-28,0,1989,1989,11,28,USA
Brian Michael,1972-02-11,7,1998,2005,2,11,USA
Daniel William,1868-01-12,5,1892,1897,1,12,USA
Harry J.,1892-06-19,0,1915,1915,6,19,USA
Jacob Ellsworth,1884-04-17,14,1910,1924,4,17,USA
Richard Fremont,1952-07-27,9,1976,1985,7,27,USA
Robert Francis,1914-08-05,0,1937,1937,8,5,USA
Harold Ray,1927-10-12,0,1951,1951,10,12,USA
John Michael,1960-07-03,6,1987,1993,7,3,USA
Darren Arthur,1962-01-03,14,1983,1997,1,3,USA
George August,1889-09-22,14,1912,1926,9,22,USA
Victor Jose,1939-07-30,17,1963,1980,7,30,Venezuela
Pompeyo Antonio,1928-06-30,0,1953,1953,6,30,Venezuela
Frank Gerald,1945-08-21,8,1969,1977,8,21,USA
Jeffrey Graham,1973-12-08,8,1999,2007,12,8,USA
Claude Edwin,1898-05-28,0,1920,1920,5,28,USA
David W.,1890-02-20,5,1914,1919,2,20,USA
James Houston,1933-08-17,12,1958,1970,8,17,USA
Joseph Jonathan,1976-03-24,2,1999,2001,3,24,USA
Joubert Lum,1900-06-27,3,1921,1924,6,27,USA
Michael Gerard,1952-06-02,1,1977,1978,6,2,USA
Thomas Joseph,1973-09-11,3,1999,2002,9,11,USA
Raymond Joseph Robert,1934-05-27,0,1962,1962,5,27,CAN
Andre Anter,1958-05-18,2,1984,1986,5,18,USA
William Simpson,1884-05-10,2,1909,1911,5,10,USA
Robert Banks,1963-01-06,0,1989,1989,1,6,Germany
Claude Boucher,1896-10-13,1,1918,1919,10,13,USA
Cleatus Lavon,1976-11-01,0,1999,1999,11,1,USA
David Lawrence,1984-04-23,2,2007,2009,4,23,CAN
Daniel Gerome,1981-01-08,0,2009,2009,1,8,USA
Homer Hurd,1884-10-14,0,1908,1908,10,14,USA
John Mark,1961-02-15,5,1986,1991,2,15,USA
Matthew Glen,1991-03-26,5,2013,2018,3,26,USA
Mordecai Hamilton,1845-11-30,NA,NA,NA,11,30,USA
Thomas Eugene,1939-10-04,3,1965,1968,10,4,USA
Lloyd Garrison,1892-03-06,12,1914,1926,3,6,USA
George Washington,1868-02-22,2,1891,1893,2,22,USA
Gerald Lee,1933-02-10,0,1959,1959,2,10,USA
Hiram Kyle,1983-09-09,10,2005,2015,9,9,USA
Zachary Ryan,1993-02-07,4,2015,2019,2,7,USA
Alvin Glenn,1960-09-09,8,1984,1992,9,9,USA
Austin Richard,1993-02-03,1,2018,2019,2,3,USA
Mark Christopher,1977-03-10,6,1998,2004,3,10,USA
Arthur Willard,1942-06-06,4,1965,1969,6,6,USA
Blake Jonathan,1983-12-22,0,2011,2011,12,22,USA
Robert Edward,1933-09-11,2,1958,1960,9,11,USA
Robert John Eugene,1952-03-01,8,1973,1981,3,1,USA
Robert Brandon,1927-09-10,1,1952,1953,9,10,USA
Bryshear Bennett,1943-10-19,9,1963,1972,10,19,USA
Bradley Edward,1982-12-29,0,2010,2010,12,29,USA
John Wilbur,1895-12-07,0,1915,1915,12,7,USA
Wallace McArthur,1958-06-19,11,1983,1994,6,19,USA
Charles Theodore,1960-01-17,18,1981,1999,1,17,Jamaica
Christopher Lyn,1986-03-17,11,2008,2019,3,17,USA
Lawrence Columbus,1919-07-14,2,1940,1942,7,14,USA
Curtis Benton,1903-09-07,12,1934,1946,9,7,USA
John Henry Albert,1858-11-28,1,1884,1885,11,28,USA
Frank Talmadge,1890-10-12,14,1912,1926,10,12,USA
Richard Earl,1953-09-25,5,1977,1982,9,25,USA
Douglas Raymond,1962-09-24,4,1988,1992,9,24,USA
Douglas,1975-09-21,12,1999,2011,9,21,USA
Eric Keith,1962-05-29,17,1984,2001,5,29,USA
Erik Randall,1986-10-08,0,2013,2013,10,8,USA
George Stacey,1870-08-23,19,1890,1909,8,23,USA
George Allen,1890-03-09,3,1912,1915,3,9,USA
Gerald Edward,1958-12-25,2,1983,1985,12,25,USA
Glenn Earle,1961-03-28,9,1984,1993,3,28,USA
Harry H.,1873-07-18,22,1895,1917,7,18,USA
Harry Albert,1908-03-07,5,1932,1937,3,7,USA
Isaac Marion,1895-06-14,6,1919,1925,6,14,USA
Isaac Benjamin,1987-03-22,6,2010,2016,3,22,USA
James Ira,1870-07-08,0,1899,1899,7,8,USA
Jacke Sylvesta,1936-03-05,0,1962,1962,3,5,USA
Jason Thomas,1980-05-08,6,2002,2008,5,8,USA
Jaylin Malik,1994-07-01,0,2019,2019,7,1,USA
Jonathan Gregory,1993-04-27,2,2017,2019,4,27,USA
James Bennett,1924-09-15,3,1954,1957,9,15,USA
Jerry C.,1978-10-25,3,2002,2005,10,25,USA
John Humphrey,1915-07-15,0,1941,1941,7,15,USA
Jody Richard,1956-11-12,9,1981,1990,11,12,USA
Joel Clark,1965-01-30,3,1985,1988,1,30,USA
John Kirk,1963-01-05,3,1987,1990,1,5,USA
Jonathan R.,1992-05-12,1,2018,2019,5,12,USA
Johnathan Lewis,1990-04-26,0,2019,2019,4,26,USA
James Joseph,1861-09-05,7,1884,1891,9,5,USA
Kane Thomas,1975-06-25,7,2000,2007,6,25,USA
Khristopher Adrian,1987-12-21,6,2013,2019,12,21,USA
George Willis,1902-02-12,12,1926,1938,2,12,USA
Johnny Lance,1976-09-01,0,2001,2001,9,1,USA
Alfonzo DeFord,1875-02-04,6,1901,1907,2,4,USA
Mark William,1960-10-19,17,1980,1997,10,19,USA
Mark Anthony,1964-11-25,0,1991,1991,11,25,USA
Michael Lynn,1945-08-04,1,1969,1970,8,4,USA
Michael Dwayne,1959-06-11,9,1980,1989,6,11,USA
Odie Ernest,1955-08-13,0,1980,1980,8,13,USA
Otis Allen,1920-09-24,0,1946,1946,9,24,USA
Roy Thomas,1905-05-31,3,1936,1939,5,31,USA
Rajai Lavae,1980-10-19,13,2006,2019,10,19,USA
Ronald Everette,1941-10-21,7,1962,1969,10,21,USA
Ronald Gene,1955-08-06,10,1978,1988,8,6,USA
William Theron,1993-04-29,2,2017,2019,4,29,USA
Russell Stuart,1969-09-13,7,1994,2001,9,13,USA
Scotty Ray,1970-10-16,1,1995,1996,10,16,USA
Virgil Lawrence,1904-12-20,17,1928,1945,12,20,USA
Steven Michael,1953-12-30,0,1979,1979,12,30,USA
George Earl,1961-12-26,12,1982,1994,12,26,USA
Steven Kennon,1960-08-04,4,1985,1989,8,4,USA
Taylor M.,1989-11-28,2,2017,2019,11,28,USA
Timothy Howard,1970-07-14,3,1994,1997,7,14,USA
Thomas Oscar,1924-07-24,2,1949,1951,7,24,USA
Herman Thomas,1939-03-21,17,1959,1976,3,21,USA
Thomas James,1973-05-21,0,1999,1999,5,21,USA
Trench Neal,1960-09-12,2,1985,1987,9,12,USA
Wade Allen,1985-09-07,10,2009,2019,9,7,USA
Wiley Anderson,1875-08-01,0,1896,1896,8,1,USA
William Henry,1940-04-15,19,1960,1979,4,15,USA
Woodrow Wilson,1913-04-25,0,1938,1938,4,25,USA
Travis Sentell,1979-05-12,4,1999,2003,5,12,USA
William Chester,1958-02-06,6,1983,1989,2,6,USA
Joseph Thomas,1971-09-19,2,2002,2004,9,19,USA
Andre Nolan,1954-07-10,20,1976,1996,7,10,USA
Ralph Fenton,1897-03-09,5,1924,1929,3,9,USA
Rexford Paul,1888-02-10,0,1913,1913,2,10,USA
William J.,1867-07-28,1,1889,1890,7,28,USA
Charles Frederick,1947-08-31,5,1969,1974,8,31,USA
Amos Dewon,1980-09-29,0,2007,2007,9,29,USA
Brian Kelly,1957-01-22,4,1983,1987,1,22,USA
John B.,1847-09-23,NA,NA,NA,9,23,USA
Leon,1916-10-30,NA,NA,NA,10,30,USA
Kenneth Grant,1959-02-25,11,1982,1993,2,25,USA
Henry Clyde,1899-08-25,7,1924,1931,8,25,USA
Grant A.,1987-11-25,3,2016,2019,11,25,USA
Stephen Zachary,1978-06-15,4,2002,2006,6,15,USA
Yonathan,1994-02-28,0,2019,2019,2,28,Venezuela
Lorenzo Burroughs,1858-06-26,1,1883,1884,6,26,USA
Roger I.,1977-06-21,0,2003,2003,6,21,Panama
Charles Albert,1891-10-30,9,1912,1921,10,30,USA
Ellis Ferguson,1923-01-23,7,1947,1954,1,23,USA
Fred Lindsay,1911-09-03,0,1939,1939,9,3,USA
John Wesley,1879-01-21,0,1906,1906,1,21,USA
Patrick E.,1861-11-12,6,1884,1890,11,12,USA
Austin James,1993-10-14,1,2018,2019,10,14,USA
Alfred Lovell,1915-08-24,7,1936,1943,8,24,USA
Jay Hanna,1910-01-16,17,1930,1947,1,16,USA
Charles Wilson,1852-11-06,0,1876,1876,11,6,USA
John Henry,1846-05-06,3,1871,1874,5,6,USA
James Harry,1915-05-12,0,1941,1941,5,12,USA
Paul Dee,1912-08-14,9,1934,1943,8,14,USA
Patrick Michael,1989-05-25,0,2016,2016,5,25,USA
Tommy Douglas,1945-08-30,4,1967,1971,8,30,USA
Wayland Ogden,1902-06-20,3,1924,1927,6,20,USA
Paul Stanford,1905-12-01,0,1927,1927,12,1,USA
Charles Hommer,1877-02-13,0,1903,1903,2,13,USA
Thomas H.,1857-11-17,7,1881,1888,11,17,USA
Alejandro Alberto,1984-04-11,10,2007,2017,4,11,D.R.
Dennis Lee,1953-01-16,0,1977,1977,1,16,USA
John Herman,1894-12-29,14,1916,1930,12,29,USA
Joseph Gaddy,1896-11-29,1,1920,1921,11,29,USA
Adam Joseph,1892-10-07,0,1917,1917,10,7,USA
David Albert,1940-10-16,1,1962,1963,10,16,USA
Yurendell Eithel,1979-09-26,0,2006,2006,9,26,Curacao
Arthur Rue,1894-01-14,5,1922,1927,1,14,USA
Douglas Vernon,1950-08-29,14,1973,1987,8,29,USA
Cody Marshall,1987-01-17,0,2015,2015,1,17,USA
Frank,1857-02-26,3,1879,1882,2,26,USA
George A.,1866-06-01,7,1892,1899,6,1,USA
Earle Harry,1864-09-03,6,1884,1890,9,3,USA
Jaff Kyle,1990-02-23,4,2013,2017,2,23,USA
George Henry,1947-06-16,10,1969,1979,6,16,USA
Dee Martin,1957-06-07,0,1983,1983,6,7,USA
Steven Michael,1965-10-25,9,1990,1999,10,25,USA
Arthur Richard,1895-07-12,0,1916,1916,7,12,USA
Raoul Martial,1914-02-17,0,1935,1935,2,17,USA
Jeffrey Linden,1960-03-04,5,1983,1988,3,4,USA
James Michael,1968-04-04,0,1995,1995,4,4,USA
Samuel,1983-07-02,5,2010,2015,7,2,D.R.
William Joseph,1874-11-16,0,1901,1901,11,16,USA
James J.,1864-12-27,0,1884,1884,12,27,USA
John Thomas,1878-06-25,0,1903,1903,6,25,USA
Robert George,1960-09-29,12,1984,1996,9,29,USA
Charles Henry,1935-06-24,2,1963,1965,6,24,USA
Maurice Leo,1889-10-04,0,1915,1915,10,4,CAN
Dean A.,1993-11-29,0,2018,2018,11,29,USA
Clyde Herbert,1895-02-22,0,1917,1917,2,22,USA
Justin Andrew,1987-10-21,4,2011,2015,10,21,USA
Anthony John,1963-04-24,NA,NA,NA,4,24,USA
Arturo Marcelino,1953-04-26,1,1978,1979,4,26,D.R.
Michael Arthur,1943-04-01,1,1961,1962,4,1,USA
Jacob Anthony,1988-06-19,5,2014,2019,6,19,USA
Arthur Sleight,1879-09-02,1,1905,1906,9,2,USA
Korwin Jay,1976-07-16,2,2000,2002,7,16,USA
Richard Allen,1970-03-21,6,1997,2003,3,21,USA
James Lawrence,1949-06-06,0,1974,1974,6,6,USA
Otto Charles,1877-10-10,7,1902,1909,10,10,Germany
Edward,1876-04-29,1,1902,1903,4,29,USA
William Alexander,1902-04-30,1,1927,1928,4,30,USA
Michael Dan,1915-01-13,0,1940,1940,1,13,USA
Michel Dwain,1970-09-28,9,1997,2006,9,28,USA
David Christopher,1979-12-20,12,2003,2015,12,20,USA
Ivan,1953-01-09,14,1974,1988,1,9,P.R.
Ivan,1987-05-01,5,2011,2016,5,1,P.R.
Jose Luis,1965-01-06,6,1988,1994,1,6,USA
Mark Stephen,1953-09-18,0,1982,1982,9,18,USA
Chase Louis,1993-12-29,2,2017,2019,12,29,USA
Jordan Jay,1979-04-12,0,2007,2007,4,12,USA
Paul Sterling,1993-08-02,2,2017,2019,8,2,USA
William Callahan,1918-12-19,0,1945,1945,12,19,USA
Steven Edward,1983-07-17,5,2011,2016,7,17,USA
Eulogio,1984-03-12,4,2007,2011,3,12,D.R.
Joel,1989-06-09,0,2016,2016,6,9,D.R.
Tomas,1911-09-18,0,1944,1944,9,18,Cuba
Edward James,1867-10-30,15,1888,1903,10,30,USA
Frank George,1882-12-29,10,1905,1915,12,29,USA
James Christopher,1879-06-20,14,1901,1915,6,20,USA
Joseph Nicholas,1875-10-18,2,1907,1909,10,18,USA
Miguel Angel,1938-10-02,9,1960,1969,10,2,Cuba
Thomas James,1872-03-09,3,1894,1897,3,9,USA
Roland Robert,1971-11-11,0,1997,1997,11,11,USA
Arthur Dewey,1897-01-05,5,1924,1929,1,5,USA
William L.,1863-03-05,0,1890,1890,3,5,USA
William Pinkney,1911-11-28,8,1932,1940,11,28,USA
Robert James,1984-09-08,1,2010,2011,9,8,USA
Dane David,1983-02-01,3,2011,2014,2,1,USA
Eury,1990-02-24,1,2013,2014,2,24,D.R.
Francisco,1966-03-03,0,1991,1991,3,3,D.R.
Jesus,1953-08-05,0,1975,1975,8,5,D.R.
Jorge Alberto,1981-04-05,14,2004,2018,4,5,Mexico
Rubby Carlos,1989-03-04,6,2011,2017,3,4,D.R.
Tomas Agramonte,1978-01-28,6,2000,2006,1,28,D.R.
Jose Hairam,1985-10-17,0,2013,2013,10,17,P.R.
Manuel,1982-02-16,5,2005,2010,2,16,USA
Jose,1960-12-20,12,1983,1995,12,20,D.R.
Jorge Luis,1987-08-15,1,2013,2014,8,15,D.R.
Jose Eugenio,1992-08-07,3,2016,2019,8,7,P.R.
Luis Antonio,1958-08-19,8,1981,1989,8,19,P.R.
Alexander,1971-01-11,0,1996,1996,1,11,Venezuela
Carlos Juan,1972-06-25,16,1993,2009,6,25,P.R.
Jesus Andres,1984-04-19,0,2008,2008,4,19,Venezuela
Luis Felipe,1954-02-02,0,1977,1977,2,2,P.R.
Randall Enrique,1990-02-09,7,2011,2018,2,9,Panama
Wilson,1972-07-15,8,1996,2004,7,15,D.R.
Robert George,1933-04-07,13,1952,1965,4,7,USA
Lee William,1892-11-05,0,1912,1912,11,5,USA
Juan Francisco,1928-02-27,0,1955,1955,2,27,Cuba
Edward Alberts,1906-04-17,4,1929,1933,4,17,USA
Jason Christopher,1976-12-17,0,1999,1999,12,17,USA
David Michael,1973-10-31,12,1997,2009,10,31,USA
William George,1886-06-11,5,1912,1917,6,11,USA
Albert Charles,1911-05-20,0,1933,1933,5,20,USA
Nicholas John,1992-07-12,2,2017,2019,7,12,USA
Ivan Martin,1929-11-11,11,1952,1963,11,11,USA
Abel,1992-11-21,1,2015,2016,11,21,D.R.
Enyel,1995-12-25,1,2018,2019,12,25,D.R.
Fautino,1986-02-15,1,2011,2012,2,15,D.R.
Luis Manuel,1966-12-29,3,1988,1991,12,29,D.R.
Luis,1977-11-01,0,2002,2002,11,1,D.R.
Ramon,1949-01-19,0,1974,1974,1,19,D.R.
Valerio Lorenzo,1972-10-06,10,1998,2008,10,6,D.R.
Miguel Eduardo,1992-10-14,0,2019,2019,10,14,D.R.
Enerio,1985-10-16,2,2010,2012,10,16,D.R.
Garton Orville,1913-11-26,0,1943,1943,11,26,USA
James Henry,1925-11-13,12,1948,1960,11,13,USA
Miguel,1972-06-22,1,1999,2000,6,22,Mexico
Richard Anthony,1964-10-07,9,1990,1999,10,7,USA
Joseph Paul,1928-12-09,10,1951,1961,12,9,USA
Albert Wentworth,1884-09-08,7,1912,1919,9,8,USA
William Lester,1925-08-26,3,1948,1951,8,26,USA
Christopher Neil,1980-09-28,1,2005,2006,9,28,USA
Frederick,1866-11-01,0,1890,1890,11,1,CAN
Joseph Franklin,1910-06-10,12,1932,1944,6,10,USA
Samuel Vincent,1985-10-23,2,2010,2012,10,23,USA
John Stephen,1936-01-08,5,1957,1962,1,8,USA
Lawrence Calvin,1953-06-04,3,1974,1977,6,4,USA
Travis Timothy,1994-09-30,0,2019,2019,9,30,USA
Donald Lee,1935-06-25,11,1956,1967,6,25,USA
Stephen,1935-01-27,1,1959,1960,1,27,USA
Harry,1867-11-12,0,1892,1892,11,12,USA
Charles Raymond,1884-02-02,10,1909,1919,2,2,USA
Donald John,1952-07-05,1,1974,1975,7,5,USA
Eugene Napoleon,1873-03-10,10,1894,1904,3,10,USA
Leon,1874-09-23,0,1903,1903,9,23,USA
Benyew Harrison,1889-04-02,1,1910,1911,4,2,USA
Cornelius Francis,1922-09-16,0,1951,1951,9,16,USA
Mark Steven,1957-12-17,0,1982,1982,12,17,USA
John Rikard,1949-09-13,23,1969,1992,9,13,USA
Ryan Scott,1977-05-03,15,1998,2013,5,3,CAN
Matthew Gerrit,1987-08-10,5,2013,2018,8,10,USA
William Francis,1946-03-31,4,1967,1971,3,31,USA
Travis Norton,1985-08-05,0,2008,2008,8,5,USA
Brian John,1956-02-12,0,1982,1982,2,12,USA
Kyle Dean,1977-07-27,0,2004,2004,7,27,USA
Thomas Francis,1899-05-12,0,1923,1923,5,12,USA
Donald Ray,1942-03-03,1,1965,1966,3,3,USA
Otto George,1912-12-28,1,1942,1943,12,28,USA
Ryan David,1987-01-10,0,2014,2014,1,10,USA
Jeremiah Dennis,1859-03-16,13,1881,1894,3,16,USA
John Allen,1952-11-08,12,1974,1986,11,8,USA
Christopher Anthony,1980-07-15,10,2005,2015,7,15,USA
Andrew,1965-11-16,4,1989,1993,11,16,USA
Russell Earl,1951-11-25,11,1973,1984,11,25,USA
Elliott Estill,1887-12-08,3,1909,1912,12,8,USA
Samuel Joseph,1922-04-26,8,1947,1955,4,26,USA
Roger,1871-10-05,4,1897,1901,10,5,USA
Michael Anthony,1858-09-11,0,1884,1884,9,11,USA
Joseph Bernard,1973-09-04,0,2003,2003,9,4,USA
Jorge,1978-11-10,2,2003,2005,11,10,D.R.
Jose Alberto,1988-03-04,0,2015,2015,3,4,D.R.
Julio Cesar,1982-12-31,0,2007,2007,12,31,D.R.
Sean Michael,1973-11-07,3,1999,2002,11,7,USA
Anthony Andrew,1912-09-20,0,1943,1943,9,20,USA
George Henry,1857-07-15,2,1881,1883,7,15,USA
Eugene A.,1860-02-03,0,1885,1885,2,3,USA
Matthew Phillip,1990-07-04,1,2016,2017,7,4,USA
Robert Eugene,1957-01-05,9,1980,1989,1,5,USA
Mark Thomas,1975-02-26,15,1998,2013,2,26,USA
Claud Lester,1886-06-11,4,1910,1914,6,11,USA
Charles James,1939-11-29,1,1956,1957,11,29,USA
James Michael,1943-09-19,0,1970,1970,9,19,USA
Samuel Paul,1906-10-17,14,1931,1945,10,17,USA
Alva Russell,1916-10-07,5,1944,1949,10,7,USA
Joseph,1959-07-27,5,1980,1985,7,27,USA
Matthew Thomas,1980-09-11,1,2007,2008,9,11,USA
Eugene Abraham,1907-06-13,16,1930,1946,6,13,USA
Daniel William,1986-10-19,9,2010,2019,10,19,USA
Anthony James,1990-04-18,5,2014,2019,4,18,USA
James Joseph,1960-06-23,11,1984,1995,6,23,USA
Delino Lamont,1969-01-15,12,1990,2002,1,15,USA
Delino Diaab,1992-08-16,4,2015,2019,8,16,USA
James Brooklyn,1909-11-30,7,1932,1939,11,30,USA
John Reed,1967-09-30,2,1993,1995,9,30,USA
Paul Raymond,1893-08-24,0,1916,1916,8,24,USA
Ian M.,1985-09-20,10,2009,2019,9,20,USA
Odrisamer,1987-04-04,5,2014,2019,4,4,Cuba
Frank Rolland,1883-03-29,3,1907,1910,3,29,USA
Elmer,1971-01-13,14,1996,2010,1,13,Mexico
Orestes,1962-05-08,7,1987,1994,5,8,Cuba
Robert Wayne,1954-09-20,0,1980,1980,9,20,USA
George Francis,1906-11-11,1,1930,1931,11,11,USA
John Franklin,1970-03-04,1,1994,1995,3,4,USA
Thomas Anthony,1947-11-17,3,1973,1976,11,17,USA
Robert Sterling,1919-02-15,4,1942,1946,2,15,USA
Ross Emery,1986-03-06,12,2007,2019,3,6,USA
Melvin Elliott,1915-07-26,0,1946,1946,7,26,USA
Cesar Salvatore,1969-09-22,1,1995,1996,9,22,D.R.
Charles,1910-01-01,2,1932,1934,1,1,USA
Christopher Michael,1990-11-13,3,2016,2019,11,13,USA
Michael,1963-04-10,11,1987,1998,4,10,USA
Rafael Calcano,1996-10-24,2,2017,2019,10,24,D.R.
Paul Adrian,1951-12-02,7,1973,1980,12,2,USA
Harold John,1893-04-11,0,1920,1920,4,11,USA
Frank Robert,1859-08-29,3,1883,1886,8,29,USA
Joseph Neal,1983-09-19,6,2005,2011,9,19,USA
William Patrick,1892-05-09,7,1918,1925,5,9,USA
Bernard John,1901-04-19,3,1924,1927,4,19,USA
Arthur McArthur,1879-10-16,9,1904,1913,10,16,USA
James Alexander,1849-06-06,4,1873,1877,6,6,USA
James H.,1866-04-16,3,1886,1889,4,16,USA
James Raymond,1922-08-25,0,1944,1944,8,25,USA
Rex Eugene,1888-01-04,0,1913,1913,1,4,USA
Albert E.,1891-08-19,9,1918,1927,8,19,USA
Doug Rinehart,1977-12-14,0,2004,2004,12,14,USA
Joshua M.,1887-11-13,6,1908,1914,11,13,USA
Walter Joseph,1885-03-14,0,1909,1909,3,14,USA
Cole William,1985-02-12,1,2012,2013,2,12,USA
Charles H.,1867-09-22,0,1890,1890,9,22,USA
Mark Alan,1965-01-03,6,1990,1996,1,3,USA
Jeffrey Allen,1965-04-13,0,1987,1987,4,13,USA
Blake Robert,1985-08-20,5,2008,2013,8,20,USA
Matthew Brian,1977-09-04,2,2000,2002,9,4,USA
Charles Dana,1876-06-15,7,1896,1903,6,15,USA
Scott Michael,1986-07-30,5,2011,2016,7,30,CAN
Thomas Nicklaus,1983-04-06,0,2010,2010,4,6,USA
Alexis,1968-10-05,7,1992,1999,10,5,USA
Aledmys,1990-08-01,3,2016,2019,8,1,Cuba
Argenis Jose,1987-02-12,0,2010,2010,2,12,Venezuela
Baudilio Jose,1953-03-23,12,1977,1989,3,23,Venezuela
Carlos Antonio,1958-01-07,4,1982,1986,1,7,USA
Carlos Francisco,1964-12-24,0,1990,1990,12,24,USA
Dayan Enrique,1989-02-10,1,2016,2017,2,10,Colombia
Edgar,1964-02-08,4,1986,1990,2,8,P.R.
Eddy Javier,1971-09-29,0,1997,1997,9,29,Venezuela
Edwin,1975-01-15,1,1998,1999,1,15,P.R.
Edwin Orlando,1994-03-22,3,2016,2019,3,22,P.R.
Einar Antonio,1972-12-28,10,1996,2006,12,28,Panama
Elias David,1990-11-17,4,2015,2019,11,17,Venezuela
Felix Antonio,1980-07-27,0,2004,2004,7,27,D.R.
Isan Xavier,1996-05-27,0,2019,2019,5,27,P.R.
Jairo Jose,1991-05-27,5,2014,2019,5,27,Venezuela
Joselo,1980-04-13,2,2006,2008,4,13,D.R.
Jonathan,1985-04-10,2,2013,2015,4,10,USA
Juan Carlos,1974-02-19,0,2002,2002,2,19,Cuba
Juan Habisail,1988-12-12,0,2012,2012,12,12,D.R.
Jose Rafael,1984-02-27,3,2014,2017,2,27,D.R.
Mario Rafael,1962-01-10,8,1987,1995,1,10,P.R.
Matthew Edward,1978-03-03,10,2003,2013,3,3,USA
Michael Anthony,1960-04-15,5,1983,1988,4,15,USA
Miguel Angel,1994-11-28,2,2017,2019,11,28,D.R.
Robinzon,1983-09-19,1,2008,2009,9,19,D.R.
Victor Israel,1981-12-10,3,2004,2007,12,10,D.R.
Yandy,1991-08-08,2,2017,2019,8,8,Cuba
Yennsy Manuel,1996-11-15,0,2019,2019,11,15,D.R.
Robert Keith,1964-01-24,7,1988,1995,1,24,USA
Pedro,1892-11-18,1,1924,1925,11,18,Cuba
Alexander Ross,1990-05-26,4,2015,2019,5,26,USA
William Malcolm,1907-06-06,18,1928,1946,6,6,USA
Lewis Pessano,1858-10-11,7,1878,1885,10,11,USA
Christopher Charles,1982-04-10,6,2008,2014,4,10,USA
McKenzie Corey,1989-05-22,6,2013,2019,5,22,USA
George Clark,1892-12-01,0,1917,1917,12,1,USA
George Willard,1915-07-10,12,1935,1947,7,10,USA
Leo Louis,1896-10-31,2,1923,1925,10,31,USA
Paul Franklin,1943-10-02,2,1964,1966,10,2,USA
Robert Allen,1974-10-29,16,2001,2017,10,29,USA
George Emerson,1914-11-12,5,1936,1941,11,12,USA
Brandon Lee,1984-11-03,1,2011,2012,11,3,USA
Jason Royce,1973-03-30,4,1996,2000,3,30,CAN
James Edward,1938-04-20,3,1963,1966,4,20,USA
John Oscar,1910-01-24,9,1936,1945,1,24,USA
Lance Michael,1969-10-19,0,1990,1990,10,19,USA
Murry Monroe,1916-08-21,20,1939,1959,8,21,USA
O'Koyea Rishaard,1990-02-09,0,2017,2017,2,9,USA
Walter Raleigh,1878-12-03,5,1910,1915,12,3,USA
Henry Harrison,1854-06-27,NA,NA,NA,6,27,USA
Robert Daniel,1949-02-16,5,1969,1974,2,16,USA
Ernest Guy,1877-10-02,6,1903,1909,10,2,USA
George Krause,1918-02-25,1,1942,1943,2,25,USA
Phillip Stewart,1994-07-16,0,2019,2019,7,16,USA
Jacob Tanner,1987-01-21,7,2012,2019,1,21,USA
Charles Edward Allen,1923-02-05,9,1947,1956,2,5,USA
Lawrence Edward,1946-09-22,13,1964,1977,9,22,USA
William John,1910-03-29,15,1933,1948,3,29,USA
Derek Richard,1989-07-18,6,2013,2019,7,18,USA
Richard Allen,1941-09-18,7,1966,1973,9,18,USA
Lloyd Arthur,1912-02-12,3,1940,1943,2,12,USA
Leroy Louis,1931-01-09,0,1954,1954,1,9,USA
Clarence Joseph,1922-12-21,1,1948,1949,12,21,USA
Mark Andrew,1976-08-23,3,2008,2011,8,23,USA
Michael William,1969-05-28,12,1996,2008,5,28,USA
Wilmer Francisco,1992-04-02,4,2015,2019,4,2,D.R.
Benjamin Howard,1979-06-13,0,2002,2002,6,13,USA
Reese Wilson,1915-09-22,0,1934,1934,9,22,USA
Stephen E.,1859-04-16,0,1880,1880,4,16,USA
Martin,1905-05-25,NA,NA,NA,5,25,Cuba
Jack Edward,1943-03-03,1,1969,1970,3,3,USA
David Donald,1937-01-08,6,1959,1965,1,8,USA
Gordon Lee,1964-05-20,1,1988,1989,5,20,USA
Robert Lee,1873-06-12,0,1900,1900,6,12,USA
Stephen Bradley,1951-02-08,7,1975,1982,2,8,USA
Timothy Charles,1983-07-19,4,2008,2012,7,19,USA
William Martin,1893-10-13,4,1917,1921,10,13,USA
Robert Bernard,1918-09-17,5,1946,1951,9,17,USA
Harley Hugh,1894-10-30,0,1914,1914,10,30,USA
William Howard,1945-05-25,3,1967,1970,5,25,USA
Joseph William,1975-08-02,4,2005,2009,8,2,USA
Patrick Henry,1853-01-02,0,1875,1875,1,2,USA
Frank Edward,1873-10-17,5,1899,1904,10,17,USA
Stephen Edward,1943-03-20,1,1963,1964,3,20,USA
Miguel Angel,1954-11-01,11,1974,1985,11,1,D.R.
Dominic Paul,1917-02-12,13,1940,1953,2,12,USA
Joseph Paul,1914-11-25,15,1936,1951,11,25,USA
Vincent Paul,1912-09-06,9,1937,1946,9,6,USA
Frank Lawrence,1965-02-16,0,1988,1988,2,16,USA
Michael Wayne,1954-10-16,2,1977,1979,10,16,USA
Leonard Edward,1979-09-19,5,2004,2009,9,19,USA
Kerry Michael,1952-07-01,3,1975,1978,7,1,USA
Vance George,1915-05-29,1,1945,1946,5,29,USA
Craig Allen,1974-03-12,5,2000,2005,3,12,USA
Nicholas Carl,1993-07-27,0,2019,2019,7,27,USA
Brian Adam,1983-11-10,0,2011,2011,11,10,USA
William Henry,1876-04-05,11,1898,1909,4,5,USA
Ronald Michael,1946-07-15,1,1973,1974,7,15,USA
Robert Louis Paul,1927-09-01,0,1951,1951,9,1,USA
Frank Michael,1956-10-22,12,1981,1993,10,22,USA
Gerard Peter,1968-05-24,7,1993,2000,5,24,USA
Andrew Lee,1986-01-24,2,2011,2013,1,24,USA
Gary Thomas,1967-11-19,11,1989,2000,11,19,USA
George Charles,1879-03-15,0,1905,1905,3,15,USA
Glenelg Edward,1970-11-05,2,1995,1997,11,5,USA
Alec John,1948-12-23,0,1969,1969,12,23,USA
Benito James,1962-01-23,8,1984,1992,1,23,USA
George Adam,1896-04-15,0,1918,1918,4,15,USA
Arthur John,1929-04-03,8,1954,1962,4,3,USA
John Douglas,1928-01-10,5,1952,1957,1,10,USA
Edward George,1894-01-16,0,1916,1916,1,16,USA
Brandon Allen,1992-01-29,1,2018,2019,1,29,USA
Kenneth John,1960-10-17,3,1984,1987,10,17,USA
Leo Moses,1894-09-04,4,1925,1929,9,4,USA
John Craig,1924-11-05,3,1953,1956,11,5,USA
Steven Ross,1969-08-03,1,1993,1994,8,3,USA
Thomas Earl,1955-04-23,6,1977,1983,4,23,USA
Brent P.,1983-03-03,0,2009,2009,3,3,USA
William Leopold,1891-01-28,17,1912,1929,1,28,USA
Walter Rudolph,1887-03-12,1,1909,1910,3,12,USA
Daniel John,1934-12-06,2,1959,1961,12,6,USA
John Kenneth,1901-11-15,0,1924,1924,11,15,USA
Gregory Stuart,1978-07-02,10,2004,2014,7,2,USA
John Gordon,1875-06-03,4,1901,1905,6,3,USA
Raymond Joseph,1906-07-28,0,1929,1929,7,28,USA
Andrew Joseph,1917-11-20,10,1939,1949,11,20,USA
Randy,1995-01-17,0,2019,2019,1,17,USA
Charles Thomas,1944-01-10,9,1966,1975,1,10,USA
Joseph Gordon,1917-01-20,15,1939,1954,1,20,USA
Patrick Edward,1942-02-12,10,1967,1977,2,12,USA
Lawrence Eugene,1923-12-13,12,1947,1959,12,13,USA
George Woodrow,1917-05-05,2,1945,1947,5,5,USA
Ona Melvin,1886-10-14,0,1912,1912,10,14,USA
Robert Wayne,1973-03-14,0,1998,1998,3,14,USA
Thomas Marion,1958-08-15,0,1986,1986,8,15,USA
John Lewis,1889-04-27,1,1912,1913,4,27,USA
Samuel Edward,1899-12-19,1,1921,1922,12,19,USA
Patrick Neal,1959-10-11,2,1986,1988,10,11,USA
Alfred George,1864-04-18,0,1890,1890,4,18,USA
Robert Pershing,1918-04-07,14,1937,1951,4,7,USA
Edward Richard,1873-11-24,8,1895,1903,11,24,USA
John Michael,1951-08-22,1,1974,1975,8,22,USA
John Harold,1967-06-11,4,1992,1996,6,11,USA
Christopher Scott,1978-02-13,4,2004,2008,2,13,USA
Leon Mark,1881-07-09,0,1914,1914,7,9,USA
Patrick Henry,1872-12-03,11,1895,1906,12,3,USA
Albert James,1882-12-23,13,1909,1922,12,23,USA
John,1867-09-12,5,1890,1895,9,12,USA
Joseph,1873-02-24,5,1896,1901,2,24,USA
Thomas J.,1855-01-10,9,1879,1888,1,10,USA
Lester Carrington,1855-07-08,0,1875,1875,7,8,USA
Rafael Jose,1988-01-10,2,2011,2013,1,10,D.R.
Frank Joseph,1907-10-05,13,1930,1943,10,5,USA
Arthur James,1913-05-07,3,1935,1938,5,7,USA
Freddy,1983-01-09,1,2008,2009,1,9,D.R.
Andrew John,1975-10-30,1,2004,2005,10,30,USA
Christopher Omar,1986-11-22,1,2014,2015,11,22,USA
Jose Alfredo,1990-08-07,3,2013,2016,8,7,D.R.
Juan Ramon,1980-05-18,2,2003,2005,5,18,D.R.
Matthew Scott,1989-08-28,5,2011,2016,8,28,USA
Seranthony Ambioris,1994-11-25,1,2018,2019,11,25,D.R.
John Stephen Michael,1920-06-23,1,1943,1944,6,23,USA
James Augustus,1862-01-08,5,1886,1891,1,8,USA
John Augustus,1879-07-13,9,1900,1909,7,13,USA
John Frederick,1894-04-19,0,1923,1923,4,19,USA
Patrick William,1884-11-03,2,1908,1910,11,3,USA
Francis L.,1873-01-23,13,1893,1906,1,23,USA
Charles Michael,1877-06-29,0,1904,1904,6,29,USA
Timothy Cornelius,1870-06-08,11,1891,1902,6,8,USA
Richard Atley,1910-08-19,7,1938,1945,8,19,USA
Edward Alexander,1883-06-22,0,1912,1912,6,22,USA
Jason Thomas,1984-09-04,2,2010,2012,9,4,USA
John David,1943-05-05,8,1966,1974,5,5,USA
Joshua Adam,1985-12-08,9,2010,2019,12,8,USA
Leonard Peter,1903-09-12,0,1929,1929,9,12,USA
Michael Joseph,1878-05-30,15,1899,1914,5,30,USA
Sylvester Urban,1914-01-21,7,1944,1951,1,21,USA
Brendan Kevin,1971-07-04,8,2002,2010,7,4,USA
Chris Barton,1966-04-21,11,1991,2002,4,21,USA
Edward,1879-07-29,1,1911,1912,7,29,USA
Edward Vincent,1932-12-10,0,1959,1959,12,10,USA
Franklin Marion,1869-10-07,1,1893,1894,10,7,USA
James B.,1865-07-19,14,1884,1898,7,19,USA
James Henry,1867-01-06,0,1884,1884,1,6,USA
John Louis,1850-11-15,1,1873,1874,11,15,USA
James Thomas,1937-10-31,1,1961,1962,10,31,USA
Alexander F.,1863-12-09,0,1891,1891,12,9,USA
Peter Joseph,1900-11-05,11,1921,1932,11,5,USA
Thomas James,1952-11-15,1,1979,1980,11,15,USA
Lino,1922-09-23,1,1955,1956,9,23,Cuba
William Edward,1876-10-13,20,1898,1918,10,13,USA
Willard Earl,1916-07-06,1,1942,1943,7,6,USA
Richard Edward,1927-12-07,15,1950,1965,12,7,USA
Frederick Maurice,1864-07-04,0,1895,1895,7,4,USA
Jeremiah Francis,1876-09-03,0,1906,1906,9,3,USA
Michael Berchman,1881-10-18,4,1904,1908,10,18,USA
Patrick Joseph,1865-03-16,17,1890,1907,3,16,Ireland
Thomas Joseph,1873-01-01,0,1901,1901,1,1,USA
Charles Sebastian,1879-06-12,14,1902,1916,6,12,USA
Michael Joseph,1880-05-07,13,1905,1918,5,7,USA
Sean Robert,1986-09-26,7,2012,2019,9,26,USA
Henry E.,1867-01-30,0,1892,1892,1,30,USA
John Robert,1963-07-14,9,1985,1994,7,14,USA
William James,1898-06-14,0,1922,1922,6,14,USA
William Donald,1958-05-28,11,1982,1993,5,28,USA
Thomas J.,1880-12-02,2,1904,1906,12,2,USA
Michael Cornelius,1853-10-02,13,1877,1890,10,2,USA
Harry,1921-07-13,9,1947,1956,7,13,USA
Charles William,1898-04-23,0,1923,1923,4,23,USA
Charles Dwight,1900-10-03,0,1928,1928,10,3,USA
Daniel Casey,1984-07-20,0,2015,2015,7,20,USA
Augustus,1876-08-18,7,1902,1909,8,18,USA
Charles Albert,1862-02-02,0,1882,1882,2,2,USA
Brian Richard,1961-04-09,9,1987,1996,4,9,USA
Calvin Leavelle,1913-06-10,7,1940,1947,6,10,USA
Jeremiah Joseph,1885-12-04,0,1911,1911,12,4,USA
James Edward,1955-08-02,5,1980,1985,8,2,USA
Melvin A.,1982-01-15,0,2006,2006,1,15,Venezuela
John Henry,1852-12-20,10,1872,1882,12,20,USA
John Henry,1880-07-27,5,1903,1908,7,27,USA
David Eric,1970-10-08,3,1996,1999,10,8,USA
Octavio Eduardo,1973-11-25,14,1999,2013,11,25,D.R.
Richard Elliott,1959-01-10,11,1979,1990,1,10,USA
Henry John,1931-11-11,4,1957,1961,11,11,USA
Gary Richard,1942-08-07,3,1961,1964,8,7,USA
Elmer L.,1867-12-17,0,1890,1890,12,17,USA
Felix Antonio,1987-10-23,5,2010,2015,10,23,Venezuela
Charles William,1862-02-07,0,1884,1884,2,7,USA
James Elliott,1968-03-08,4,1995,1999,3,8,USA
Patrick Henry,1876-10-27,9,1902,1911,10,27,USA
Thomas James,1881-05-30,0,1904,1904,5,30,USA
Astyanax Saunders,1897-09-19,4,1921,1925,9,19,USA
John Franklin,1917-09-14,0,1945,1945,9,14,USA
William Bingham,1872-05-10,8,1896,1904,5,10,USA
Lawrence Howard,1890-06-05,0,1915,1915,6,5,USA
Phillip Brooks,1890-06-17,10,1912,1922,6,17,USA
Sean Reed,1979-04-28,4,2001,2005,4,28,USA
Charles William,1935-02-17,0,1957,1957,2,17,USA
Ryan Matthew,1981-04-03,9,2005,2014,4,3,USA
Taylor Lee,1901-04-22,10,1923,1933,4,22,USA
Dennis Anthony,1981-08-31,0,2007,2007,8,31,USA
Clarence G.,1854-10-02,0,1884,1884,10,2,USA
John Leo,1891-01-03,0,1912,1912,1,3,USA
James Joseph,1889-02-16,0,1910,1910,2,16,USA
Raymond Bernard,1897-12-20,7,1919,1926,12,20,USA
Thomas Jefferson,1869-04-20,10,1891,1901,4,20,USA
Kyle Alexander,1993-02-03,0,2019,2019,2,3,USA
Kenneth Allen,1961-01-19,0,1987,1987,1,19,USA
Joseph E.,1865-07-15,0,1889,1889,7,15,USA
David Barclay,1942-08-23,2,1964,1966,8,23,USA
Henry James Peter,1876-07-15,4,1897,1901,7,15,USA
Alexander Cummings,1889-02-06,0,1909,1909,2,6,USA
Thomas Edward,1884-01-01,6,1909,1915,1,1,USA
Alphonso Erwin,1941-06-28,16,1961,1977,6,28,USA
Brian Jay,1950-10-09,19,1973,1992,10,9,USA
David Ralph,1952-06-21,0,1972,1972,6,21,USA
Darin Burton,1984-12-26,2,2012,2014,12,26,USA
Kelly Robert,1960-10-25,7,1986,1993,10,25,USA
Russell Matt,1984-03-19,3,2009,2012,3,19,USA
Jerome Willis,1883-08-23,5,1907,1912,8,23,USA
Scott Jeremy,1976-03-17,14,2000,2014,3,17,USA
Thomas Joseph,1866-08-12,2,1890,1892,8,12,Ireland
Brian Reed,1954-01-26,3,1978,1981,1,26,USA
William Carl,1912-07-30,5,1935,1940,7,30,USA
Howard James,1917-01-24,0,1943,1943,1,24,USA
Robert Dennis,1944-01-17,7,1970,1977,1,17,USA
John Joseph,1869-10-25,16,1889,1905,10,25,Ireland
Jesse Herbert,1898-04-14,6,1925,1931,4,14,USA
Jeffrey Donald,1956-10-02,0,1983,1983,10,2,USA
James Francis,1886-12-21,1,1910,1911,12,21,USA
Jacob Dixon,1855-11-26,0,1872,1872,11,26,USA
Lawrence Joseph,1886-07-31,13,1907,1920,7,31,USA
Paul Sinnott,1939-10-02,3,1969,1972,10,2,USA
Judd Bruce,1881-09-15,4,1906,1910,9,15,USA
Michael Cory,1981-08-13,0,2007,2007,8,13,USA
James Brian,1987-05-15,7,2012,2019,5,15,USA
William Joseph,1928-08-31,2,1947,1949,8,31,USA
William Henry,1965-09-21,0,1992,1992,9,21,USA
Hunter William,1991-08-22,3,2016,2019,8,22,USA
Thomas Dean,1961-09-05,0,1986,1986,9,5,USA
Douglas Dean,1962-07-25,12,1986,1998,7,25,USA
Kyle Jordan,1987-12-08,6,2010,2016,12,8,USA
Myron Walter,1935-07-21,16,1956,1972,7,21,Poland
Richard Anthony,1945-06-25,12,1969,1981,6,25,USA
Brian Stacy,1966-11-07,3,1991,1994,11,7,USA
Delos Daniel,1886-12-03,4,1911,1915,12,3,USA
Larry Francis,1921-05-04,3,1945,1948,5,4,USA
Logan Gaffney,1899-12-26,2,1922,1924,12,26,USA
Lyman Daniel,1852-02-09,0,1884,1884,2,9,USA
Oliver Gardner,1987-01-13,4,2015,2019,1,13,USA
Samuel Harrison,1934-10-07,2,1960,1962,10,7,USA
Solomon Louis,1930-10-23,3,1956,1959,10,23,USA
Thomas Kendall,1912-08-07,2,1939,1941,8,7,USA
Kelly Daniel,1975-04-16,5,1999,2004,4,16,USA
Michael Anthony,1966-09-14,0,1993,1993,9,14,USA
Jacob F.,1864-01-06,0,1892,1892,1,6,USA
David Francis,1956-02-14,7,1982,1989,2,14,USA
William Richard,1904-07-26,0,1931,1931,7,26,USA
Thomas Kent,1963-06-17,0,1991,1991,6,17,USA
Darren James,1972-05-03,10,1994,2004,5,3,USA
Clemens Johann,1916-01-24,4,1944,1948,1,24,USA
William Clayton,1921-05-23,2,1944,1946,5,23,USA
Ryan Thomas,1976-04-05,5,2001,2006,4,5,USA
Robert Nicholson,1878-10-04,0,1902,1902,10,4,USA
Charles Walter,1894-09-20,8,1925,1933,9,20,USA
Kirk Richard,1969-04-08,0,1991,1991,4,8,USA
Leo August,1889-07-23,4,1914,1918,7,23,USA
Robert Alan,1954-02-02,5,1975,1980,2,2,USA
Cameron Steward,1964-02-12,0,1988,1988,2,12,USA
David Jonathan,1975-11-20,13,1998,2011,11,20,USA
Frank John,1916-05-25,1,1944,1945,5,25,USA
Karl August,1920-02-22,8,1946,1954,2,22,USA
Stephen Oris,1983-03-16,11,2006,2017,3,16,USA
Timothy Andrew,1978-08-31,4,2000,2004,8,31,USA
Steven William,1969-11-19,1,1993,1994,11,19,USA
Barney,1865-02-23,NA,NA,NA,2,23,Germany
Daniel,1951-07-29,14,1973,1987,7,29,USA
Lewis L.,1877-05-09,3,1902,1905,5,9,USA
John F.,1855-11-19,4,1880,1884,11,19,USA
Dennis F.,1862-10-10,0,1885,1885,10,10,USA
James Bernard,1944-05-14,2,1970,1972,5,14,USA
Michael Columbus,1892-10-19,0,1916,1916,10,19,USA
John Leo,1895-01-11,0,1917,1917,1,11,USA
Travis Corey,1971-08-01,5,2002,2007,8,1,USA
Michael F.,1864-12-19,0,1885,1885,12,19,USA
Thomas F.,1887-08-26,0,1913,1913,8,26,USA
Walter,1923-01-30,12,1949,1961,1,30,USA
Richard Fred,1936-07-01,6,1957,1963,7,1,USA
Louis Frank,1888-12-03,3,1909,1912,12,3,USA
Carl A.,1881-09-04,1,1906,1907,9,4,USA
Timothy Darnell,1964-12-24,3,1987,1990,12,24,USA
Keith Alan,1954-10-21,3,1978,1981,10,21,USA
Brandon S.,1992-08-21,4,2015,2019,8,21,USA
Donald Scott,1936-07-23,13,1956,1969,7,23,USA
Walter John,1918-02-12,8,1944,1952,2,12,USA
Brian Andrew,1967-04-18,1,1989,1990,4,18,USA
Jason Bradford,1979-03-26,1,2004,2005,3,26,USA
Mauricio Andre,1994-07-19,0,2019,2019,7,19,Honduras
Eric Ladell,1976-05-15,4,2002,2006,5,15,USA
Jean Joseph Octave,1888-09-15,11,1908,1919,9,15,USA
Robert Thomas,1965-05-24,14,1987,2001,5,24,CAN
Justin Craig,1977-11-19,9,2001,2010,11,19,USA
Brandon J.,1976-01-23,7,2001,2008,1,23,USA
James Raymond,1939-05-24,3,1963,1966,5,24,USA
Lucas Christopher,1986-02-03,9,2010,2019,2,3,USA
Elzie Clise,1903-08-08,4,1929,1933,8,8,USA
John Joseph,1916-05-27,0,1941,1941,5,27,USA
Brian Matthew,1983-02-22,9,2009,2018,2,22,USA
Hal Joseph,1954-09-22,3,1977,1980,9,22,USA
James Francis,1935-11-25,4,1961,1965,11,25,USA
Charles Edward,1866-01-27,4,1889,1893,1,27,USA
Tyler Blinn,1990-12-27,4,2015,2019,12,27,USA
John Brown,1945-10-04,0,1967,1967,10,4,USA
Cecil Elba,1896-11-20,0,1922,1922,11,20,USA
Matthew Clark,1974-10-06,0,2002,2002,10,6,USA
Patrick Henry,1875-05-06,0,1906,1906,5,6,USA
Bernard Allen,1893-08-18,0,1913,1913,8,18,USA
Christopher Ellis,1980-04-20,4,2005,2009,4,20,USA
Daniel Richard,1988-12-21,8,2011,2019,12,21,USA
Frank Thomas,1946-10-14,9,1970,1979,10,14,USA
Hugh,1866-11-26,18,1888,1906,11,26,USA
Matthew Michael,1991-01-15,5,2014,2019,1,15,USA
Matthew Edward,1989-02-06,1,2015,2016,2,6,USA
Daniel Phillip,1907-02-22,1,1928,1929,2,22,USA
Joseph Anthony,1897-05-12,14,1917,1931,5,12,USA
Augustin Joseph,1907-03-24,4,1930,1934,3,24,CAN
Daniel Edward,1864-10-28,8,1886,1894,10,28,USA
Oscar Joseph,1887-10-25,7,1913,1920,10,25,USA
James Elmer,1885-06-01,0,1911,1911,6,1,USA
Steven Michael,1993-11-04,1,2018,2019,11,4,USA
Robert Lee,1995-07-03,0,2019,2019,7,3,USA
William James,1874-03-16,9,1898,1907,3,16,USA
Elijah David,1984-06-26,2,2007,2009,6,26,USA
Noble Jan,1945-08-16,3,1969,1972,8,16,USA
Thomas Earl,1942-08-31,5,1967,1972,8,31,USA
Zachary Thomas,1983-04-19,14,2005,2019,4,19,USA
Robert John,1935-01-09,8,1959,1967,1,9,USA
Ryan Christopher,1989-10-02,4,2015,2019,10,2,USA
Phillip Anthony,1981-07-12,4,2007,2011,7,12,USA
George Henry,1895-11-13,4,1915,1919,11,13,USA
Daniel Lynn,1953-08-20,1,1977,1978,8,20,USA
Nicholas,1902-01-02,0,1923,1923,1,2,USA
Matthew Marshall,1968-10-15,0,1995,1995,10,15,USA
Thomas Jerome,1959-11-24,2,1983,1985,11,24,USA
Christopher Edwin,1981-05-05,4,2005,2009,5,5,USA
Courtney Demond,1974-10-09,1,2001,2002,10,9,USA
David Edwin,1945-09-26,12,1964,1976,9,26,USA
Jeffrey Matthew,1978-12-09,1,2003,2004,12,9,USA
James William,1871-07-01,0,1899,1899,7,1,USA
Mariano,1963-03-13,12,1985,1997,3,13,D.R.
Louis Baird,1893-10-06,9,1915,1924,10,6,USA
David Shelley,1979-09-29,6,2007,2013,9,29,USA
Taylor McDowell,1953-05-12,1,1977,1978,5,12,USA
Vernon Van Duke,1890-01-06,2,1913,1915,1,6,USA
Edward Joseph,1859-07-10,1,1883,1884,7,10,USA
Augustus Joseph,1874-07-10,2,1904,1906,7,10,USA
James William,1947-08-06,0,1970,1970,8,6,USA
Samuel Morrison,1866-07-29,9,1892,1901,7,29,USA
Leland Huffield,1902-06-09,0,1926,1926,6,9,USA
Henry Houston,1877-01-30,0,1902,1902,1,30,USA
Edward Perks,1872-08-30,7,1897,1904,8,30,USA
William James,1909-05-01,1,1929,1930,5,1,USA
Frederick C.,1859-05-21,11,1880,1891,5,21,USA
Grant Lester,1923-12-20,0,1953,1953,12,20,USA
John Francis,1879-09-14,2,1903,1905,9,14,USA
George Henry,1888-07-19,1,1913,1914,7,19,USA
Adam Troy,1979-11-09,13,2001,2014,11,9,USA
Michael Dennis,1962-10-27,5,1987,1992,10,27,USA
Andrew Jackson,1871-08-12,2,1889,1891,8,12,USA
Jake Austin,1988-08-12,1,2013,2014,8,12,USA
Steven John,1949-05-15,7,1970,1977,5,15,USA
John Joseph,1872-10-06,7,1897,1904,10,6,USA
James William,1931-02-25,0,1952,1952,2,25,USA
Joseph Edward,1885-03-11,1,1908,1909,3,11,USA
Justin Warren,1995-09-22,0,2019,2019,9,22,USA
Michael Glen,1985-05-23,10,2009,2019,5,23,USA
Ronald Ray,1950-01-24,1,1974,1975,1,24,USA
Scott Allen,1978-05-23,2,2004,2006,5,23,USA
Stephen B.,1858-12-21,0,1884,1884,12,21,CAN
Steven Robert,1970-04-18,1,1994,1995,4,18,USA
Todd Kent,1970-07-29,1,1996,1997,7,29,USA
Shawon Donnell,1963-03-21,17,1985,2002,3,21,USA
Todd Franklin,1975-04-11,5,1997,2002,4,11,USA
Frank Oliver,1877-04-29,0,1901,1901,4,29,USA
Jon Christopher,1994-07-11,0,2019,2019,7,11,USA
Michael Dennis,1953-05-29,0,1976,1976,5,29,USA
Daniel James,1954-03-16,0,1981,1981,3,16,USA
German,1984-08-03,0,2008,2008,8,3,Mexico
Luis A.,1986-04-23,2,2009,2011,4,23,Panama
Michael Joseph,1969-09-14,0,1996,1996,9,14,USA
Roberto Alejandro,1973-03-06,1,1997,1998,3,6,D.R.
Montana Robert,1992-03-27,0,2019,2019,3,27,USA
Erubiel,1974-01-23,6,1999,2005,1,23,Mexico
Chad Griffin,1977-12-03,14,1999,2013,12,3,USA
Joseph Adam,1982-02-24,3,2004,2007,2,24,USA
Blaine Alphonsus,1886-09-10,2,1907,1909,9,10,USA
Rinold George,1929-02-22,11,1954,1965,2,22,USA
Louis Staub,1877-06-27,5,1904,1909,6,27,USA
Donald Gary,1949-03-21,1,1972,1973,3,21,USA
Edward Fant,1907-08-17,4,1929,1933,8,17,USA
James Garfield,1881-10-07,0,1902,1902,10,7,USA
Joseph Vann,1931-07-31,5,1954,1959,7,31,USA
Leon,1957-07-31,9,1980,1989,7,31,USA
Ray,1971-11-30,13,1995,2008,11,30,USA
Robert Eugene,1933-01-15,0,1957,1957,1,15,USA
George Dewey,1898-05-09,0,1925,1925,5,9,USA
Richard Knott,1892-10-10,1,1917,1918,10,10,USA
Jayson Paul,1974-08-18,1,2002,2003,8,18,USA
Leo Ernest,1905-07-27,20,1925,1945,7,27,USA
Elmer Cable,1921-02-03,1,1944,1945,2,3,USA
Trent John,1975-08-27,6,1999,2005,8,27,Australia
Cedric Montgomery,1896-08-23,8,1922,1930,8,23,USA
James Newton,1859-09-07,4,1889,1893,9,7,USA
Ervin Frank,1920-07-29,11,1941,1952,7,29,USA
Carl Robert,1932-07-22,2,1956,1958,7,22,USA
Robert Andrew,1935-09-28,0,1963,1963,9,28,USA
Adam Lynn,1988-09-04,5,2014,2019,9,4,USA
Michael Alan,1974-10-11,3,1998,2001,10,11,USA
William George,1870-02-21,0,1890,1890,2,21,USA
Albert Ward,1856-01-04,0,1884,1884,1,4,USA
Christopher Paul,1988-04-10,0,2013,2013,4,10,USA
Joseph Michael,1903-03-27,0,1937,1937,3,27,USA
John Francis,1868-03-25,11,1888,1899,3,25,USA
James Edward,1950-06-03,17,1973,1990,6,3,USA
Jerome Mathew,1955-07-07,5,1980,1985,7,7,USA
James Robert,1922-02-03,5,1951,1956,2,3,USA
Jermaine Terrell,1974-01-28,13,1996,2009,1,28,USA
Benjamin Franklin,1893-02-13,5,1914,1919,2,13,USA
Don Robert,1945-08-15,13,1968,1981,8,15,USA
Edwin Hawley,1899-10-11,5,1922,1927,10,11,USA
Michael Lawrence,1966-09-08,7,1989,1996,9,8,USA
James Henry,1884-07-05,5,1905,1910,7,5,USA
James Joseph,1896-11-10,21,1918,1939,11,10,USA
Radhames Alviro,1974-09-27,0,1998,1998,9,27,Aruba
Allan Christopher,1987-05-21,0,2015,2015,5,21,USA
Leonard Kyle,1963-02-10,11,1985,1996,2,10,USA
John F.,1852-06-05,0,1882,1882,6,5,USA
Jarrod Martel,1984-08-15,9,2010,2019,8,15,USA
Samuel Isaac,1988-05-07,7,2012,2019,5,7,USA
Donald Johnson,1934-02-16,0,1959,1959,2,16,USA
Ryan Nelson,1991-12-15,0,2019,2019,12,15,USA
William,1869-06-01,7,1891,1898,6,1,USA
Charles Eugene,1877-08-10,0,1901,1901,8,10,USA
William Lycurgus,1877-07-25,0,1898,1898,7,25,USA
Charles Emory,1887-09-27,0,1915,1915,9,27,USA
Arnold Carl,1933-06-04,7,1960,1967,6,4,USA
William Moffat,1867-11-10,5,1889,1894,11,10,USA
William Albert,1956-01-30,0,1986,1986,1,30,USA
Thomas Francis Aloysius,1917-02-19,7,1938,1945,2,19,USA
Howard J.,1867-02-25,1,1890,1891,2,25,USA
William Scott,1960-09-18,0,1984,1984,9,18,USA
Jacob Willard,1915-05-19,10,1939,1949,5,19,USA
George Livingston,1900-02-15,8,1928,1936,2,15,USA
Jacinto Damion,1969-11-11,16,1992,2008,11,11,USA
Edward Michael,1985-12-21,0,2015,2015,12,21,USA
Kenneth Logan,1961-11-04,2,1987,1989,11,4,USA
Michael Anthony,1950-11-29,14,1973,1987,11,29,USA
Malcolm Wayne,1879-03-13,6,1900,1906,3,13,USA
Carlton William,1894-08-27,9,1915,1924,8,27,USA
Henry Propert,1864-09-16,6,1884,1890,9,16,USA
James Morris,1953-02-17,13,1974,1987,2,17,USA
Luscious Luke,1915-08-04,5,1949,1954,8,4,USA
Paul,1905-09-28,10,1928,1938,9,28,USA
Roy Charles,1915-01-12,0,1944,1944,1,12,USA
Theodore Harrison,1885-04-20,6,1909,1915,4,20,USA
Harry Hamlet,1862-04-12,0,1882,1882,4,12,USA
Gordon Hugh,1919-07-07,2,1941,1943,7,7,USA
John S.,1865-02-28,5,1889,1894,2,28,USA
John David,1933-03-04,4,1955,1959,3,4,USA
Rawlins Jackson,1950-10-24,7,1974,1981,10,24,USA
Adam Thomas,1977-11-23,9,2000,2009,11,23,USA
Adam Cory,1988-12-06,7,2012,2019,12,6,USA
Craig,1954-09-07,0,1979,1979,9,7,USA
Zebulon Vance,1920-02-02,1,1944,1945,2,2,USA
Gary Louis,1963-07-22,2,1988,1990,7,22,USA
Vallie Ennis,1911-09-06,7,1935,1942,9,6,USA
Edwin,1890-11-10,8,1913,1921,11,10,USA
Charles Hercules,1859-10-29,NA,NA,NA,10,29,USA
Derrin Lee,1976-08-21,0,1999,1999,8,21,USA
Hiram C.,1859-06-12,0,1889,1889,6,12,USA
Harry Josiah,1893-07-09,0,1915,1915,7,9,USA
Angel Santos,1971-05-25,6,1996,2002,5,25,USA
John Gresham,1917-01-09,0,1939,1939,1,9,USA
Eric Ryan,1976-12-17,1,2002,2003,12,17,USA
Albert George,1906-05-17,5,1930,1935,5,17,USA
Charles William,1897-08-08,3,1919,1922,8,8,USA
Dennis Lee,1954-10-03,23,1975,1998,10,3,USA
Oscar George,1901-12-23,4,1932,1936,12,23,USA
David Mark,1975-01-20,9,2001,2010,1,20,USA
Christopher Mark,1969-11-27,0,1995,1995,11,27,USA
Donald Eugene,1946-10-25,1,1970,1971,10,25,USA
Steven Allen,1957-08-21,0,1979,1979,8,21,USA
Edward Joseph,1912-03-16,0,1932,1932,3,16,USA
Benny Joe,1955-09-16,1,1981,1982,9,16,USA
John Rogers,1935-07-27,0,1955,1955,7,27,USA
Charles M.,1855-01-18,8,1877,1885,1,18,USA
Kenneth Edward,1967-03-18,1,1995,1996,3,18,USA
Edward Michael,1949-05-22,2,1976,1978,5,22,Panama
Thomas Patrick,1961-06-09,8,1987,1995,6,9,USA
Claude Lee,1956-07-18,0,1979,1979,7,18,USA
William Albert,1941-08-16,3,1966,1969,8,16,USA
Joshua Wayne,1986-12-17,5,2012,2017,12,17,USA
Jacob Frank,1891-07-04,0,1912,1912,7,4,USA
Steven Bradley,1985-06-27,1,2011,2012,6,27,USA
David Delmer,1956-08-05,3,1980,1983,8,5,USA
Thomas Hyunsu,1995-05-09,0,2019,2019,5,9,USA
Robert E.,1879-04-30,2,1906,1908,4,30,USA
Brian Christopher,1973-01-29,1,1998,1999,1,29,USA
Earl Edward,1889-11-20,0,1913,1913,11,20,USA
George Henderson,1896-05-18,2,1922,1924,5,18,USA
James Patrick,1970-06-27,17,1993,2010,6,27,USA
Paul Michael,1943-02-12,0,1969,1969,2,12,USA
Samuel Sherwood,1883-08-30,0,1907,1907,8,30,USA
Charles Bruce,1923-07-15,10,1946,1956,7,15,USA
Carl Fleming,1991-09-03,4,2015,2019,9,3,USA
David Leonard,1954-02-24,4,1978,1982,2,24,USA
Howard Rodney,1936-12-10,8,1962,1970,12,10,USA
Foster Hamilton,1903-09-01,5,1925,1930,9,1,USA
Henry Albert,1919-01-29,12,1941,1953,1,29,USA
James Corbette,1894-12-14,6,1922,1928,12,14,USA
John Alban,1938-06-10,13,1961,1974,6,10,USA
Jonathan Benjamin,1988-01-08,5,2014,2019,1,8,USA
Marshall Lynn,1952-08-27,2,1981,1983,8,27,USA
Michael Lewis,1952-08-27,3,1977,1980,8,27,USA
Michael Donald,1976-11-24,3,2003,2006,11,24,USA
Ralph Strunk,1882-12-14,0,1915,1915,12,14,USA
Sherman Stanley,1909-07-25,0,1934,1934,7,25,USA
Wayne Maurice,1964-03-07,2,1989,1991,3,7,USA
Harry Archibald,1880-02-14,0,1906,1906,2,14,USA
Robert Franciscus,1968-02-09,3,1994,1997,2,9,Netherlands
Zachary Adams,1994-04-08,3,2016,2019,4,8,USA
Arthur Augustus,1883-11-20,7,1908,1915,11,20,USA
Richard Joseph,1884-06-23,8,1908,1916,6,23,USA
Richard Wallis,1937-03-24,4,1963,1967,3,24,USA
John Joseph,1871-07-09,0,1894,1894,7,9,USA
Thomas Patrick,1946-06-09,10,1965,1975,6,9,USA
Aloysius Jerome,1881-06-16,4,1902,1906,6,16,USA
John Edward,1983-05-12,3,2009,2012,5,12,USA
Cody Paul,1991-05-08,0,2016,2016,5,8,USA
Elmer Albert,1902-01-29,0,1927,1927,1,29,USA
David Daniel,1849-04-30,14,1871,1885,4,30,USA
Bruce Edward,1965-04-10,0,1991,1991,4,10,USA
Howard John,1894-04-24,15,1915,1930,4,24,USA
Philip Sydney,1868-08-31,10,1888,1898,8,31,USA
Welton Claude,1894-11-20,5,1924,1929,11,20,USA
Henry Hack,1893-12-06,8,1912,1920,12,6,USA
Brett William,1988-12-02,1,2016,2017,12,2,USA
Juan Tyrone,1953-10-21,10,1978,1988,10,21,USA
Mark Anthony,1960-11-21,14,1982,1996,11,21,USA
Frederick George,1903-01-06,6,1925,1931,1,6,USA
Jerad Joseph,1990-07-02,4,2015,2019,7,2,USA
David William,1966-07-05,12,1988,2000,7,5,USA
David Louis,1936-12-03,3,1964,1967,12,3,USA
Darrell Lee,1972-09-04,0,2000,2000,9,4,USA
Joseph Raymond,1970-05-25,12,1994,2006,5,25,USA
Harry,1915-10-10,7,1935,1942,10,10,USA
Jacob Henry,1922-10-03,0,1944,1944,10,3,USA
James Michael,1959-04-18,16,1982,1998,4,18,USA
Edward Henry,1871-10-14,1,1890,1891,10,14,Germany
Michael Robert,1983-08-30,4,2008,2012,8,30,USA
Frederick,1851-09-12,0,1873,1873,9,12,USA
Vincent Scott,1976-02-23,10,1998,2008,2,23,USA
Norman Arthur,1875-04-13,16,1898,1914,4,13,USA
Timothy Scott,1985-08-13,6,2008,2014,8,13,USA
David Matthew,1975-09-23,1,2002,2003,9,23,USA
George Rezin,1921-03-10,0,1949,1949,3,10,USA
Henry Knox,1890-08-23,0,1913,1913,8,23,USA
Bradley Ross,1980-07-12,7,2005,2012,7,12,USA
Calvin John,1967-11-24,14,1991,2005,11,24,USA
Lee Constantine,1937-07-16,2,1966,1968,7,16,USA
Roenis,1988-08-01,5,2014,2019,8,1,Cuba
Peter,1918-06-17,1,1943,1944,6,17,USA
Roy,1886-02-08,9,1909,1918,2,8,USA
Francis Rogers,1895-12-25,5,1919,1924,12,25,USA
Horace Owen,1894-07-05,4,1917,1921,7,5,USA
Joseph J.,1854-04-03,9,1875,1884,4,3,USA
Harold Bruce,1949-04-26,0,1974,1974,4,26,USA
Brian Michael,1990-08-04,2,2015,2017,8,4,USA
Allen Clifford,1897-12-25,1,1923,1924,12,25,USA
Robert Irving,1916-11-26,14,1939,1953,11,26,USA
Carter Ward,1893-11-29,0,1921,1921,11,29,USA
Claude Judson,1876-11-17,1,1904,1905,11,17,USA
Donald Glenn,1968-09-20,1,1994,1995,9,20,USA
Eugene Burninghaus,1889-02-08,0,1911,1911,2,8,USA
Herbert Glenn,1919-11-11,2,1947,1949,11,11,USA
Harold William,1899-05-29,3,1929,1932,5,29,USA
Harry Lewis,1923-12-30,2,1953,1955,12,30,USA
James Thomas,1900-10-22,11,1923,1934,10,22,USA
Lawrence Lee,1938-03-05,4,1962,1966,3,5,USA
Randy Lee,1951-06-05,8,1972,1980,6,5,USA
Harold Bell,1890-07-08,10,1910,1920,7,8,USA
Andrew James,1981-04-09,10,2008,2018,4,9,USA
Herbert Spencer,1896-11-15,4,1916,1920,11,15,USA
Christopher John,1992-09-22,0,2019,2019,9,22,USA
Dock Phillip,1945-03-11,11,1968,1979,3,11,USA
George Russell,1897-01-24,0,1920,1920,1,24,USA
Jason Jerome,1978-04-04,5,2003,2008,4,4,USA
James Russell,1945-03-25,2,1967,1969,3,25,USA
John Charles,1948-08-21,12,1969,1981,8,21,USA
Mark William,1977-06-06,12,2002,2014,6,6,USA
Robert Walter,1950-07-03,4,1971,1975,7,3,USA
Robert Randolph,1970-12-15,7,1996,2003,12,15,USA
George William,1885-11-17,3,1909,1912,11,17,USA
Samuel Joseph,1941-02-11,7,1962,1969,2,11,USA
Jacoby McCabe,1983-09-11,10,2007,2017,9,11,USA
Richard Clark,1940-03-22,13,1958,1971,3,22,USA
Steven Clark,1960-07-30,0,1988,1988,7,30,USA
Jacob David,1987-06-15,7,2012,2019,6,15,USA
Verdo Wilson,1899-12-10,0,1924,1924,12,10,USA
Eugene Raybold,1891-03-01,2,1923,1925,3,1,USA
Kevin Daniel,1964-08-03,14,1986,2000,8,3,USA
Donald Ray,1929-04-06,11,1953,1964,4,6,USA
Narciso Chicho,1967-10-29,0,1990,1990,10,29,Mexico
William Frederick,1863-06-07,18,1884,1902,6,7,USA
Isaac Harry,1868-08-13,0,1892,1892,8,13,USA
John Daniel,1986-05-13,2,2010,2012,5,13,USA
Bradley Mark,1986-03-28,0,2011,2011,3,28,USA
Alan Duane,1970-01-23,17,1992,2009,1,23,USA
Charles Willard,1917-08-30,8,1941,1949,8,30,USA
Charles Akin,1901-08-17,0,1923,1923,8,17,USA
Chester Arthur,1889-10-27,1,1911,1912,10,27,USA
Calvin Wayne,1937-06-28,0,1963,1963,6,28,USA
Herrick Smith,1896-12-10,0,1924,1924,12,10,USA
Charles Henry,1875-04-05,0,1896,1896,4,5,USA
Robert George,1891-08-01,0,1923,1923,8,1,USA
Frank William,1896-02-17,10,1916,1926,2,17,USA
William Peter,1919-09-29,1,1945,1946,9,29,USA
Robert Daniel,1859-01-27,2,1883,1885,1,27,CAN
Angelo Benjamin,1969-04-18,2,1995,1997,4,18,D.R.
Edwin Elpidio,1983-01-07,14,2005,2019,1,7,D.R.
Juan de Dios,1976-03-08,10,1997,2007,3,8,D.R.
Luis Martin Lora,1963-10-20,0,1990,1990,10,20,D.R.
Mario,1975-09-24,1,2001,2002,9,24,D.R.
Trevor Hale,1974-12-22,0,2000,2000,12,22,USA
William Franklin,1918-09-04,0,1946,1946,9,4,USA
Adam Trevor,1991-12-09,2,2017,2019,12,9,USA
Joseph William,1893-03-12,8,1912,1920,3,12,USA
Steven Michael,1961-12-31,0,1985,1985,12,31,USA
Charlie August,1903-08-27,5,1925,1930,8,27,USA
Arthur Clyde,1884-03-19,7,1909,1916,3,19,USA
Ralph David,1956-11-30,8,1981,1989,11,30,USA
Richard Douglas,1957-04-07,0,1981,1981,4,7,USA
Charles Dewie,1910-04-08,5,1932,1937,4,8,USA
Gilbert Raymond,1909-07-02,13,1931,1944,7,2,USA
Jesse Logan,1984-09-13,0,2010,2010,9,13,USA
Elwood George,1906-03-02,11,1927,1938,3,2,USA
Delmer,1925-06-08,13,1946,1959,6,8,USA
John Wayne,1979-10-17,5,2002,2007,10,17,USA
Russell Edward,1897-03-10,0,1926,1926,3,10,USA
Dietrich,1991-05-16,0,2017,2017,5,16,USA
Barry Ryan,1986-03-30,3,2010,2013,3,30,USA
George Albert,1954-05-09,0,1976,1976,5,9,USA
Jackson Percy,1895-11-29,0,1917,1917,11,29,USA
Morgan Paul,1975-08-26,8,2000,2008,8,26,USA
Jewel Winklemeyer,1889-08-24,3,1922,1925,8,24,USA
Anton,1887-02-02,0,1912,1912,2,2,USA
Charles Massey,1887-10-06,0,1909,1909,10,6,USA
Terry Gene,1950-10-10,0,1974,1974,10,10,USA
Clarence Herman,1885-11-04,1,1914,1915,11,4,USA
John,1890-03-04,6,1914,1920,3,4,USA
Nathan Edward,1990-02-13,8,2011,2019,2,13,USA
James Gerhard,1960-04-27,3,1987,1990,4,27,USA
Albert Paul,1918-05-07,12,1938,1950,5,7,USA
Cody Allen,1985-10-08,2,2011,2013,10,8,USA
Aubrey Lee,1912-03-03,0,1935,1935,3,3,USA
Harold Franklin,1914-03-26,6,1938,1944,3,26,USA
Michael Peter,1943-04-04,8,1966,1974,4,4,USA
Joseph Gregory,1954-05-31,0,1977,1977,5,31,USA
Edward Lorenz Sebastian,1924-09-26,6,1947,1953,9,26,USA
Joseph Michael,1921-09-01,1,1950,1951,9,1,CAN
Todd Michael,1973-11-21,4,1997,2001,11,21,USA
Donald Lee,1931-12-13,0,1958,1958,12,13,USA
Eric George Adolph,1892-03-13,8,1914,1922,3,13,Sweden
Henry Nels,1907-11-11,0,1935,1935,11,11,USA
Harold James,1919-07-17,0,1953,1953,7,17,USA
John Edward,1967-09-16,2,1995,1997,9,16,USA
Matt,1975-07-30,0,2004,2004,7,30,USA
Paul Walford,1915-12-14,7,1941,1948,12,14,USA
Ralph Lief,1902-06-25,1,1929,1930,6,25,USA
Roger Farrell,1956-08-30,5,1978,1983,8,30,USA
Scott Gavin,1968-02-02,16,1990,2006,2,2,USA
Robert Joseph,1990-10-08,6,2013,2019,10,8,USA
Calvin Coolidge,1923-11-10,0,1947,1947,11,10,USA
Frank John,1930-08-22,1,1957,1958,8,22,USA
Richard Merriwell,1912-03-05,4,1938,1942,3,5,USA
Carl Daniel,1926-12-13,11,1948,1959,12,13,USA
Darin Charles,1974-06-04,13,1996,2009,6,4,USA
Phillip S.,1992-07-15,2,2017,2019,7,15,USA
Ross Emil,1885-12-22,7,1907,1914,12,22,USA
Nicholas Andrew,1960-02-24,7,1983,1990,2,24,USA
Edgmer Eduarado,1986-10-06,3,2010,2013,10,6,Venezuela
Felix Eduardo,1979-03-12,3,2002,2005,3,12,Venezuela
Saturnino,1929-12-01,0,1954,1954,12,1,P.R.
Sergio Luis,1984-08-03,2,2009,2011,8,3,Venezuela
Ernesto,1949-12-27,0,1982,1982,12,27,Mexico
James Godrich,1891-08-21,0,1915,1915,8,21,USA
Lawrence Edward,1920-09-22,0,1942,1942,9,22,USA
Jacob Otto,1990-03-27,1,2016,2017,3,27,USA
Alexander Jose,1978-09-06,5,2001,2006,9,6,Venezuela
Alcides,1986-12-16,10,2008,2018,12,16,Venezuela
Angel Ruben,1965-05-12,0,1988,1988,5,12,Venezuela
Eduardo Jose,1989-01-05,8,2011,2019,1,5,Venezuela
Edwin Jose,1992-04-22,2,2014,2016,4,22,Venezuela
Jose Elias,1960-10-30,0,1991,1991,10,30,Venezuela
Kelvim Jose,1976-04-11,12,1997,2009,4,11,Venezuela
Luis Alberto,1996-05-30,0,2019,2019,5,30,Colombia
Yunel,1982-11-02,10,2007,2017,11,2,Cuba
Thomas Darwin,1994-06-20,0,2019,2019,6,20,USA
Vaughn Michael,1969-05-22,2,1995,1997,5,22,USA
James Joseph,1889-08-08,4,1911,1915,8,8,USA
Charles H.,1867-07-28,8,1890,1898,7,28,USA
Alvaro Alberto,1962-02-19,13,1984,1997,2,19,Venezuela
Daniel Richard,1987-04-25,7,2010,2017,4,25,USA
Eugene MacAlalag,1982-09-08,0,2008,2008,9,8,USA
Juan,1956-03-16,4,1982,1986,3,16,D.R.
Arnulfo Acevedo,1953-08-15,7,1974,1981,8,15,D.R.
Paolo Alesandro,1987-01-10,0,2017,2017,1,10,Panama
Brian James,1979-02-24,3,2007,2010,2,24,USA
Michael Anthony,1981-09-27,0,2005,2005,9,27,USA
Samuel,1931-12-15,11,1952,1963,12,15,USA
Cecil Edward,1963-01-20,10,1983,1993,1,20,USA
Charles Abraham,1931-08-09,5,1958,1963,8,9,USA
Mark Gerald,1956-04-01,0,1979,1979,4,1,USA
James Sarkis,1951-01-02,11,1973,1984,1,2,USA
William Earl,1880-12-18,1,1906,1907,12,18,USA
Roberto,1911-04-25,14,1935,1949,4,25,Cuba
Robert M.,1974-08-23,8,1996,2004,8,23,USA
Richard Henry,1942-01-18,1,1964,1965,1,18,USA
Thomas John,1857-06-09,11,1880,1891,6,9,USA
Aaron Shawn,1973-02-18,13,1995,2008,2,18,USA
Carlos Samuel,1992-12-28,3,2016,2019,12,28,D.R.
George John,1924-11-02,0,1951,1951,11,2,USA
Charles Leonard,1938-02-15,7,1960,1967,2,15,USA
Francisco,1948-02-12,0,1971,1971,2,12,Mexico
Horacio,1975-10-19,2,1999,2001,10,19,Venezuela
Johnny Pulado,1976-06-27,7,2001,2008,6,27,USA
Marco Rene,1983-07-05,11,2008,2019,7,5,Mexico
Oscar,1904-02-15,0,1929,1929,2,15,Cuba
Thairo Jose,1996-02-22,0,2019,2019,2,22,Venezuela
Leoncio,1975-02-20,4,2000,2004,2,20,D.R.
Andrew Auguste,1943-06-20,16,1962,1978,6,20,USA
Clarence Hampton,1915-01-27,1,1943,1944,1,27,USA
Bobby Lamar,1942-11-25,2,1967,1969,11,25,USA
Seth Michael,1976-10-17,6,2000,2006,10,17,USA
Andre Everett,1982-04-10,11,2006,2017,4,10,USA
Nicholas Raymond Thomas,1913-09-19,9,1938,1947,9,19,USA
Mark Edward,1966-10-30,0,1993,1993,10,30,Australia
John Franklin,1872-09-09,2,1905,1907,9,9,USA
Uel Melvin,1903-02-14,0,1922,1922,2,14,USA
Frank Anthony,1959-12-23,0,1985,1985,12,23,USA
Fernandes Bowen,1892-04-22,0,1917,1917,4,22,USA
Raul Antonio Bare,1967-04-27,10,1991,2001,4,27,D.R.
Frank John,1873-11-07,0,1896,1896,11,7,USA
Alfred Hubert,1916-09-28,12,1939,1951,9,28,USA
William Arthur,1911-08-03,0,1932,1932,8,3,USA
Barry Steven,1955-11-30,4,1978,1982,11,30,USA
Bart Steven,1970-12-30,0,1998,1998,12,30,USA
William James,1893-02-10,3,1916,1919,2,10,USA
William Lawrence,1919-03-25,2,1949,1951,3,25,USA
William George,1884-02-10,NA,NA,NA,2,10,USA
Charles Franklin,1889-10-15,1,1909,1910,10,15,USA
Darrell Wayne,1947-05-26,20,1969,1989,5,26,USA
Dwight Michael,1951-11-03,19,1972,1991,11,3,USA
Uriah L. P.,1856-09-22,6,1879,1885,9,22,USA
Joseph Patton,1895-05-15,10,1915,1925,5,15,USA
Nicholas R.,1986-01-30,6,2008,2014,1,30,USA
Phillip Matthew,1992-09-10,1,2017,2018,9,10,USA
Russell Edison,1906-11-12,3,1936,1939,11,12,USA
Robert Roy,1874-03-19,6,1897,1903,3,19,USA
Louis Richard,1885-02-17,7,1908,1915,2,17,USA
Michael Terry,1982-01-19,3,2007,2010,1,19,USA
Thomas John,1974-07-09,3,1997,2000,7,9,USA
Dana James,1983-10-29,11,2005,2016,10,29,USA
Jeffrey Adam,1977-02-02,10,2001,2011,2,2,USA
Carl Edward,1971-06-03,13,1993,2006,6,3,USA
William Lee,1868-12-13,6,1895,1901,12,13,USA
Edward Leon,1947-01-12,0,1969,1969,1,12,USA
Thomas James,1983-04-20,0,2009,2009,4,20,USA
Bryan David,1969-02-11,4,1994,1998,2,11,USA
Walter Arthur,1921-02-08,15,1941,1956,2,8,USA
John Joseph,1881-07-21,27,1902,1929,7,21,USA
Joseph Francis,1891-09-10,0,1913,1913,9,10,USA
Thomas Francis,1852-03-31,2,1882,1884,3,31,USA
George W.,1850-10-29,0,1871,1871,10,29,USA
George Lemuel,1873-04-24,10,1902,1912,4,24,USA
William,1859-10-17,17,1880,1897,10,17,USA
John,1863-06-01,8,1883,1891,6,1,USA
Reuben,1899-11-30,0,1921,1921,11,30,Russia
Samuel James,1949-04-09,5,1973,1978,4,9,USA
Arthur Lee,1894-01-08,0,1919,1919,1,8,USA
Luis,1987-01-20,0,2012,2012,1,20,USA
Scott Alan,1972-05-30,12,1997,2009,5,30,USA
William Mays,1978-07-21,5,2006,2011,7,21,USA
George Lincoln,1925-03-03,0,1943,1943,3,3,USA
Homer Estell,1896-02-28,2,1923,1925,2,28,USA
Jacob S.,1859-10-24,6,1884,1890,10,24,USA
Urban Clarence,1888-09-06,19,1914,1933,9,6,USA
Jorge,1970-03-13,8,1994,2002,3,13,USA
Albert LaVerne,1887-12-23,1,1916,1917,12,23,USA
Elroy Leon,1928-02-20,16,1953,1969,2,20,USA
Leonardo Lago,1960-05-13,4,1980,1984,5,13,USA
Anthony Joseph,1893-07-09,1,1919,1920,7,9,USA
William A.,1865-02-15,1,1887,1888,2,15,USA
Everett Joseph,1918-01-13,3,1943,1946,1,13,USA
William Roger,1950-06-14,12,1971,1983,6,14,USA
Brandon Michael,1981-01-18,2,2006,2008,1,18,USA
Francis Raymond,1896-01-22,0,1918,1918,1,22,USA
Howard Simpson,1892-06-24,0,1912,1912,6,24,USA
Clarence Willie,1890-03-10,0,1914,1914,3,10,USA
Gerald Warren,1924-12-09,0,1951,1951,12,9,USA
Ferris Roy,1921-03-29,8,1947,1955,3,29,USA
James Lee,1881-03-17,1,1903,1904,3,17,USA
Peter Anderson,1993-12-16,0,2019,2019,12,16,USA
James Lamar,1892-08-19,0,1919,1919,8,19,USA
James Burke,1944-09-22,5,1968,1973,9,22,USA
George T.,1856-01-13,0,1876,1876,1,13,USA
Ronald Ray,1938-07-12,20,1958,1978,7,12,USA
Hector,1970-11-16,4,1991,1995,11,16,Mexico
Anton C.,1860-12-04,0,1884,1884,12,4,USA
Peter,1953-10-01,9,1975,1984,10,1,USA
Bibb August,1899-01-27,11,1920,1931,1,27,USA
Chester Emanuel,1905-05-15,2,1925,1927,5,15,USA
Brian Thomas,1978-01-18,9,1999,2008,1,18,USA
Frederick Peter,1879-12-17,14,1903,1917,12,17,USA
Edward Joseph,1908-12-22,2,1931,1933,12,22,USA
Robert Joseph,1960-02-18,1,1984,1985,2,18,USA
Charles Augustus,1881-03-07,0,1905,1905,3,7,USA
George Decatur,1914-07-08,8,1937,1945,7,8,USA
Peter James,1891-04-24,0,1914,1914,4,24,USA
Steven James,1972-01-28,2,1997,1999,1,28,USA
Irving,1983-06-06,2,2012,2014,6,6,P.R.
Jeurys,1989-10-10,7,2012,2019,10,10,D.R.
Rikkert,1969-05-31,3,1993,1996,5,31,Netherlands
Clifford Bryson,1924-05-13,7,1945,1952,5,13,USA
William James,1927-09-14,3,1954,1957,9,14,USA
Harry Michael,1940-05-11,1,1963,1964,5,11,USA
Frank Joseph,1923-01-11,4,1949,1953,1,11,USA
Stanley Robert,1965-02-12,0,1986,1986,2,12,USA
Harry Clayton,1886-10-16,0,1910,1910,10,16,USA
Carmen Donald,1941-08-30,4,1970,1974,8,30,USA
Jacob Daniel,1993-07-30,2,2017,2019,7,30,USA
Paul Tyrrell,1965-02-20,3,1990,1993,2,20,USA
Monty Ted,1967-10-13,2,1991,1993,10,13,USA
Robert Jacob,1937-11-15,1,1961,1962,11,15,USA
Alexander Johnson,1877-05-09,0,1908,1908,5,9,USA
William Charles,1864-02-27,0,1888,1888,2,27,Ireland
George Runie,1991-02-20,5,2014,2019,2,20,USA
Edward Joseph,1949-10-18,12,1971,1983,10,18,USA
Howard Earl,1966-11-18,0,1990,1990,11,18,USA
Floyd Haskell,1892-07-14,2,1916,1918,7,14,USA
James Kyle,1990-08-17,2,2017,2019,8,17,USA
Michael Anthony,1968-07-03,0,1996,1996,7,3,USA
Jeffrey Ellis,1975-10-06,0,2002,2002,10,6,USA
Kyle Lynn,1976-04-14,15,1999,2014,4,14,USA
Daniel Andres,1987-02-17,7,2011,2018,2,17,USA
Sidney Douglas,1859-08-10,7,1883,1890,8,10,USA
Edward Stephen,1901-12-26,10,1925,1935,12,26,USA
Charles Andrew,1866-08-31,17,1888,1905,8,31,USA
John,1856-01-02,0,1874,1874,1,2,USA
John A.,1857-07-05,10,1879,1889,7,5,USA
John Edward,1892-12-19,1,1914,1915,12,19,USA
John Sebastian,1876-12-04,4,1901,1905,12,4,USA
John Edward,1962-08-04,9,1987,1996,8,4,USA
Major Kerby,1913-09-03,2,1943,1945,9,3,USA
Luke Thomas,1991-06-07,2,2017,2019,6,7,USA
Richard Joseph,1934-04-08,13,1956,1969,4,8,USA
Eric Michael-Jay,1986-03-03,1,2011,2012,3,3,USA
James Alfred,1956-05-18,0,1982,1982,5,18,USA
John Jacob,1853-11-08,11,1873,1884,11,8,USA
Steven Michael,1956-12-12,10,1984,1994,12,12,USA
Salvatore Frank,1971-08-10,12,1996,2008,8,10,USA
Jeffrey Joseph,1963-01-05,15,1991,2006,1,5,USA
Frederick Peter,1859-10-30,0,1887,1887,10,30,USA
Darcy Rae,1947-03-10,0,1968,1968,3,10,USA
John Edward,1927-04-11,0,1953,1953,4,11,USA
William Alvan,1940-04-21,8,1962,1970,4,21,USA
Andrew Michael,1992-09-12,1,2015,2016,9,12,USA
James Leroy,1899-07-27,3,1927,1930,7,27,USA
Robert Shaw,1908-04-08,0,1944,1944,4,8,USA
Charles Victor,1880-10-09,0,1911,1911,10,9,USA
Joseph Roamon,1887-02-28,0,1916,1916,2,28,USA
Clayton King,1872-08-01,0,1899,1899,8,1,USA
Ernest Joseph,1942-01-25,4,1962,1966,1,25,USA
Luvern Carl,1924-08-21,0,1952,1952,8,21,USA
Taylor Joseph,1989-10-08,2,2015,2017,10,8,USA
Carlos Manuel,1976-05-24,5,1998,2003,5,24,D.R.
Erick James,1993-02-25,2,2017,2019,2,25,USA
Alfred,1924-07-11,1,1951,1952,7,11,USA
Timothy Joseph,1987-08-05,8,2011,2019,8,5,USA
John,1867-12-23,0,1889,1889,12,23,USA
William Paul,1912-05-31,0,1934,1934,5,31,USA
Ryan Robert,1985-08-22,13,2006,2019,8,22,USA
Edward Isidore,1917-09-29,1,1938,1939,9,29,USA
Marvin Wilfred,1915-12-20,0,1942,1942,12,20,USA
Michael Otis,1961-11-18,9,1985,1994,11,18,USA
Harry,1919-11-10,5,1941,1946,11,10,USA
Scott Wynne,1983-02-07,12,2005,2017,2,7,USA
Jesus,1979-06-06,0,2010,2010,6,6,P.R.
Pedro Juan,1976-08-25,11,2002,2013,8,25,P.R.
August Guenther,1895-05-24,4,1923,1927,5,24,USA
Harry Francis,1875-07-16,1,1901,1902,7,16,USA
Junior Francisco,1967-10-03,5,1989,1994,10,3,D.R.
Michael,1993-06-28,4,2015,2019,6,28,D.R.
Neftali,1988-05-02,8,2009,2017,5,2,D.R.
Pedro Julio,1975-04-27,10,2000,2010,4,27,D.R.
Robert William Andrew,1918-11-03,20,1936,1956,11,3,USA
Jack Leland,1936-12-10,0,1958,1958,12,10,USA
Oscar Emil,1891-08-22,5,1915,1920,8,22,USA
John Frederick,1942-05-30,5,1968,1973,5,30,USA
Terry Lane,1957-10-29,3,1979,1982,10,29,USA
Francis John,1860-02-18,6,1884,1890,2,18,USA
Horace Alfred,1897-07-12,0,1921,1921,7,12,USA
Robert Richard,1946-12-10,1,1972,1973,12,10,Japan
Stanley,1915-03-05,4,1942,1946,3,5,USA
James Alexander,1897-02-16,11,1918,1929,2,16,USA
Robert Vavasour,1845-01-31,13,1871,1884,1,31,USA
Robert Lester,1919-04-18,0,1944,1944,4,18,USA
Caleb Paul,1996-07-02,1,2018,2019,7,2,USA
Charles J.,1863-04-17,3,1884,1887,4,17,USA
Charles Augustus,1875-05-10,0,1901,1901,5,10,USA
Cecil Benoni,1883-08-27,5,1906,1911,8,27,USA
Joseph Vance,1946-09-19,13,1970,1983,9,19,USA
Felix Jose,1963-10-09,9,1987,1996,10,9,D.R.
Ramon Antonio,1972-11-25,0,1995,1995,11,25,D.R.
Alexander,1969-08-13,10,1990,2000,8,13,USA
Humberto,1932-03-02,7,1956,1963,3,2,Cuba
Lorenzo Marto,1939-04-23,0,1968,1968,4,23,Cuba
Edward Paul,1918-03-11,6,1940,1946,3,11,USA
Frank,1943-04-16,5,1967,1972,4,16,USA
Jared Wade,1972-02-02,5,2001,2006,2,2,USA
Jose Mayobanex,1974-11-02,2,1999,2001,11,2,D.R.
Jose D.,1992-07-31,3,2013,2016,7,31,Cuba
Jose Miguel,1988-04-27,0,2018,2018,4,27,Cuba
Jose Manuel,1993-02-13,1,2018,2019,2,13,D.R.
Junior Fabio,1997-03-02,0,2019,2019,3,2,D.R.
Froilan,1918-10-25,8,1942,1950,10,25,USA
Osvaldo,1966-11-04,5,1996,2001,11,4,Cuba
Charles Sidney,1962-10-12,14,1983,1997,10,12,USA
Octavio Antonio,1962-06-30,18,1983,2001,6,30,D.R.
Alfred John,1939-12-22,8,1963,1971,12,22,USA
Anthony Michael,1978-06-22,0,2003,2003,6,22,USA
William Joseph,1907-04-19,0,1935,1935,4,19,USA
Donald Hugh,1929-06-19,7,1955,1962,6,19,USA
Michael Dennis,1944-08-18,6,1966,1972,8,18,USA
Jeffrey Alan,1990-11-23,2,2015,2017,11,23,USA
Richard Benjamin,1905-10-12,18,1929,1947,10,12,USA
Sergio,1951-01-29,5,1974,1979,1,29,P.R.
Anthony Ross,1962-10-04,0,1985,1985,10,4,USA
Wesley Cheek,1908-02-02,14,1927,1941,2,2,USA
Robert Eugene,1955-05-07,1,1979,1980,5,7,USA
David Meadow,1921-12-05,5,1945,1950,12,5,USA
Albert Samuel,1874-12-07,8,1901,1909,12,7,United Kingdom
Thomas Jerome,1915-01-06,11,1941,1952,1,6,USA
Alfred Joseph,1878-09-27,1,1904,1905,9,27,USA
John Francis,1887-04-07,3,1910,1913,4,7,USA
Alexander,1866-07-14,3,1889,1892,7,14,USA
Wallace Clifton,1860-10-05,NA,NA,NA,10,5,USA
Matthew,1993-03-11,1,2018,2019,3,11,USA
Louis Henry William,1907-03-15,8,1937,1945,3,15,USA
Michael Lee,1964-12-19,15,1989,2004,12,19,USA
William McKinnon,1884-06-24,0,1906,1906,6,24,USA
Wilson Lloyd,1895-11-10,10,1917,1927,11,10,USA
Neil Stephen,1956-08-24,0,1981,1981,8,24,USA
Charles Joseph,1985-11-20,0,2012,2012,11,20,USA
John Ralph,1921-05-18,0,1944,1944,5,18,USA
Robert Charles John,1974-03-15,9,1998,2007,3,15,USA
Mark Steven,1954-08-14,4,1976,1980,8,14,USA
Clarence Thomas,1913-09-04,0,1932,1932,9,4,USA
Bruce Alan,1960-10-06,3,1986,1989,10,6,USA
Cecil Grant,1963-09-21,13,1985,1998,9,21,USA
Daniel Leigh,1991-01-23,0,2015,2015,1,23,USA
George S.,1852-07-26,0,1872,1872,7,26,USA
James C.,1863-04-24,15,1883,1898,4,24,USA
John Joseph,1864-10-20,5,1887,1892,10,20,Ireland
Joshua Dean,1982-12-14,4,2006,2010,12,14,USA
Joshua David,1985-08-19,5,2013,2018,8,19,USA
John David,1992-02-20,0,2018,2018,2,20,USA
Nathan Patrick,1975-12-11,5,2002,2007,12,11,USA
Prince Semien,1984-05-09,11,2005,2016,5,9,USA
Samuel Jay,1848-10-12,1,1875,1876,10,12,USA
Thomas Samuel,1987-02-22,4,2011,2015,2,22,USA
Casey Michael,1983-10-21,8,2009,2017,10,21,USA
Louis Henry,1884-12-29,3,1906,1909,12,29,USA
Michael Bruce,1985-06-15,8,2011,2019,6,15,USA
Danny Wayne,1949-10-05,1,1973,1974,10,5,USA
Stephen J.,1986-10-04,2,2012,2014,10,4,USA
John Proctor,1871-10-05,2,1897,1899,10,5,USA
Alfredo,1984-07-07,5,2009,2014,7,7,D.R.
Michael Anthony,1970-07-31,2,1997,1999,7,31,USA
Frank Y.,1873-04-22,0,1894,1894,4,22,USA
Desmond DeChone,1978-01-22,12,2002,2014,1,22,USA
Bienvenido,1964-02-07,0,1992,1992,2,7,D.R.
Stephen Cole,1987-06-30,2,2014,2016,6,30,USA
Eduardo,1948-10-14,7,1974,1981,10,14,P.R.
Jesus Maria,1957-02-20,0,1980,1980,2,20,D.R.
Luis R.,1974-02-16,6,2001,2007,2,16,P.R.
Nelson,1974-05-18,11,2000,2011,5,18,USA
Pedro Jose,1985-11-23,2,2012,2014,11,23,D.R.
Jeremy Joseph,1975-04-08,3,2001,2004,4,8,USA
Robert Michael,1977-01-28,3,2001,2004,1,28,USA
Thomas Carson,1956-12-01,10,1982,1992,12,1,USA
Samuel Lawrence,1922-05-18,0,1940,1940,5,18,USA
Charles Edward,1883-05-19,0,1908,1908,5,19,USA
Stephen Charles,1921-06-28,4,1944,1948,6,28,USA
Marcus Lucius,1912-02-28,0,1934,1934,2,28,USA
Dana,1893-11-06,10,1915,1925,11,6,USA
Heath Devon,1994-05-16,1,2018,2019,5,16,USA
William Peter,1958-09-28,8,1982,1990,9,28,USA
John Joseph,1959-02-10,4,1983,1987,2,10,USA
William Allen,1894-05-26,0,1916,1916,5,26,USA
Joel D.,1956-08-20,0,1979,1979,8,20,USA
Thomas Morgan,1914-10-10,3,1947,1950,10,10,USA
Roland Glen,1946-08-25,17,1968,1985,8,25,USA
James Leroy,1928-08-19,5,1954,1959,8,19,USA
Herman Adam,1911-08-22,2,1935,1937,8,22,USA
Pembroke,1888-07-31,1,1908,1909,7,31,USA
William James,1863-10-04,0,1886,1886,10,4,USA
Robert Edward,1915-11-25,1,1943,1944,11,25,USA
Charles Edward,1962-11-26,16,1986,2002,11,26,USA
Steven Allen,1965-03-12,18,1989,2007,3,12,USA
Brandon Kyle,1993-04-14,4,2014,2018,4,14,USA
Joseph Ignatius,1890-10-29,6,1912,1918,10,29,USA
Harold Wilson,1905-07-30,5,1931,1936,7,30,USA
Louis Klopsche,1910-08-13,16,1931,1947,8,13,USA
Cornelius Francis,1904-01-24,3,1930,1933,1,24,USA
Anders Gar,1968-03-11,0,1994,1994,3,11,USA
Jeffrey Philip,1983-04-14,4,2005,2009,4,14,USA
Michael Gary Joseph,1944-10-11,4,1968,1972,10,11,USA
Anthony James,1971-10-12,3,2000,2003,10,12,USA
Stephen John,1957-06-06,11,1981,1992,6,6,USA
Daniel Michael,1956-10-16,7,1981,1988,10,16,USA
John E.,1855-05-06,0,1884,1884,5,6,USA
William Charles,1930-10-11,8,1956,1964,10,11,USA
Charles William,1905-11-05,7,1930,1937,11,5,USA
Henry William,1940-01-11,5,1962,1967,1,11,USA
Jeffrey Thomas,1963-08-17,2,1987,1989,8,17,USA
Michael Thomas,1955-09-13,10,1977,1987,9,13,USA
Reuben Walter,1916-09-19,5,1941,1946,9,19,USA
Todd Richard,1960-09-15,0,1986,1986,9,15,USA
William Charles,1891-03-02,4,1913,1917,3,2,USA
Samuel E.,1893-05-15,0,1919,1919,5,15,USA
John,1856-08-15,1,1884,1885,8,15,USA
Robert Taylor,1886-11-03,7,1912,1919,11,3,USA
Brian Kevin,1962-03-18,7,1985,1992,3,18,USA
Charles Edward,1983-02-22,2,2009,2011,2,22,USA
Charles G.,1852-03-10,0,1884,1884,3,10,USA
Chauncey Burr,1872-01-08,8,1893,1901,1,8,USA
Clarence Henry,1898-08-27,1,1919,1920,8,27,USA
Derek Joseph,1993-08-21,2,2017,2019,8,21,USA
Donald Raymond,1916-02-06,0,1945,1945,2,6,USA
Edward Fredrick,1876-10-31,0,1902,1902,10,31,USA
Eddie Gene,1936-07-16,14,1959,1973,7,16,USA
Frederick Brown,1941-11-28,0,1964,1964,11,28,USA
George Cresse,1855-08-20,0,1884,1884,8,20,USA
August Harris,1885-10-21,1,1911,1912,10,21,USA
Harry Devereaux,1926-01-03,1,1951,1952,1,3,CAN
John Howard,1939-03-04,10,1959,1969,3,4,USA
John Alan,1962-11-08,0,1988,1988,11,8,USA
Leo,1877-12-13,0,1899,1899,12,13,USA
Maurice Wayne,1931-02-16,0,1955,1955,2,16,USA
Isaac Newton,1871-06-28,0,1898,1898,6,28,USA
Ray Lyle,1887-10-04,10,1910,1920,10,4,USA
John Gustave,1887-06-22,0,1910,1910,6,22,USA
George Aloys,1899-01-16,9,1923,1932,1,16,USA
Thomas Chalmers,1880-11-01,0,1904,1904,11,1,USA
Thomas Gene,1942-04-04,0,1967,1967,4,4,USA
Wilbur McCullough,1894-07-18,0,1916,1916,7,18,USA
Carlton Ernest,1947-12-26,24,1969,1993,12,26,USA
Maximilian Patrick,1888-10-12,0,1914,1914,10,12,USA
Weston Dickson,1843-07-06,5,1871,1876,7,6,USA
Douglas Wildes,1984-02-04,9,2009,2018,2,4,USA
Paul Clarence,1887-10-10,3,1914,1917,10,10,USA
Charles Caspar,1904-02-13,0,1928,1928,2,13,USA
Brian Michael,1974-12-26,0,2002,2002,12,26,USA
Edward Raymond,1924-05-21,11,1948,1959,5,21,USA
Howard Chumney,1902-05-16,4,1922,1926,5,16,USA
John H.,1870-05-30,0,1891,1891,5,30,USA
John Francis,1933-09-15,0,1958,1958,9,15,USA
Matthew William,1880-08-31,1,1906,1907,8,31,USA
Justin Howard,1891-06-26,7,1911,1918,6,26,USA
Michael Roy,1960-07-13,9,1983,1992,7,13,USA
Michael Patrick,1964-03-28,0,1988,1988,3,28,USA
Raymond Francis,1904-12-05,0,1931,1931,12,5,USA
Robert Paul,1900-07-30,0,1924,1924,7,30,USA
Alan James,1946-03-21,9,1969,1978,3,21,USA
Shaun Earle,1942-08-25,0,1966,1966,8,25,USA
Edward Henry,1889-12-09,2,1915,1917,12,9,USA
Fred Landis,1901-07-28,18,1925,1943,7,28,USA
Thomas William,1890-04-06,0,1919,1919,4,6,USA
Max John,1890-02-05,11,1914,1925,2,5,USA
Walter Leonard,1921-11-03,0,1945,1945,11,3,USA
Ira James,1893-09-22,13,1917,1930,9,22,USA
Jack Rafe,1995-10-15,2,2017,2019,10,15,USA
John Timothy,1967-10-21,13,1992,2005,10,21,USA
Martin John,1853-09-24,0,1881,1881,9,24,USA
Patrick Henry,1866-01-31,0,1894,1894,1,31,USA
Patrick Joseph,1876-06-29,12,1899,1911,6,29,USA
Ryan Edward,1986-07-27,7,2012,2019,7,27,USA
Albert Dell,1916-07-24,0,1941,1941,7,24,USA
Charles James,1891-12-31,0,1913,1913,12,31,USA
Edward F.,1861-09-15,2,1887,1889,9,15,USA
Michael Kendall,1951-12-16,17,1975,1992,12,16,USA
James Paul,1881-04-20,0,1905,1905,4,20,USA
Yohan Carlos,1986-01-27,2,2014,2016,1,27,D.R.
Raymond Arthur,1923-01-08,0,1946,1946,1,8,USA
Thomas Anthony,1934-09-06,4,1954,1958,9,6,USA
John Michael,1957-01-25,0,1977,1977,1,25,USA
Timothy Earl,1957-09-29,10,1979,1989,9,29,USA
Raymond Harold,1901-10-31,0,1927,1927,10,31,USA
John William,1883-09-22,0,1908,1908,9,22,USA
John Thomas,1942-05-07,0,1964,1964,5,7,USA
Angel Felix,1914-11-10,0,1948,1948,11,10,Cuba
Leslie Fletcherd,1913-07-31,6,1940,1946,7,31,USA
David Anthony,1969-11-07,4,1991,1995,11,7,USA
Leslie Harvey,1915-08-07,10,1939,1949,8,7,USA
Thomas Vincent,1873-11-20,5,1899,1904,11,20,USA
Gregory Alan,1969-02-25,4,1993,1997,2,25,USA
Arthur,1885-01-05,13,1909,1922,1,5,USA
Darrin Glen,1966-10-03,13,1989,2002,10,3,USA
David Owen,1994-05-31,1,2018,2019,5,31,USA
Elburt Preston,1916-03-18,15,1934,1949,3,18,USA
Oliver Frank,1891-03-06,0,1914,1914,3,6,USA
George Horace Elliot,1845-04-21,0,1872,1872,4,21,USA
Edward Paul,1967-01-14,3,1993,1996,1,14,USA
Samuel Scott,1881-02-21,3,1909,1912,2,21,USA
Scott Brian,1958-07-30,14,1981,1995,7,30,USA
Thomas Wayne,1942-06-28,0,1962,1962,6,28,USA
Alfred Vanoide,1924-08-06,0,1955,1955,8,6,USA
Christopher John,1994-07-01,2,2017,2019,7,1,USA
Elmer Harrison,1876-01-11,12,1898,1910,1,11,USA
Lewis Miller,1915-02-18,1,1943,1944,2,18,USA
Don Raphael,1892-11-17,0,1917,1917,11,17,USA
John Richard,1954-09-02,4,1978,1982,9,2,USA
Frank Sylvester,1855-08-03,14,1875,1889,8,3,USA
Hildreth Milton,1923-08-21,0,1942,1942,8,21,USA
Moritz Herman,1911-08-15,0,1934,1934,8,15,USA
Curtis Charles,1938-01-18,15,1956,1971,1,18,USA
Timothy Andrew,1877-03-13,4,1899,1903,3,13,USA
Kevin Scot,1969-06-10,4,1991,1995,6,10,USA
Donald Emery,1967-03-16,0,1995,1995,3,16,USA
Gilberto,1952-10-27,2,1977,1979,10,27,P.R.
Jesse Sandoval,1914-11-02,8,1942,1950,11,2,Mexico
Jesus Miguel,1984-10-26,5,2007,2012,10,26,Venezuela
Jose Carlos,1973-06-28,2,2002,2004,6,28,USA
Kendry,1991-11-24,1,2015,2016,11,24,D.R.
Paul Robert,1900-04-22,0,1926,1926,4,22,USA
Randy Alan,1975-07-31,8,2002,2010,7,31,USA
Ramon,1992-03-26,2,2015,2017,3,26,Venezuela
Ronald Joel,1979-08-09,2,2005,2007,8,9,USA
Wilmer Alejandro,1991-08-06,6,2013,2019,8,6,Venezuela
Bryce Bettencourt,1970-05-21,7,1994,2001,5,21,USA
Pedro Alexander,1986-12-10,7,2011,2018,12,10,D.R.
Dylan Lee,1990-12-27,3,2016,2019,12,27,USA
Bennett,1927-06-15,5,1951,1956,6,15,USA
D'Arcy Raymond,1902-03-16,11,1923,1934,3,16,USA
Cole Tyler,1986-01-24,10,2009,2019,1,24,USA
Charles Wesley,1913-08-13,4,1940,1944,8,13,USA
Robert Nathan,1943-10-20,6,1968,1974,10,20,USA
Leslie Roe,1917-06-23,0,1944,1944,6,23,USA
Cornelius Clifford,1972-12-05,16,1993,2009,12,5,USA
Gavin Christopher,1983-01-27,12,2004,2016,1,27,USA
John Lester,1894-01-03,0,1915,1915,1,3,USA
Brian A.,1990-04-19,6,2013,2019,4,19,USA
Cornelius Francis Xavier,1875-01-23,2,1894,1896,1,23,USA
William,1849-04-29,1,1871,1872,4,29,USA
Robert Douglas,1951-04-18,10,1975,1985,4,18,USA
Edward J.,1864-06-25,0,1887,1887,6,25,USA
George Albert,1871-05-24,0,1896,1896,5,24,USA
Joseph Nicholas,1861-12-29,0,1884,1884,12,29,USA
John A.,1864-06-30,1,1886,1887,6,30,USA
John Anthony,1883-09-07,2,1910,1912,9,7,USA
Michael J.,1872-03-15,0,1891,1891,3,15,Ireland
Stuart McGuire,1911-12-05,0,1936,1936,12,5,USA
Gene Arlan,1931-07-09,0,1958,1958,7,9,USA
James G.,1864-02-12,6,1884,1890,2,12,USA
John J.,1864-05-24,0,1885,1885,5,24,USA
Horace S.,1861-03-02,NA,NA,NA,3,2,USA
Joshua Smith,1976-12-13,8,2001,2009,12,13,USA
Leo Alexander,1876-11-28,1,1902,1903,11,28,USA
Henry Lee,1929-06-10,11,1953,1964,6,10,USA
Charles Joseph,1856-01-14,4,1879,1883,1,14,Ireland
John J.,1857-10-25,0,1885,1885,10,25,USA
Marvis Edwin,1953-08-29,6,1978,1984,8,29,USA
Raymond Kirwin,1906-06-23,0,1928,1928,6,23,USA
Thomas Michael,1959-09-09,12,1983,1995,9,9,USA
William Brown,1855-11-15,9,1875,1884,11,15,USA
Timothy John,1950-12-06,15,1970,1985,12,6,USA
Richard Nevin,1946-10-17,7,1970,1977,10,17,USA
Michael Gary,1991-10-07,5,2014,2019,10,7,USA
Dee Virgil,1924-10-31,7,1951,1958,10,31,USA
Lewis Albert,1899-01-21,12,1921,1933,1,21,USA
Nolan David,1991-06-06,1,2017,2018,6,6,USA
Joseph Daniel,1977-03-20,0,1998,1998,3,20,USA
Michael Eugene,1980-06-09,7,2005,2012,6,9,USA
Silton Ray,1957-08-08,3,1983,1986,8,8,USA
Wilmer,1990-05-24,7,2012,2019,5,24,Venezuela
Chad Everette,1971-03-05,4,1995,1999,3,5,USA
James Emerson,1949-01-13,2,1971,1973,1,13,USA
Barry Clifton,1952-02-16,9,1973,1982,2,16,USA
Jesse William,1980-07-10,2,2003,2005,7,10,USA
Patrick Joseph,1967-09-22,3,1998,2001,9,22,USA
David W.,1849-07-27,15,1871,1886,7,27,USA
Benjamin Cooper,1975-08-15,6,1998,2004,8,15,USA
William Brown,1915-10-14,0,1936,1936,10,14,USA
Curtis Glenn,1960-10-11,5,1985,1990,10,11,USA
Darnell Glenn,1952-05-19,10,1975,1985,5,19,USA
David Alan,1956-12-29,3,1978,1981,12,29,USA
Darren Scott,1985-10-01,1,2010,2011,10,1,USA
Edgar Lee,1862-04-10,0,1884,1884,4,10,USA
Eugene Wyman,1881-04-16,0,1905,1905,4,16,CAN
Eugene Matthew,1912-06-23,2,1936,1938,6,23,USA
Horace Hills,1897-07-23,14,1919,1933,7,23,USA
Thomas James,1974-02-20,1,1997,1998,2,20,USA
Jon Lewis,1976-08-12,9,2003,2012,8,12,USA
Matthew Lee,1981-04-08,0,2003,2003,4,8,USA
Michael,1992-07-04,0,2019,2019,7,4,USA
Russell William,1883-04-25,6,1909,1915,4,25,CAN
Theodore Henry,1947-02-07,3,1970,1973,2,7,USA
Percival Edmund Wentworth,1946-11-25,0,1973,1973,11,25,Bahamas
Edward Charles,1928-10-21,17,1950,1967,10,21,USA
Brook Alexander,1970-05-07,9,1995,2004,5,7,USA
John Davis,1874-08-06,1,1895,1896,8,6,USA
Francis Isaiah,1863-05-01,18,1884,1902,5,1,USA
August G.,1897-07-20,2,1924,1926,7,20,USA
William Orange,1886-10-10,1,1909,1910,10,10,USA
Eric Anthony,1988-01-02,0,2014,2014,1,2,USA
Jose Miguel,1932-01-18,11,1952,1963,1,18,Cuba
Robert Herbert,1950-01-13,15,1974,1989,1,13,USA
Kenneth Roth,1946-09-08,16,1970,1986,9,8,USA
Scott Christian,1971-10-27,0,2000,2000,10,27,USA
Terry Jay,1952-01-14,15,1971,1986,1,14,USA
Thomas W.,1859-05-01,4,1882,1886,5,1,USA
Edward James,1887-04-30,0,1915,1915,4,30,USA
John Logan,1987-01-14,8,2011,2019,1,14,USA
Bartolome,1974-08-24,2,2004,2006,8,24,D.R.
Garrett Reese,1894-10-11,4,1916,1920,10,11,USA
Timothy Shawn,1962-04-11,3,1992,1995,4,11,USA
Gerald Eugene,1940-09-21,1,1964,1965,9,21,USA
Emilio Antonio,1957-09-23,11,1988,1999,9,23,Cuba
Raymond Earl,1947-04-04,12,1967,1979,4,4,USA
George Dueward,1897-06-13,0,1921,1921,6,13,USA
Larry Curtis,1936-04-18,1,1961,1962,4,18,USA
Casey Paul,1978-01-06,8,2001,2009,1,6,USA
Alan Benton,1946-12-08,9,1967,1976,12,8,USA
William Hendrick,1904-06-12,NA,NA,NA,6,12,USA
Edward Lee,1885-06-25,0,1908,1908,6,25,USA
Edward Cunningham,1887-02-13,13,1910,1923,2,13,USA
Elmer Ellsworth,1861-08-15,5,1886,1891,8,15,USA
George Arthur,1948-12-01,17,1969,1986,12,1,USA
John Norman,1978-05-17,3,2002,2005,5,17,USA
Kevin Christopher,1969-01-13,8,1993,2001,1,13,USA
John Kristian,1974-08-30,0,2001,2001,8,30,USA
Larry Lynn,1937-12-24,0,1963,1963,12,24,USA
Leonard Norris,1951-02-02,6,1971,1977,2,2,USA
Clarence Francis,1878-04-08,3,1898,1901,4,8,USA
Roy,1945-07-29,2,1970,1972,7,29,USA
Robert G.,1856-10-06,0,1884,1884,10,6,USA
George,1888-01-05,4,1913,1917,1,5,USA
Andrew Bishop,1879-09-17,NA,NA,NA,9,17,USA
Steven Eugene,1966-08-16,2,1991,1993,8,16,USA
Robert Roy,1897-08-16,11,1922,1933,8,16,USA
Steven Raymond,1949-10-03,5,1973,1978,10,3,USA
Keith Charles,1972-10-19,11,1997,2008,10,19,USA
Julius Henry,1865-08-08,0,1894,1894,8,8,USA
John Frank,1889-09-28,15,1912,1927,9,28,USA
David Luther,1856-09-07,12,1884,1896,9,7,USA
Frank Hayes,1877-04-08,0,1901,1901,4,8,USA
John Arthur,1922-07-03,10,1954,1964,7,3,USA
Joseph Chester,1900-11-11,3,1923,1926,11,11,USA
William Dexter,1986-03-22,11,2008,2019,3,22,USA
Richard John,1921-03-30,11,1941,1952,3,30,CAN
Dustin Ryan,1994-12-29,1,2017,2018,12,29,USA
Jesse Peter,1898-10-30,0,1924,1924,10,30,USA
Alan Kim,1958-08-08,3,1982,1985,8,8,USA
Andrew Junipero,1971-01-12,8,1996,2004,1,12,USA
William Henry,1872-01-15,4,1897,1901,1,15,USA
Charles Francis,1921-10-07,0,1942,1942,10,7,USA
Chad Douglas,1970-09-03,12,1997,2009,9,3,USA
William Aloysius,1879-05-31,3,1908,1911,5,31,USA
Eric Hollis,1963-08-15,3,1992,1995,8,15,USA
Jacob,1878-09-26,0,1902,1902,9,26,USA
Howard Francis,1921-03-01,10,1944,1954,3,1,USA
John T.,1880-07-26,0,1908,1908,7,26,USA
Jacob Quirin,1982-07-20,4,2007,2011,7,20,USA
John Joseph,1859-02-07,5,1881,1886,2,7,USA
Matthew Jacob,1982-12-04,0,2010,2010,12,4,USA
Jacob Nelson,1927-12-25,18,1947,1965,12,25,USA
George Bennerd,1868-12-01,8,1891,1899,12,1,USA
Ervin,1909-03-08,12,1933,1945,3,8,USA
Terrence Edward,1935-07-31,6,1960,1966,7,31,USA
James Emory,1907-10-22,20,1925,1945,10,22,USA
Joseph Anthony,1943-02-21,5,1966,1971,2,21,USA
Paul Eugene,1930-11-16,11,1953,1964,11,16,USA
Kenneth Douglas,1948-01-19,4,1972,1976,1,19,USA
Jake Arnold,1995-05-25,0,2019,2019,5,25,USA
Louis Benjamin,1981-10-23,6,2007,2013,10,23,USA
Earl Coleman,1935-07-14,5,1960,1965,7,14,USA
Enderson Daniel,1992-12-29,0,2019,2019,12,29,Venezuela
Franklin,1979-09-11,10,2004,2014,9,11,D.R.
Jeffrey William,1981-01-08,11,2004,2015,1,8,CAN
Jeffrey Braden,1984-01-08,11,2005,2016,1,8,USA
John Anthony,1960-09-17,21,1984,2005,9,17,USA
Julio Cesar,1958-08-23,25,1982,2007,8,23,D.R.
Juan Ramon,1987-06-24,5,2009,2014,6,24,D.R.
Matthew Neil,1969-08-19,8,1995,2003,8,19,USA
Maikel Antonio,1992-08-26,5,2014,2019,8,26,D.R.
Osman Beverly,1858-10-04,0,1890,1890,10,4,USA
Ray James,1893-03-08,3,1922,1925,3,8,USA
Terry Jon,1959-04-22,9,1981,1990,4,22,USA
John Patsy,1933-11-04,14,1956,1970,11,4,USA
Tyler Lawrence,1994-07-13,0,2019,2019,7,13,USA
Kevin Vincent,1982-05-24,9,2006,2015,5,24,USA
Charles,1870-05-30,1,1893,1894,5,30,USA
John Frederick,1873-03-11,0,1898,1898,3,11,USA
Frederick Meloy,1904-04-09,12,1927,1939,4,9,USA
Herman Louis,1914-01-04,10,1939,1949,1,4,USA
Jack Wilford,1919-10-20,0,1944,1944,10,20,USA
John William,1953-03-16,0,1971,1971,3,16,USA
Micah Ishanti,1972-04-25,0,1997,1997,4,25,USA
Stephen Michael,1974-01-14,0,1998,1998,1,14,USA
Murray Asher,1914-04-01,1,1941,1942,4,1,USA
Nicholas Edward,1991-03-02,5,2013,2018,3,2,USA
Ryan Ray,1973-03-05,12,1999,2011,3,5,USA
James Seth,1988-08-27,0,2017,2017,8,27,USA
Gary Wayne,1974-03-09,6,2000,2006,3,9,USA
Caleb Michael,1993-07-08,1,2018,2019,7,8,USA
John Vincent,1970-02-04,7,1994,2001,2,4,USA
Charles Carrolton,1873-08-26,13,1896,1909,8,26,USA
William Patrick,1964-05-26,9,1986,1995,5,26,USA
Victor Patrick,1904-08-05,8,1931,1939,8,5,USA
Jason Andrew,1977-08-09,11,2004,2015,8,9,USA
George K.,1861-01-07,NA,NA,NA,1,7,NA
Adam Timothy,1991-12-14,3,2016,2019,12,14,USA
Clint Jackson,1994-09-06,2,2017,2019,9,6,USA
George Allen,1954-10-13,9,1978,1987,10,13,USA
Jeffrey Michael,1982-08-10,0,2010,2010,8,10,USA
Joseph Filmore,1922-10-06,9,1947,1956,10,6,USA
Arthur Louis,1965-01-26,5,1993,1998,1,26,USA
Todd Brian,1986-02-12,8,2011,2019,2,12,USA
John Henry,1902-01-26,5,1929,1934,1,26,USA
Kevin Albert Francis,1976-11-04,2,2002,2004,11,4,USA
Scott Eric,1967-08-19,0,1993,1993,8,19,USA
Edwin Charles,1919-08-22,0,1942,1942,8,22,USA
Roger Vernon,1946-06-02,9,1970,1979,6,2,USA
William Ashley,1941-11-29,15,1961,1976,11,29,USA
Kyle Richard,1993-05-14,2,2017,2019,5,14,USA
Ryan Paul,1976-03-08,8,2001,2009,3,8,USA
John Frank,1871-10-30,16,1891,1907,10,30,USA
Alexander Vernon,1896-07-05,1,1921,1922,7,5,USA
Raphael,1979-10-20,2,2004,2006,10,20,USA
Frederick Charles,1989-09-12,9,2010,2019,9,12,USA
Harvey Bayard,1897-12-22,0,1921,1921,12,22,USA
Hershell Baskin,1928-07-01,6,1952,1958,7,1,USA
Frank Ellsworth,1879-12-26,1,1908,1909,12,26,USA
Jimmy Lee,1951-06-29,1,1972,1973,6,29,USA
John Edward,1901-01-24,0,1927,1927,1,24,USA
Julius Benjamin,1868-11-07,0,1888,1888,11,7,USA
Justin Michael,1986-10-22,0,2013,2013,10,22,USA
LaVel Maurice,1963-02-18,0,1989,1989,2,18,USA
Mark Price,1930-12-07,1,1959,1960,12,7,USA
Marvin,1963-04-10,10,1986,1996,4,10,USA
Michael Barrett,1987-08-04,3,2016,2019,8,4,USA
Samuel Douglas,1987-06-24,7,2012,2019,6,24,USA
David Richard,1983-04-28,10,2009,2019,4,28,USA
George Walter,1926-09-12,8,1953,1961,9,12,USA
Eugene Lewis,1934-01-08,11,1955,1966,1,8,USA
Carl Alexander,1900-04-25,0,1925,1925,4,25,USA
James Louis,1942-04-04,17,1961,1978,4,4,USA
Vern Donald,1923-12-19,0,1941,1941,12,19,USA
Howard Earl,1902-08-01,6,1922,1928,8,1,USA
Nathan Samuel,1986-12-31,1,2013,2014,12,31,USA
Alejandro,1974-08-23,0,2005,2005,8,23,Venezuela
David James,1951-10-31,5,1974,1979,10,31,USA
David Joseph,1989-03-18,2,2017,2019,3,18,USA
Antonio,1908-05-05,4,1932,1936,5,5,USA
Charles Calvin,1883-10-12,1,1909,1910,10,12,USA
Richard James,1941-08-13,6,1965,1971,8,13,USA
Lawrence Herbert,1907-11-01,13,1929,1942,11,1,USA
Lucas Stephen,1985-09-13,1,2009,2010,9,13,USA
Frank Alexander,1893-09-22,0,1917,1917,9,22,USA
Raymond Edward,1895-01-09,4,1920,1924,1,9,USA
Walter Edward,1899-07-12,6,1923,1929,7,12,USA
Benjamin Rudolph,1906-04-06,7,1929,1936,4,6,USA
James Gottfried,1931-05-26,NA,NA,NA,5,26,USA
Linus Reinhard,1910-08-23,15,1933,1948,8,23,USA
Steven Francis,1963-07-29,7,1989,1996,7,29,USA
Carlos David,1989-11-13,2,2014,2016,11,13,D.R.
Hanley,1973-12-05,3,1997,2000,12,5,D.R.
Jesus Maria,1948-07-14,8,1973,1981,7,14,D.R.
Bernard Albert,1899-08-18,14,1919,1933,8,18,USA
Marion John,1923-07-15,3,1952,1955,7,15,USA
Ford Christopher,1894-12-19,NA,NA,NA,12,19,USA
Grier William,1897-10-26,0,1923,1923,10,26,USA
James Riley,1924-09-06,6,1952,1958,9,6,USA
Robert George,1906-08-30,0,1932,1932,8,30,USA
Christian Louis Patrick,1987-07-08,4,2012,2016,7,8,USA
Arthur Edwin,1897-07-23,0,1920,1920,7,23,USA
Max Dorian,1994-01-18,2,2017,2019,1,18,USA
William Edward,1876-04-01,2,1901,1903,4,1,USA
Patrick Henry,1858-06-11,1,1890,1891,6,11,USA
Robert Bartmess,1930-11-24,15,1951,1966,11,24,USA
Daniel Sebastian,1873-04-18,3,1895,1898,4,18,USA
Lawrence Joseph,1875-07-05,0,1896,1896,7,5,USA
Owen Lacey,1927-03-21,7,1949,1956,3,21,USA
Robert Lawrence,1917-07-29,0,1941,1941,7,29,USA
Ernesto,1985-07-19,8,2009,2017,7,19,Colombia
Peter Martin,1857-10-30,1,1883,1884,10,30,USA
John Edmond,1879-04-03,2,1910,1912,4,3,USA
Frederick Ferdinand,1911-08-25,0,1934,1934,8,25,USA
Charles Augustus,1874-02-02,1,1899,1900,2,2,USA
Frank Francis,1897-09-09,18,1919,1937,9,9,USA
Daniel Vincent,1946-03-04,9,1967,1976,3,4,USA
John Emil,1874-10-15,8,1899,1907,10,15,USA
Charles Cornelius,1882-06-13,0,1907,1907,6,13,USA
Harry Koch,1890-09-30,2,1913,1915,9,30,USA
Laurence Joseph,1949-02-14,0,1975,1975,2,14,USA
William John,1930-10-20,0,1955,1955,10,20,USA
Douglas Steven,1959-06-06,5,1982,1987,6,6,CAN
Samuel William,1882-12-23,4,1907,1911,12,23,USA
Albert George,1885-01-02,0,1909,1909,1,2,USA
Todd Gerard,1962-09-28,9,1987,1996,9,28,USA
Arthur Henry,1883-09-03,9,1906,1915,9,3,USA
Carl David,1952-11-17,5,1977,1982,11,17,USA
Emiliano Ricardo,1984-06-06,0,2006,2006,6,6,Colombia
Charlie Andrew,1913-07-17,0,1940,1940,7,17,USA
Jeffrey Dustin,1966-08-31,9,1992,2001,8,31,USA
Eric Joseph,1985-08-26,6,2011,2017,8,26,USA
Jace Hayden,1993-07-09,2,2017,2019,7,9,USA
Jerry Ray,1956-02-29,0,1978,1978,2,29,USA
Johnson,1901-11-21,0,1923,1923,11,21,USA
David Travis,1969-03-25,12,1990,2002,3,25,USA
Woodrow Thompson,1940-04-12,17,1966,1983,4,12,USA
Paul Raymond,1992-07-26,1,2018,2019,7,26,USA
Charles Thomas,1913-11-18,2,1942,1944,11,18,USA
Emil Edwin,1878-04-17,NA,NA,NA,4,17,Germany
Brian Christopher,1975-08-09,11,2001,2012,8,9,USA
Josh,1993-02-19,0,2019,2019,2,19,USA
Miguel,1946-05-10,0,1969,1969,5,10,P.R.
Michael Jay,1958-06-11,1,1983,1984,6,11,USA
Reymond Louis,1991-02-12,4,2013,2017,2,12,USA
Rigoberto,1944-01-04,13,1965,1978,1,4,Cuba
Alfred George,1896-07-20,0,1922,1922,7,20,USA
Oscar Lawrence,1893-08-22,4,1921,1925,8,22,USA
Kyuji,1980-07-21,2,2013,2015,7,21,Japan
Kosuke,1977-04-26,4,2008,2012,4,26,Japan
Kazuo,1976-08-04,0,2008,2008,8,4,Japan
Jeffrey Joseph,1979-11-26,5,2006,2011,11,26,USA
Samuel Babson,1981-11-20,8,2007,2015,11,20,USA
James Lavoisier,1900-07-04,0,1921,1921,7,4,USA
John Thomas,1956-06-09,1,1979,1980,6,9,USA
Curtis Hooper,1898-09-13,12,1921,1933,9,13,USA
Edward Aston White,1869-03-22,0,1886,1886,3,22,USA
Frank Edward,1894-01-01,8,1915,1923,1,1,USA
Henry W.,1862-12-05,0,1891,1891,12,5,USA
James Hardy,1950-11-28,4,1973,1977,11,28,USA
John Edward,1950-01-29,0,1974,1974,1,29,USA
Charles F.,1878-03-30,0,1902,1902,3,30,USA
William Benjamin,1867-10-10,8,1888,1896,10,10,USA
Vernon Gordon,1944-03-01,6,1964,1970,3,1,USA
Charles Philip,1901-02-27,8,1928,1936,2,27,USA
Bradley Ryan,1975-01-17,7,1997,2004,1,17,USA
Carson Springer,1993-12-13,3,2016,2019,12,13,USA
Charles John,1851-02-13,13,1871,1884,2,13,USA
Christopher,1858-07-04,5,1884,1889,7,4,USA
Michael Joseph,1993-03-15,2,2016,2018,3,15,USA
Washington Fayette,1840-06-15,0,1875,1875,6,15,USA
William David,1963-10-22,0,1987,1987,10,22,USA
Richard Aaron,1973-09-04,7,2000,2007,9,4,USA
David Lewis,1875-05-29,7,1898,1905,5,29,USA
Mark Clifford,1957-05-16,4,1981,1985,5,16,USA
Franklin Ray,1935-08-30,3,1960,1963,8,30,USA
Elias Calvin,1904-10-28,4,1929,1933,10,28,USA
Thomas James,1962-03-13,0,1986,1986,3,13,USA
Charles Roderick,1986-04-11,4,2011,2015,4,11,USA
Rafael,1977-10-24,14,2000,2014,10,24,D.R.
Carl Anthony,1922-03-08,14,1946,1960,3,8,USA
Jason Joseph,1979-07-31,2,2005,2007,7,31,USA
Christopher Wren,1976-05-19,2,1998,2000,5,19,USA
Edward L.,1856-07-17,6,1882,1888,7,17,USA
Frederick Morris,1895-10-07,7,1922,1929,10,7,USA
Lester Leroy,1921-03-07,1,1952,1953,3,7,USA
Michael Edwin,1969-12-09,6,1996,2002,12,9,USA
Kason Ronald,1982-04-08,2,2006,2008,4,8,USA
Armando Leisdeker,1983-08-31,1,2009,2010,8,31,D.R.
Frank Harold,1911-11-06,3,1935,1938,11,6,USA
William Louis,1930-08-04,0,1958,1958,8,4,USA
John Richard,1930-10-02,2,1959,1961,10,2,USA
Kenneth Harlin,1919-01-31,2,1945,1947,1,31,USA
Leonard Hilbourne,1915-09-08,0,1939,1939,9,8,USA
Leonard Gary,1940-02-14,10,1960,1970,2,14,USA
John Wilson,1914-02-05,0,1938,1938,2,5,USA
Edward Carl,1925-06-08,0,1951,1951,6,8,USA
Gary Joseph,1958-08-19,19,1981,2000,8,19,USA
Brent Allen,1958-10-05,2,1982,1984,10,5,USA
Fabian Sebastian,1913-08-05,6,1936,1942,8,5,USA
John H.,1855-06-29,NA,NA,NA,6,29,USA
Philip Joseph,1941-12-27,11,1963,1974,12,27,USA
Ralph Michael,1946-10-08,0,1965,1965,10,8,USA
Eric Serge,1976-01-07,9,1999,2008,1,7,CAN
Gregory Carpenter,1961-11-12,14,1983,1997,11,12,USA
John Edward,1883-04-16,1,1914,1915,4,16,USA
Harold Dennis,1897-09-27,2,1922,1924,9,27,USA
Andrew Miles,1990-06-26,1,2018,2019,6,26,USA
Charles Frederick,1862-03-25,0,1884,1884,3,25,USA
Julian Edward,1970-08-13,2,1997,1999,8,13,USA
Dellas Clinton,1886-11-10,13,1909,1922,11,10,USA
Johnathan Keith,1966-10-08,0,1993,1993,10,8,USA
Arnesta Joe,1936-11-22,6,1960,1966,11,22,USA
Willard Roland,1897-12-23,0,1921,1921,12,23,USA
Telmanch,1960-12-25,2,1985,1987,12,25,USA
Frederick Jacob,1885-08-31,0,1908,1908,8,31,Germany
Stephen Robert,1969-12-30,0,1998,1998,12,30,USA
Daniel Michael,1964-05-01,0,1991,1991,5,1,USA
August John,1912-05-23,15,1934,1949,5,23,USA
Matthew Joseph,1944-03-22,NA,NA,NA,3,22,USA
Andres Jose,1961-06-18,19,1985,2004,6,18,Venezuela
Armando Antonio,1982-01-15,5,2007,2012,1,15,Venezuela
Robert Joseph,1952-01-13,4,1977,1981,1,13,USA
Milton,1907-05-04,6,1933,1939,5,4,USA
Dennis Ward,1911-12-07,15,1934,1949,12,7,USA
Richard Blackwell,1954-01-19,6,1978,1984,1,19,USA
Rocky Michael,1988-02-22,4,2015,2019,2,22,USA
Alan Mitchell Edward George Patrick Henry,1945-10-19,3,1970,1973,10,19,USA
Robert Collins,1947-07-07,3,1972,1975,7,7,USA
Cameron Joseph,1992-12-06,2,2017,2019,12,6,USA
David Thomas,1960-09-20,8,1987,1995,9,20,USA
Douglas Eugene,1940-02-21,0,1962,1962,2,21,USA
Edward Michael,1910-11-28,0,1932,1932,11,28,USA
Lawrence Kirby,1896-09-05,0,1922,1922,9,5,USA
John Laurence,1902-01-28,0,1923,1923,1,28,USA
John Carroll,1892-02-18,0,1915,1915,2,18,USA
Joseph Emmett,1914-03-07,1,1939,1940,3,7,USA
Sean Patrick,1985-12-30,3,2007,2010,12,30,USA
Charles William,1872-04-30,0,1901,1901,4,30,USA
William Howard,1874-02-04,0,1896,1896,2,4,USA
Yovani,1986-02-27,11,2007,2018,2,27,Mexico
Giovanny,1991-08-14,2,2017,2019,8,14,Mexico
Michael Anthony,1960-10-31,12,1985,1997,10,31,USA
Stanley Joseph,1919-02-07,0,1942,1942,2,7,USA
Zachary Peter,1995-08-03,0,2019,2019,8,3,USA
Melvin Allys,1891-10-14,8,1912,1920,10,14,USA
Philip Joseph,1907-05-29,3,1931,1934,5,29,USA
John Christopher,1978-04-02,2,2005,2007,4,2,USA
Clarence Edward,1896-08-04,9,1919,1928,8,4,USA
Isaac,1989-10-10,1,2018,2019,10,10,USA
James Cato,1887-09-16,0,1912,1912,9,16,USA
Joseph Nicholas,1993-11-19,4,2015,2019,11,19,USA
Michael Dwain,1977-04-02,3,2003,2006,4,2,USA
Balvino,1964-03-31,0,1986,1986,3,31,D.R.
Freddy Jose,1989-11-14,7,2012,2019,11,14,Venezuela
James Joseph,1907-08-11,0,1930,1930,8,11,USA
James Louis,1863-04-23,0,1884,1884,4,23,USA
James Francis,1856-12-25,17,1875,1892,12,25,USA
Robert,1866-02-06,0,1888,1888,2,6,USA
John Robert,1948-02-10,1,1972,1973,2,10,USA
Lee Jesse,1910-06-28,5,1935,1940,6,28,USA
Oscar Charles,1949-12-20,16,1969,1985,12,20,USA
Eduardo Avila,1984-12-21,0,2016,2016,12,21,USA
Benjamin Joseph,1992-05-17,3,2016,2019,5,17,USA
Mathew Lawrence,1985-07-26,4,2008,2012,7,26,USA
John Ashley,1876-03-17,0,1901,1901,3,17,USA
Gustavo,1971-07-19,0,2001,2001,7,19,USA
Arnold,1888-01-19,9,1910,1919,1,19,USA
Robert Brinkley,1893-08-25,0,1916,1916,8,25,USA
Robert Stephen,1875-04-23,4,1905,1909,4,23,USA
William Patrick,1873-03-17,0,1901,1901,3,17,USA
James Edward,1873-11-26,0,1895,1895,11,26,USA
Michael Joseph,1877-02-22,0,1898,1898,2,22,USA
Joseph Steven,1915-08-25,1,1939,1940,8,25,USA
John Michael,1992-08-06,3,2016,2019,8,6,USA
James Elmer,1953-01-05,16,1976,1992,1,5,USA
Ronald Edwin,1965-03-02,16,1987,2003,3,2,USA
Foster Pirie,1901-05-22,1,1927,1928,5,22,USA
Charles William,1862-06-18,13,1884,1897,6,18,USA
John Henry,1874-04-07,10,1898,1908,4,7,USA
Eddy Jorge,1976-12-02,0,2005,2005,12,2,D.R.
Joseph Henry,1926-02-12,8,1946,1954,2,12,USA
Keith John,1969-10-25,0,1994,1994,10,25,USA
Victor J.,1984-09-25,0,2009,2009,9,25,Venezuela
Robert Michael,1909-11-13,11,1934,1945,11,13,USA
Nathaniel Michael,1916-02-02,1,1944,1945,2,2,USA
Barbaro,1956-12-04,4,1984,1988,12,4,Cuba
Robert Mitchell,1928-09-10,0,1956,1956,9,10,USA
Henry Eugene,1947-11-13,19,1969,1988,11,13,USA
Alexander,1922-06-25,0,1952,1952,6,25,USA
Frank Yeury,1990-01-17,1,2014,2015,1,17,D.R.
Richard Aron,1971-05-18,12,1990,2002,5,18,Venezuela
Adonis,1985-04-12,2,2015,2017,4,12,Cuba
Jose Adolis,1993-03-02,0,2018,2018,3,2,Cuba
Amaury Miguel,1975-05-20,0,1999,1999,5,20,D.R.
Anderson,1981-03-23,0,2007,2007,3,23,D.R.
Aramis Michael,1993-01-12,1,2018,2019,1,12,USA
Avisail Antonio,1991-06-12,7,2012,2019,6,12,Venezuela
Bryan,1995-04-19,0,2019,2019,4,19,USA
Carlos Jesus,1967-10-15,9,1990,1999,10,15,Venezuela
Vinicio Otilio,1924-12-24,0,1954,1954,12,24,Mexico
Christian J.,1985-08-24,0,2012,2012,8,24,USA
Damaso Domingo,1957-02-07,11,1978,1989,2,7,D.R.
Daniel Raphael,1954-04-29,0,1981,1981,4,29,USA
Daniel Joseph,1980-04-12,1,2003,2004,4,12,USA
David,1920-09-15,NA,NA,NA,9,15,USA
Edgar Ernesto,1996-10-04,0,2019,2019,10,4,D.R.
Freddy Adrian,1972-08-01,4,1995,1999,8,1,D.R.
Freddy Antonio,1976-10-06,14,1999,2013,10,6,Venezuela
Greg Joseph,1989-08-08,5,2014,2019,8,8,USA
Guillermo Antonio,1972-04-04,1,1998,1999,4,4,D.R.
Harvey Anderson,1984-03-16,0,2007,2007,3,16,Venezuela
Santiago,1980-07-25,14,2004,2018,7,25,D.R.
Jaime Omar,1986-07-08,10,2008,2018,7,8,Mexico
Jason Emilio,1992-11-21,0,2015,2015,11,21,USA
Jarlin Emmanuel,1993-01-18,2,2017,2019,1,18,D.R.
Jesus Jesse,1973-09-24,6,1999,2005,9,24,USA
Jose Luis,1985-01-07,0,2006,2006,1,7,D.R.
Gustavo Karim,1975-10-29,9,1995,2004,10,29,Mexico
Alfonso Rafael,1953-10-14,9,1976,1985,10,14,USA
Leonardo Antonio,1962-11-06,1,1987,1988,11,6,D.R.
Leury,1991-03-18,6,2013,2019,3,18,D.R.
Luis Rafael,1975-05-20,0,1999,1999,5,20,D.R.
Luis Carlos,1975-09-22,0,2002,2002,9,22,Mexico
Luis Amado,1987-01-30,6,2013,2019,1,30,D.R.
Edward Miguel,1923-11-17,13,1948,1961,11,17,USA
Miguel Angel,1967-04-03,2,1987,1989,4,3,Venezuela
Michael R.,1968-05-11,1,1999,2000,5,11,USA
Anthony Nomar,1973-07-23,13,1996,2009,7,23,USA
Onelki,1989-08-02,4,2013,2017,8,2,Cuba
Pedro Modesto,1950-04-17,4,1973,1977,4,17,P.R.
Ramon,1924-03-05,0,1948,1948,3,5,Cuba
Ralph,1948-12-14,2,1972,1974,12,14,USA
Ramon Antonio,1969-02-09,6,1991,1997,2,9,Venezuela
Reynaldo,1974-04-15,1,2002,2003,4,15,D.R.
Joshua Rico,1994-01-10,0,2019,2019,1,10,USA
Rosman Jose,1979-01-03,1,2003,2004,1,3,Venezuela
Robel E.,1993-03-28,0,2019,2019,3,28,D.R.
Willy Camilo,1992-09-04,0,2017,2017,9,4,D.R.
Yimi,1990-08-18,5,2014,2019,8,18,D.R.
Alfred Stephen,1918-01-11,0,1945,1945,1,11,USA
Daniel Lewis,1920-02-26,6,1944,1950,2,26,USA
Nick,1993-08-15,1,2017,2018,8,15,USA
Ronald Clyde,1957-10-24,4,1981,1985,10,24,Germany
Arthur Cecil,1899-12-26,0,1923,1923,12,26,USA
Michael James,1965-10-19,5,1990,1995,10,19,CAN
Alexander,1861-04-28,0,1884,1884,4,28,CAN
Arthur Junior,1952-09-21,3,1975,1978,9,21,USA
William Frederick,1927-07-19,9,1954,1963,7,19,USA
Brett M.,1983-08-24,11,2008,2019,8,24,USA
Christopher John,1969-03-30,0,1991,1991,3,30,USA
Earle McClurkin,1884-01-24,4,1908,1912,1,24,USA
Franklin Washington,1859-05-06,9,1879,1888,5,6,USA
Miles Glenn,1916-01-25,0,1945,1945,1,25,USA
Harry Ray,1887-06-01,1,1911,1912,6,1,USA
Jeffrey Scott,1964-02-04,3,1991,1994,2,4,USA
James Andrew,1873-10-04,7,1895,1902,10,4,USA
William Lawrence,1886-05-13,16,1908,1924,5,13,USA
Terrence Lee,1975-01-16,6,2002,2008,1,16,USA
Mark Allan,1962-03-01,12,1989,2001,3,1,USA
Raymond Vincent,1901-10-25,1,1929,1930,10,25,USA
Richard Frank,1944-12-19,8,1965,1973,12,19,USA
Wesley Brian,1961-04-29,7,1984,1991,4,29,USA
William Milton,1867-10-26,1,1889,1890,10,26,USA
Arthur Edward,1907-08-21,0,1936,1936,8,21,USA
Robert Roy,1942-03-03,7,1962,1969,3,3,USA
Daniel,1973-02-14,0,2000,2000,2,14,Mexico
Ryan Francis,1981-01-02,5,2005,2010,1,2,USA
Jon Steven,1979-09-27,13,2000,2013,9,27,USA
Louis Lyman,1905-07-16,0,1931,1931,7,16,USA
Marcus Wayne,1950-10-26,8,1973,1981,10,26,USA
Kyle Bruce,1992-01-26,0,2019,2019,1,26,USA
Michael Douglas,1949-09-16,9,1969,1978,9,16,USA
Debs C.,1907-06-26,13,1932,1945,6,26,USA
Robert Cole,1984-12-15,0,2011,2011,12,15,USA
Dustin Thomas,1987-08-13,4,2015,2019,8,13,USA
Percival,1988-12-13,0,2016,2016,12,13,USA
Philip Mason,1949-04-30,15,1973,1988,4,30,USA
William,1877-07-28,0,1899,1899,7,28,USA
Henry Adrian,1943-01-03,10,1966,1976,1,3,USA
Amir Jamal,1992-05-03,2,2017,2019,5,3,USA
Clarence Raymond,1891-03-06,0,1915,1915,3,6,USA
Gregory,1947-03-12,1,1970,1971,3,12,USA
Reed,1993-01-02,0,2019,2019,1,2,USA
Scott William,1961-10-30,9,1982,1991,10,30,USA
Ronald Wayne,1947-12-03,9,1969,1978,12,3,USA
Virgil Cecil,1916-08-15,0,1946,1946,8,15,USA
Clifford William,1906-08-13,0,1928,1928,8,13,USA
Robert Ford,1915-08-29,3,1943,1946,8,29,USA
Gil Gonzalo,1941-06-26,8,1964,1972,6,26,Panama
Francis Joseph,1908-02-04,0,1931,1931,2,4,USA
Stevenson Nathaniel,1986-09-12,0,2011,2011,9,12,USA
Webster Leotis,1965-08-24,0,1996,1996,8,24,USA
Ralph Allen,1945-12-12,12,1968,1980,12,12,USA
James Thomas,1869-09-21,0,1893,1893,9,21,USA
Ryan Patrick,1989-12-05,3,2016,2019,12,5,USA
Mitchell Lyn,1991-01-15,2,2017,2019,1,15,USA
Ned Franklin,1925-12-25,13,1948,1961,12,25,USA
Steven Patrick,1948-12-22,18,1969,1987,12,22,USA
Theodore Jared,1955-10-21,5,1977,1982,10,21,USA
Virgil Lee,1874-01-01,8,1896,1904,1,1,USA
Matthew Scott,1983-11-26,11,2006,2017,11,26,USA
Harry Lambert,1883-04-28,3,1909,1912,4,28,USA
Rodney Earl,1946-04-03,5,1969,1974,4,3,USA
Charles Cason,1918-08-12,2,1944,1946,8,12,USA
David K.,1978-12-14,0,2005,2005,12,14,USA
Thomas Everett,1932-06-13,1,1955,1956,6,13,USA
Edward,1865-08-01,1,1884,1885,8,1,USA
John Walter,1989-02-16,0,2013,2013,2,16,USA
Alexander Nathaniel,1893-03-12,9,1920,1929,3,12,USA
Clarence Edwin,1944-03-17,11,1967,1978,3,17,USA
Nathaniel Milton,1896-01-27,10,1924,1934,1,27,USA
Welcome Thornburg,1874-12-19,1,1898,1899,12,19,USA
Henry Carl,1865-03-29,7,1889,1896,3,29,USA
Brent Robert,1970-03-14,6,1993,1999,3,14,USA
Joseph Daniel,1954-10-03,1,1978,1979,10,3,USA
Michael Grant,1956-09-20,1,1981,1982,9,20,USA
Aubrey Lee,1938-11-17,7,1963,1970,11,17,USA
Joey Renard,1981-04-27,7,2004,2011,4,27,USA
Frank Anthony,1871-03-06,3,1898,1901,3,6,USA
James Evan,1986-08-18,5,2013,2018,8,18,USA
John David,1985-04-28,0,2011,2011,4,28,USA
James Jennings,1955-06-03,1,1978,1979,6,3,USA
Chad Edward,1983-03-24,10,2003,2013,3,24,USA
Michael John,1869-08-04,0,1889,1889,8,4,USA
Kevin John,1991-01-06,6,2013,2019,1,6,USA
Walter Paul,1901-07-26,3,1925,1928,7,26,USA
Sidney Allen,1912-05-04,1,1936,1937,5,4,USA
Samuel Joseph,1990-05-22,2,2017,2019,5,22,USA
George Joseph,1892-03-13,0,1920,1920,3,13,USA
Michael,1895-10-13,5,1923,1928,10,13,USA
Dale Dudley,1872-02-02,5,1896,1901,2,2,USA
Lloyd William,1923-08-10,0,1947,1947,8,10,USA
Dennis John,1897-10-15,1,1923,1924,10,15,USA
Cory Nathanial,1986-04-14,8,2011,2019,4,14,USA
Robert Norton,1891-05-10,3,1918,1921,5,10,USA
Geoffrey Michael,1976-08-26,6,2003,2009,8,26,USA
Eugene Francis Joseph,1917-01-22,1,1942,1943,1,22,USA
Robert Henry,1943-01-03,3,1971,1974,1,3,USA
Peter,1923-08-10,0,1947,1947,8,10,USA
James Lee,1949-03-23,1,1972,1973,3,23,USA
Elmer John,1917-04-15,0,1939,1939,4,15,USA
Elmer Joseph,1893-12-05,7,1913,1920,12,5,USA
Richard Leo,1959-09-26,12,1980,1992,9,26,USA
Alfred W.,1849-05-06,3,1872,1875,5,6,USA
Dillon Kyle,1986-04-28,7,2010,2017,4,28,USA
John Alexander,1915-12-07,7,1939,1946,12,7,USA
Joshua Brent,1983-06-02,1,2008,2009,6,2,USA
Charles Leonard,1903-05-11,18,1924,1942,5,11,USA
Henry,1881-01-24,1,1907,1908,1,24,USA
Henry Louis,1903-06-19,16,1923,1939,6,19,USA
Paul Arthur,1912-05-03,0,1937,1937,5,3,USA
Philip Louis,1876-11-03,8,1896,1904,11,3,USA
Gary Merle,1937-04-04,12,1958,1970,4,4,USA
William J.,1858-07-15,2,1882,1884,7,15,USA
John David,1955-01-18,7,1978,1985,1,18,USA
Vernon William,1946-01-10,0,1969,1969,1,10,USA
Emil August,1865-03-20,0,1887,1887,3,20,USA
Charles Magnus,1906-01-26,11,1929,1940,1,26,USA
John Richard,1943-06-25,7,1964,1971,6,25,USA
Steven Andrew,1987-11-01,4,2012,2016,11,1,USA
Joseph Edward,1897-01-15,8,1922,1930,1,15,USA
C. Frank,1866-11-02,9,1892,1901,11,2,USA
Ryan Joseph,1990-05-01,6,2013,2019,5,1,USA
George Michael,1922-02-22,0,1950,1950,2,22,USA
James Edward,1934-06-03,9,1957,1966,6,3,USA
Samuel Christopher,1916-10-12,0,1943,1943,10,12,USA
Craig Alan,1983-11-29,9,2009,2018,11,29,USA
Gary Edward,1946-10-06,6,1969,1975,10,6,USA
Harvey William,1926-05-27,0,1954,1954,5,27,USA
James Ruffus,1918-05-18,5,1943,1948,5,18,USA
Alex Thomas M.,1938-09-27,0,1955,1955,9,27,USA
William,1865-01-27,2,1887,1889,1,27,USA
Christopher Sean,1966-09-24,0,1991,1991,9,24,USA
Christopher Coleman,1979-09-16,3,2001,2004,9,16,USA
Charles Peter,1912-12-25,10,1935,1945,12,25,USA
Thomas Edward,1886-08-13,7,1911,1918,8,13,USA
Oscar John,1916-11-25,0,1938,1938,11,25,USA
Benjamin Raymond,1912-07-19,8,1936,1944,7,19,USA
David Frederick,1936-08-06,0,1962,1962,8,6,USA
Craig Stuart,1959-01-08,0,1985,1985,1,8,USA
George Alois,1942-03-08,0,1962,1962,3,8,USA
Michael Jeffrey,1992-07-08,1,2018,2019,7,8,USA
Walter,1891-08-18,15,1914,1929,8,18,USA
Robert Peter,1961-09-22,5,1988,1993,9,22,USA
John Joseph,1855-02-14,18,1873,1891,2,14,USA
Harold Kenneth,1961-05-19,2,1986,1988,5,19,USA
Allen Russell,1950-08-13,0,1974,1974,8,13,USA
Albert,1917-06-24,5,1943,1948,6,24,USA
George Herbert,1903-07-28,1,1927,1928,7,28,USA
Stephen Paul,1912-11-19,0,1945,1945,11,19,USA
John Glenn,1917-05-11,1,1938,1939,5,11,USA
Domingo,1992-08-04,2,2017,2019,8,4,D.R.
Esteban,1978-01-26,9,2002,2011,1,26,D.R.
Franklyn Miguel,1980-01-20,6,2002,2008,1,20,D.R.
Justin William,1982-08-06,10,2004,2014,8,6,USA
Lester Stanley,1869-06-01,7,1890,1897,6,1,USA
Gonzalez German,1987-09-23,3,2013,2016,9,23,D.R.
Richard Edward,1928-09-28,10,1952,1962,9,28,USA
Edwin Frederick,1897-07-22,0,1919,1919,7,22,USA
Cesar Francisco,1948-03-11,14,1969,1983,3,11,D.R.
Louis Wilhelm,1875-05-04,2,1901,1903,5,4,USA
Joseph Diego,1977-09-18,7,2003,2010,9,18,USA
Lucien Edward,1890-07-06,0,1913,1913,7,6,USA
Samuel,1985-01-10,1,2009,2010,1,10,D.R.
Henry Homer,1880-12-23,8,1903,1911,12,23,USA
Allen Jones,1917-09-17,10,1945,1955,9,17,USA
Byron Earl,1980-03-13,0,2004,2004,3,13,USA
Lewis Thomas Leyton,1868-12-11,6,1889,1895,12,11,USA
Jacob John,1875-10-25,2,1897,1899,10,25,Russia
Christopher Ryan,1983-08-30,6,2008,2014,8,30,USA
Gustave,1889-08-03,9,1909,1918,8,3,USA
Charles H.,1864-02-14,8,1884,1892,2,14,Germany
Jacob Bowman,1884-03-26,3,1910,1913,3,26,USA
James Edward,1903-06-03,2,1924,1926,6,3,USA
Edward Patrick,1892-03-13,14,1916,1930,3,13,USA
Anthony Paul,1961-08-23,0,1983,1983,8,23,USA
Robert Paul,1937-05-20,0,1958,1958,5,20,USA
Jason Gilbert,1971-01-08,19,1995,2014,1,8,USA
Jeremy Dean,1974-09-30,5,1998,2003,9,30,USA
Joseph Francis,1888-09-08,0,1911,1911,9,8,USA
Raymond John,1966-02-05,4,1991,1995,2,5,USA
Joseph Oscar,1898-10-07,2,1925,1927,10,7,USA
Anthony James,1982-11-29,0,2005,2005,11,29,USA
Johnny Arthur,1987-07-10,6,2011,2017,7,10,USA
Ian Philip,1993-11-19,0,2019,2019,11,19,USA
Jay Jonathan,1977-03-02,10,2001,2011,3,2,USA
Joseph Charles,1935-04-10,12,1960,1972,4,10,USA
John Michael,1962-06-08,2,1984,1986,6,8,USA
Jerry Dean,1938-11-07,9,1962,1971,11,7,USA
Stephan Benson,1972-10-09,1,1995,1996,10,9,USA
Robert,1935-11-09,16,1959,1975,11,9,USA
Robert Louis,1957-06-19,4,1983,1987,6,19,USA
Charles Ellsworth,1879-11-17,0,1905,1905,11,17,USA
Charles Griffin,1899-11-21,0,1924,1924,11,21,USA
Derrick Lamont,1975-02-05,1,1998,1999,2,5,USA
Frank Gilbert,1890-09-27,14,1913,1927,9,27,USA
George C.,1880-07-22,13,1905,1918,7,22,CAN
Joshua,1911-12-21,NA,NA,NA,12,21,USA
Kirk Harold,1957-05-28,16,1979,1995,5,28,USA
Kyle Benjamin,1987-10-23,6,2013,2019,10,23,USA
Norwood Ringold,1877-03-11,3,1903,1906,3,11,USA
Paul Marshall,1960-01-04,8,1988,1996,1,4,USA
Robert Murray,1869-08-20,0,1890,1890,8,20,USA
John Russell,1939-05-06,5,1967,1972,5,6,USA
Samuel Braxton,1899-08-05,6,1926,1932,8,5,USA
Leighton P.,1868-10-06,0,1888,1888,10,6,USA
George Edward,1915-10-18,1,1937,1938,10,18,USA
Byron Brett,1963-08-08,3,1987,1990,8,8,USA
James Leslie,1953-09-26,0,1975,1975,9,26,USA
Floyd George,1909-12-10,2,1939,1941,12,10,USA
Joseph Henry,1891-11-30,0,1913,1913,11,30,USA
Paul Robert,1932-09-29,7,1954,1961,9,29,USA
Daniel Joshua,1977-05-19,2,2007,2009,5,19,USA
James H.,1845-10-18,NA,NA,NA,10,18,USA
Robert Thomas,1933-08-13,3,1959,1962,8,13,USA
Norman Phillip,1938-05-12,0,1967,1967,5,12,USA
Romar Benjamin,1972-10-06,10,1993,2003,10,6,Mexico
Andrew,1914-07-18,4,1942,1946,7,18,USA
Alfred Gideon,1868-03-13,0,1892,1892,3,13,USA
William Oliver,1876-06-21,8,1901,1909,6,21,USA
Drew Edward,1935-07-26,0,1959,1959,7,26,USA
Charles Mader,1919-07-08,7,1940,1947,7,8,USA
Harry H.,1868-07-08,0,1890,1890,7,8,USA
John Robert,1875-09-04,6,1898,1904,9,4,USA
John G.,1864-01-08,0,1890,1890,1,8,USA
Joe Dennis,1952-04-20,1,1972,1973,4,20,USA
Lawrence William,1891-12-03,1,1914,1915,12,3,USA
Mark David,1956-08-22,0,1985,1985,8,22,USA
Peter,1867-09-06,4,1890,1894,9,6,USA
Albert Shawn,1965-03-12,3,1997,2000,3,12,USA
Harold Joseph,1929-04-04,3,1950,1953,4,4,USA
Walter John,1900-12-19,4,1928,1932,12,19,USA
William Freeman,1947-09-03,3,1971,1974,9,3,USA
Rodney Joe,1952-09-24,6,1972,1978,9,24,USA
Donald Loren,1935-04-19,3,1959,1962,4,19,USA
Brian Jeffrey,1960-04-27,9,1981,1990,4,27,USA
Brian Stephen,1971-01-20,14,1995,2009,1,20,USA
Kenneth Robert,1990-09-20,5,2014,2019,9,20,USA
Marcus William,1978-05-18,6,2001,2007,5,18,USA
Warren Crandall,1896-05-28,NA,NA,NA,5,28,USA
Jason Edward,1976-08-31,0,2003,2003,8,31,USA
Geronimo,1975-08-07,6,2001,2007,8,7,Mexico
Tomas Gustavo,1939-04-19,4,1967,1971,4,19,Venezuela
George Lewis,1899-09-08,1,1920,1921,9,8,USA
Frank Patrick,1892-06-10,8,1911,1919,6,10,USA
Jerry Bienvenido,1982-10-14,3,2004,2007,10,14,D.R.
Otis Bernard,1966-09-24,11,1990,2001,9,24,USA
Robert James,1864-07-02,6,1887,1893,7,2,USA
Conor Michael,1987-07-18,9,2008,2017,7,18,USA
Robert William,1919-10-08,6,1944,1950,10,8,USA
Carden Edison,1917-05-13,8,1940,1948,5,13,USA
Claral Lewis,1900-05-20,0,1923,1923,5,20,USA
Cole Braden,1984-06-20,6,2010,2016,6,20,USA
Edward James,1895-08-07,0,1919,1919,8,7,USA
John Patrick,1900-02-25,0,1922,1922,2,25,USA
John William Linden,1862-05-03,0,1890,1890,5,3,USA
Paul Allen,1920-09-18,3,1942,1945,9,18,USA
Peter Patrick,1851-11-30,7,1880,1887,11,30,USA
Samuel,1867-11-14,4,1893,1897,11,14,USA
Thomas J.,1862-05-18,2,1884,1886,5,18,USA
Thomas Bradford,1962-07-02,0,1990,1990,7,2,USA
George Lloyd,1909-02-13,2,1937,1939,2,13,USA
Harold Edward,1899-01-23,0,1923,1923,1,23,USA
Andrew Bernard,1856-01-03,13,1875,1888,1,3,USA
Grant,1901-01-24,2,1927,1929,1,24,USA
John Patrick,1885-10-18,1,1909,1910,10,18,USA
James William,1928-10-17,13,1953,1966,10,17,USA
Paul Gant,1945-01-12,0,1967,1967,1,12,USA
Lawrence Patrick D.,1937-08-22,NA,NA,NA,8,22,USA
James Clifford,1865-09-29,0,1889,1889,9,29,USA
John Wesley,1905-03-27,9,1927,1936,3,27,USA
George Fred,1875-02-28,0,1898,1898,2,28,USA
Warren Darst,1878-12-21,0,1908,1908,12,21,USA
James Joseph,1870-06-14,0,1893,1893,6,14,USA
Pitkin Clark,1864-03-14,0,1884,1884,3,14,USA
Sean Patrick,1990-05-08,4,2015,2019,5,8,USA
Franklin T.,1864-04-27,2,1886,1888,4,27,USA
Ernest Grover,1888-11-01,1,1914,1915,11,1,USA
Leonard Preston,1917-11-03,0,1944,1944,11,3,USA
John M.,1869-10-26,1,1895,1896,10,26,USA
Harold,1942-02-09,0,1968,1968,2,9,USA
Christopher Paul,1982-12-27,9,2009,2018,12,27,USA
Hector C.,1982-09-28,7,2006,2013,9,28,Venezuela
Caleb Charles,1988-08-31,1,2013,2014,8,31,USA
William Joseph,1872-11-07,0,1899,1899,11,7,USA
Joseph John,1893-01-10,0,1915,1915,1,10,USA
Kevin Andrew,1994-03-24,0,2019,2019,3,24,USA
Tinsley Rucker,1891-09-26,0,1914,1914,9,26,USA
Myron Nathan,1926-10-11,14,1948,1962,10,11,USA
Keith Michael,1976-05-05,5,2000,2005,5,5,USA
Matthew Shane,1977-12-24,8,2000,2008,12,24,USA
Lucas Frost,1994-07-14,3,2016,2019,7,14,USA
Albert Francis,1922-03-08,3,1944,1947,3,8,USA
Thomas Arthur,1925-10-09,0,1953,1953,10,9,USA
Edward Thomas,1969-03-04,4,1995,1999,3,4,USA
Charles Wells,1972-12-16,7,1998,2005,12,16,USA
Charles August,1884-12-16,0,1910,1910,12,16,USA
Joseph Elliott,1964-10-14,14,1989,2003,10,14,USA
Chad Alan,1991-02-06,0,2016,2016,2,6,USA
Christopher Odell,1978-01-04,0,2004,2004,1,4,USA
Angelo John,1912-11-24,7,1936,1943,11,24,USA
David John,1939-11-27,15,1962,1977,11,27,USA
Brian Allen,1965-11-06,1,1995,1996,11,6,USA
Mychal Antonio,1990-05-13,4,2015,2019,5,13,USA
Clinton Daniel,1957-07-07,10,1983,1993,7,7,USA
Fred Earl,1936-06-28,12,1961,1973,6,28,USA
James Walter,1922-10-02,0,1946,1946,10,2,USA
Frederick Monroe,1876-01-25,6,1902,1908,1,25,USA
Joseph Albert Rolland Edouard,1911-05-10,0,1944,1944,5,10,CAN
John Burke,1894-07-28,0,1920,1920,7,28,USA
Douglas Metunwa,1970-08-25,8,1996,2004,8,25,USA
Norman Matthew,1894-08-31,0,1920,1920,8,31,USA
Tyler Allen,1993-08-23,3,2016,2019,8,23,USA
John Wesley,1857-07-22,16,1879,1895,7,22,USA
Thomas Joseph,1898-04-29,0,1925,1925,4,29,USA
Keith Harris,1972-01-18,2,1998,2000,1,18,USA
Troy Edward,1976-08-03,12,1998,2010,8,3,USA
Luke Frank,1893-01-17,0,1913,1913,1,17,USA
Michael Patrick,1973-01-24,0,2003,2003,1,24,USA
Thomas Giatano,1923-10-26,4,1949,1953,10,26,USA
Thomas Michael,1966-03-25,21,1987,2008,3,25,USA
Daniel Ralph,1881-03-13,2,1906,1908,3,13,USA
Charles Franklin,1893-09-17,4,1920,1924,9,17,USA
William G.,1858-11-12,7,1882,1889,11,12,USA
William Patrick,1894-09-06,5,1916,1921,9,6,USA
Harry Gilbert,1875-03-28,4,1901,1905,3,28,USA
John Day,1854-07-14,9,1877,1886,7,14,USA
Joseph Paul,1895-07-09,2,1920,1922,7,9,USA
William J.,1866-10-26,24,1888,1912,10,26,USA
Roy William,1943-04-09,0,1963,1963,4,9,USA
Jerry Don,1957-09-14,13,1979,1992,9,14,USA
James Joseph,1912-03-05,6,1936,1942,3,5,USA
Frank Elmer,1894-03-07,1,1919,1920,3,7,USA
Robert Joseph,1867-01-17,3,1890,1893,1,17,USA
Martin James,1878-11-20,1,1902,1903,11,20,USA
Burdette,1894-06-16,0,1920,1920,6,16,USA
Bradley Edward,1987-04-02,0,2014,2014,4,2,USA
Edward C.,1860-06-15,4,1884,1888,6,15,USA
Harry Melville,1890-06-09,0,1915,1915,6,9,USA
Joseph Charles,1908-11-19,8,1932,1940,11,19,USA
John,1928-07-10,0,1960,1960,7,10,USA
Salvador Michael,1902-05-07,0,1930,1930,5,7,USA
George,1969-06-29,0,1994,1994,6,29,USA
Ross Peter,1976-04-05,11,2000,2011,4,5,USA
Norman Stanley,1894-06-15,0,1914,1914,6,15,USA
Alban,1914-07-12,7,1939,1946,7,12,USA
John Gary,1976-12-03,9,1999,2008,12,3,USA
Koda James,1993-04-13,2,2016,2018,4,13,USA
William Vincent,1925-07-30,5,1949,1954,7,30,USA
Edward Paul,1953-06-03,10,1975,1985,6,3,USA
Ryan David,1974-11-01,6,1999,2005,11,1,USA
Joshua Mercer,1870-01-31,2,1896,1898,1,31,USA
Billy James,1981-07-19,6,2003,2009,7,19,USA
John Peter,1875-09-12,2,1901,1903,9,12,USA
John Michael,1864-10-25,0,1892,1892,10,25,USA
Danny Ray,1946-11-04,0,1974,1974,11,4,USA
Joseph Harold,1950-07-23,0,1972,1972,7,23,USA
Graham H.,1984-08-09,1,2011,2012,8,9,USA
Zachary Thomas,1990-04-21,4,2015,2019,4,21,USA
John Henry,1877-03-10,1,1905,1906,3,10,USA
Carlton Tyrell,1979-07-10,0,2005,2005,7,10,USA
Jacob Dwayne,1987-09-24,0,2014,2014,9,24,USA
Wilbur Edwin,1898-09-01,0,1922,1922,9,1,USA
William John,1871-09-03,0,1899,1899,9,3,USA
Erik Van Norman,1988-12-20,4,2014,2018,12,20,USA
Tyler David,1992-10-20,0,2016,2016,10,20,USA
John Hardy,1937-10-24,0,1960,1960,10,24,USA
Jerry Leroy,1964-04-12,6,1990,1996,4,12,USA
David Paul,1988-10-11,2,2015,2017,10,11,USA
Charles Francis,1945-07-07,2,1972,1974,7,7,USA
William Joseph,1947-10-26,5,1970,1975,10,26,USA
Luiz Henrique,1996-07-31,1,2017,2018,7,31,Brazil
Gregory James,1967-10-29,3,1993,1996,10,29,USA
Ryan Matthew,1988-02-13,6,2013,2019,2,13,USA
Bradley Andrew,1990-02-21,0,2017,2017,2,21,USA
James Edward,1936-03-20,3,1960,1963,3,20,USA
Michael Henry,1851-09-11,3,1875,1878,9,11,USA
Roy Kramer,1888-07-12,1,1910,1911,7,12,USA
Jonah John,1906-08-29,3,1928,1931,8,29,USA
Fredrick Ernest,1856-05-15,9,1875,1884,5,15,USA
Gordon Frederick,1927-08-30,3,1949,1952,8,30,USA
Harold Eugene,1898-08-18,3,1926,1929,8,18,USA
Isidore,1908-06-06,0,1932,1932,6,6,Russia
Leslie Elmer,1918-05-13,3,1943,1946,5,13,USA
Paul Edward,1987-09-10,8,2011,2019,9,10,USA
Walton Hugh,1861-12-31,4,1884,1888,12,31,USA
Purnal William,1937-11-28,1,1962,1963,11,28,USA
Stanley,1918-05-21,0,1941,1941,5,21,USA
Michael Mitchell,1921-11-05,3,1949,1952,11,5,USA
Gregory Joseph,1985-09-17,3,2008,2011,9,17,USA
David Allan,1949-06-23,11,1972,1983,6,23,USA
Walter George,1894-02-01,0,1922,1922,2,1,USA
Austin Zachary,1993-11-23,0,2018,2018,11,23,USA
Brandon Paul,1984-07-15,4,2011,2015,7,15,USA
Jonathan Johnson,1980-11-22,12,2003,2015,11,22,USA
Wayne Maurice,1973-01-15,5,1997,2002,1,15,USA
Yan,1987-07-19,7,2012,2019,7,19,Brazil
Alexis de Jesus,1978-08-08,4,2002,2006,8,8,D.R.
Carlos Argelis,1985-12-04,12,2007,2019,12,4,D.R.
Jose Luis,1909-03-23,7,1935,1942,3,23,Mexico
Christopher Cory,1971-06-16,15,1993,2008,6,16,USA
Hector Alexis,1988-03-05,4,2011,2015,3,5,D.R.
Jeanmar Alejandro,1988-02-10,9,2010,2019,2,10,Venezuela
Vernon Louis,1908-11-26,13,1930,1943,11,26,USA
Leonardo,1966-03-02,6,1990,1996,3,2,P.R.
Luis,1951-08-19,7,1974,1981,8,19,Mexico
Mauro Alexis,1984-09-07,0,2012,2012,9,7,D.R.
Miguel Angel,1992-12-17,1,2017,2018,12,17,D.R.
Patrick Alexander,1968-03-17,2,1993,1995,3,17,USA
Preston,1923-04-20,0,1944,1944,4,20,Cuba
Randell Scott,1957-02-04,0,1984,1984,2,4,USA
Roberto Ezequiel,1989-08-03,1,2017,2018,8,3,D.R.
Ruben,1927-07-13,14,1953,1967,7,13,P.R.
Jesse Lemar,1936-01-20,7,1960,1967,1,20,USA
Stephen William,1994-07-08,0,2018,2018,7,8,USA
Anthony D.,1994-05-14,0,2019,2019,5,14,USA
Adrian Sabin,1982-05-08,14,2004,2018,5,8,USA
Alexander Scott,1973-04-08,12,1994,2006,4,8,USA
Alexander,1977-02-15,16,1998,2014,2,15,Venezuela
Alberto Ramon,1983-04-18,6,2007,2013,4,18,Venezuela
Alfredo Rene,1992-07-13,0,2018,2018,7,13,Venezuela
Angel Manuel,1981-12-15,2,2007,2009,12,15,P.R.
Carlos Eduardo,1985-10-17,11,2008,2019,10,17,Venezuela
Alexander,1992-01-15,4,2015,2019,1,15,USA
Daniel David,1953-09-30,1,1979,1980,9,30,USA
Denio Mariano,1963-07-22,5,1984,1989,7,22,D.R.
Dicky Angel,1978-12-21,3,2001,2004,12,21,P.R.
Edgar Gerardo,1983-02-23,10,2003,2013,2,23,Mexico
Edgar Victor,1978-06-14,1,2008,2009,6,14,USA
Enrique Cesar,1982-07-14,5,2006,2011,7,14,Venezuela
Erik,1991-08-31,3,2016,2019,8,31,D.R.
Eusebio Miguel,1892-07-13,0,1918,1918,7,13,Cuba
Jose Fernando,1950-06-19,7,1972,1979,6,19,P.R.
Fredi Jesus,1964-01-28,NA,NA,NA,1,28,Cuba
Gabriel,1972-05-24,0,1998,1998,5,24,USA
German Jose,1962-03-07,1,1988,1989,3,7,Venezuela
Giovany Aramis,1985-09-19,11,2008,2019,9,19,USA
Geremis Segundo,1975-01-08,9,1997,2006,1,8,Venezuela
Joe Madrid,1915-03-19,0,1937,1937,3,19,USA
Jose Rafael,1964-11-23,7,1985,1992,11,23,D.R.
Julio Enrique,1920-12-20,0,1949,1949,12,20,Cuba
Julio Cesar,1952-12-25,6,1977,1983,12,25,P.R.
Juan Alberto,1969-10-20,16,1989,2005,10,20,P.R.
Lawrence Christopher,1967-03-28,0,1993,1993,3,28,USA
Lariel Alfonso,1976-05-25,0,1998,1998,5,25,D.R.
Luis Emilio,1967-09-03,18,1990,2008,9,3,USA
Luis Alberto,1979-06-26,2,2004,2006,6,26,Venezuela
Marwin Javier,1989-03-14,7,2012,2019,3,14,Venezuela
Marco Elias,1992-02-16,5,2014,2019,2,16,USA
Merandy,1995-10-09,0,2018,2018,10,9,D.R.
Miguel Angel,1890-09-24,20,1912,1932,9,24,Cuba
Michael Vela,1978-05-23,10,2003,2013,5,23,USA
Miguel Angel,1984-05-27,6,2012,2018,5,27,Mexico
Miguel Antonio,1990-12-03,0,2013,2013,12,3,Venezuela
Miguel Alfredo,1983-09-23,0,2014,2014,9,23,Cuba
Orlando Eugene,1951-11-15,4,1976,1980,11,15,Cuba
Pedro,1937-12-12,4,1963,1967,12,12,D.R.
Victor Raul,1973-12-27,4,2000,2004,12,27,P.R.
Rene Adrian,1960-09-03,13,1984,1997,9,3,USA
Severino Yunier,1992-09-28,1,2015,2016,9,28,Panama
Andres Antonio,1936-08-28,11,1960,1971,8,28,Cuba
Wenceslao,1925-09-28,0,1955,1955,9,28,Cuba
Wiklenman Vicente,1974-05-17,7,1999,2006,5,17,Venezuela
Charles Furman,1902-06-05,0,1929,1929,6,5,USA
John Beverley,1897-11-09,12,1921,1933,11,9,USA
Lee Currin,1890-02-23,2,1915,1917,2,23,USA
Herbert Frank,1866-08-10,0,1890,1890,8,10,USA
Andrew Richard,1979-09-19,2,2003,2005,9,19,USA
Dwight Eugene,1964-11-16,16,1984,2000,11,16,USA
John Henry William,1907-04-05,0,1928,1928,4,5,USA
Michael J.,1866-10-03,1,1887,1888,10,3,USA
Eugene Joseph,1882-12-13,0,1906,1906,12,13,USA
William Dale,1926-03-22,15,1947,1962,3,22,USA
Ival Richard,1908-07-23,9,1935,1944,7,23,USA
Jacob,1853-09-14,4,1878,1882,9,14,USA
Ralph Nelson,1886-04-25,0,1910,1910,4,25,USA
Cartier Niko,1992-02-28,2,2017,2019,2,28,USA
James Edward,1948-01-25,7,1970,1977,1,25,USA
Arthur Ingram,1876-02-27,0,1905,1905,2,27,USA
Brian Christopher,1990-11-02,3,2016,2019,11,2,USA
Clyde Thurston,1881-09-02,0,1906,1906,9,2,USA
Curtis LaMar,1972-09-30,4,1995,1999,9,30,USA
Danny Kay,1953-09-02,7,1975,1982,9,2,USA
Wilbur David,1885-09-28,13,1905,1918,9,28,USA
James Patrick,1926-08-15,0,1948,1948,8,15,USA
Marvin Mardo,1891-01-16,9,1916,1925,1,16,USA
Claire Vernon,1891-12-19,1,1914,1915,12,19,USA
Thomas Jones,1968-07-27,13,1991,2004,7,27,USA
Nicholas Gunnar,1991-07-06,4,2015,2019,7,6,USA
Raymond Daniel,1919-09-05,0,1946,1946,9,5,USA
Gregory Bryant,1945-12-14,5,1965,1970,12,14,USA
Glen Edward,1930-07-08,2,1955,1957,7,8,CAN
Raymond Cornelius,1892-04-11,1,1921,1922,4,11,USA
Alex Jonathan,1984-02-10,12,2007,2019,2,10,USA
Brian Ernest,1978-08-16,3,2008,2011,8,16,USA
Devaris,1988-04-22,8,2011,2019,4,22,USA
Donald Thomas,1959-10-10,2,1986,1988,10,10,USA
Joseph Lowell,1915-02-18,12,1938,1950,2,18,USA
Keith Bradley,1969-01-22,0,1993,1993,1,22,USA
Michael William,1953-09-11,1,1977,1978,9,11,USA
Sidney,1917-08-13,14,1941,1955,8,13,USA
Thomas,1967-11-18,21,1988,2009,11,18,USA
Reid Evan,1980-12-22,0,2009,2009,12,22,USA
Richard John,1973-08-27,1,1997,1998,8,27,USA
George F.,1854-05-03,13,1879,1892,5,3,USA
Terrance J.,1991-06-08,5,2014,2019,6,8,USA
Robert John,1952-01-07,0,1977,1977,1,7,USA
Charles Perry,1928-02-06,1,1954,1955,2,6,USA
Herbert Allen,1924-12-19,0,1952,1952,12,19,USA
Howard Paul,1913-05-14,1,1937,1938,5,14,USA
Thomas David,1919-03-16,0,1939,1939,3,16,USA
Thomas Aloysius,1925-01-04,7,1952,1959,1,4,USA
Thomas Patrick,1957-12-16,6,1981,1987,12,16,USA
Joseph,1866-12-20,0,1891,1891,12,20,USA
Nicholas Anthony,1979-04-19,0,2007,2007,4,19,USA
Henry Frank,1911-01-14,5,1941,1946,1,14,USA
John Joseph Perry,1915-03-29,7,1940,1947,3,29,USA
John Albert,1933-10-21,7,1957,1964,10,21,USA
Thomas Stephen,1982-07-12,11,2005,2016,7,12,USA
Anthony Robert,1990-08-10,4,2012,2016,8,10,USA
James Benjamin,1983-08-17,4,2013,2017,8,17,USA
James Charles,1942-11-06,11,1963,1974,11,6,USA
Leon Allen,1900-10-16,17,1921,1938,10,16,USA
Michael Frederick,1980-09-23,5,2004,2009,9,23,USA
Richard Michael,1951-07-05,22,1972,1994,7,5,USA
Daniel James,1992-11-13,1,2017,2018,11,13,USA
John Star,1890-08-21,1,1913,1914,8,21,USA
Philip David,1988-10-03,6,2013,2019,10,3,USA
Howard Wayne,1934-11-01,1,1962,1963,11,1,USA
Julio Enrique,1939-06-09,9,1960,1969,6,9,P.R.
Ruben Bruce,1982-12-25,4,2004,2008,12,25,P.R.
James William,1959-08-03,13,1982,1995,8,3,USA
Trevor Vaughan,1992-08-26,4,2015,2019,8,26,USA
Theodore Lee,1889-08-12,0,1912,1912,8,12,USA
Albert Frank,1893-01-20,1,1916,1917,1,20,USA
Charles Harvey,1847-08-21,6,1871,1877,8,21,USA
Nicholas Edward,1916-11-13,1,1944,1945,11,13,USA
Yulieski,1984-06-09,3,2016,2019,6,9,Cuba
Harry Morgan,1889-08-24,20,1910,1930,8,24,USA
Lawrence Clyde,1948-05-02,0,1972,1972,5,2,USA
Mauro Paul,1966-03-07,5,1989,1994,3,7,USA
Billy Cordell,1946-01-18,6,1969,1975,1,18,USA
Rodney Blaine,1930-06-20,0,1958,1958,6,20,USA
Alfons Francis,1901-09-04,1,1929,1930,9,4,USA
Jason William,1976-05-24,3,2002,2005,5,24,USA
John Patrick,1900-01-07,7,1924,1931,1,7,USA
John William,1978-11-04,8,2003,2011,11,4,USA
Reginald John,1907-07-16,2,1932,1934,7,16,USA
Robert Earl,1907-02-24,8,1929,1937,2,24,USA
Franklyn Benjamin,1979-08-20,0,2004,2004,8,20,D.R.
Joseph LaVerne,1914-01-05,9,1938,1947,1,5,USA
Mark Eugene,1964-06-28,15,1988,2003,6,28,USA
Matthew Aaron,1988-12-14,4,2015,2019,12,14,USA
Michael Lee,1956-06-14,0,1978,1978,6,14,USA
Michael James,1970-06-20,4,1995,1999,6,20,USA
John F.,1858-12-15,0,1884,1884,12,15,USA
Michael William,1869-12-23,12,1894,1906,12,23,USA
Frederick Gottleib,1889-08-25,0,1913,1913,8,25,USA
Louis George,1866-07-25,0,1890,1890,7,25,USA
Samuel Mason,1843-12-08,NA,NA,NA,12,8,USA
Milton Edward,1930-12-30,1,1957,1958,12,30,USA
Anthony Joseph,1972-06-06,13,1996,2009,6,6,USA
James,1865-01-08,0,1889,1889,1,8,USA
Bert,1886-04-03,0,1910,1910,4,3,USA
William James,1883-07-22,2,1908,1910,7,22,USA
William Albert,1937-01-21,1,1966,1967,1,21,USA
Charles Henry,1878-04-24,0,1906,1906,4,24,USA
Daniel Jay,1954-07-19,2,1979,1981,7,19,USA
Jack Bernard,1916-12-24,3,1946,1949,12,24,USA
Johnathan Ryan,1990-01-14,1,2015,2016,1,14,USA
Lee Willard,1959-09-22,0,1983,1983,9,22,USA
Archibald Wright,1877-11-12,0,1905,1905,11,12,USA
Oscar Marion,1878-07-20,0,1907,1907,7,20,USA
George Frederick,1877-03-23,10,1902,1912,3,23,USA
Roy Vincent,1895-02-22,1,1922,1923,2,22,USA
Kyle,1899-08-14,5,1924,1929,8,14,USA
Arthur William,1909-08-12,1,1934,1935,8,12,USA
Dawson Francis,1892-09-09,0,1914,1914,9,9,USA
Tyler Lewis,1984-01-25,0,2012,2012,1,25,USA
Wayne Leon,1936-04-06,1,1963,1964,4,6,USA
Joseph Milton,1967-08-14,9,1990,1999,8,14,USA
Alex Joseph,1977-11-17,1,2004,2005,11,17,USA
Bert Thomas,1945-04-19,0,1968,1968,4,19,USA
Alexander Peter,1926-04-03,9,1954,1963,4,3,USA
Henry Eckhard,1903-09-28,2,1927,1929,9,28,USA
Curtis,1981-03-16,15,2004,2019,3,16,USA
Yasmani,1988-11-08,7,2012,2019,11,8,Cuba
John Gladstone,1886-06-10,14,1908,1922,6,10,CAN
Jeffrey Adam,1971-12-16,4,1993,1997,12,16,USA
Wayne Allan,1944-03-15,8,1968,1976,3,15,USA
Zachary Thomas,1992-09-17,0,2017,2017,9,17,USA
Edward Leslie,1883-05-21,10,1905,1915,5,21,USA
Ulysses Franklin,1865-08-01,NA,NA,NA,8,1,USA
George Farley,1900-05-20,12,1922,1934,5,20,USA
George Addison,1903-01-06,8,1923,1931,1,6,USA
James Ronald,1894-08-04,0,1923,1923,8,4,USA
James Charles,1918-10-06,2,1942,1944,10,6,USA
Mark Andrew,1963-10-24,9,1984,1993,10,24,USA
James Timothy,1935-08-13,13,1958,1971,8,13,USA
Thomas Raymond,1957-05-28,0,1983,1983,5,28,USA
Richard Ray,1958-04-16,2,1983,1985,4,16,USA
Louis Junior,1924-09-11,0,1948,1948,9,11,USA
Newton Michael,1920-05-10,9,1946,1955,5,10,USA
Beiker,1974-11-09,0,1999,1999,11,9,Venezuela
Brusdar Javier,1998-08-26,0,2019,2019,8,26,Venezuela
Donald,1923-08-27,1,1945,1946,8,27,USA
Juan Jose,1989-02-14,3,2016,2019,2,14,Venezuela
Mark Anthony,1964-01-19,2,1991,1993,1,19,USA
William,1868-07-24,0,1891,1891,7,24,USA
Brett Thomas,1993-01-30,0,2018,2018,1,30,USA
Daniel Peter,1973-08-07,10,1996,2006,8,7,Viet Nam
Frank Norris,1860-11-02,0,1886,1886,11,2,USA
Joseph Ebenezer,1906-02-26,0,1926,1926,2,26,USA
Kendall Chase,1990-12-21,4,2014,2018,12,21,USA
Samuel Sidney,1901-11-30,0,1927,1927,11,30,USA
George Edward,1873-07-17,0,1899,1899,7,17,USA
David Alexander,1943-01-07,0,1964,1964,1,7,USA
Richard Benjamin,1931-07-11,2,1958,1960,7,11,USA
William Denton,1878-12-04,2,1909,1911,12,4,USA
Samuel David,1897-10-15,9,1924,1933,10,15,USA
Gary George,1952-09-21,5,1977,1982,9,21,USA
Jeffrey Edward,1963-04-10,3,1988,1991,4,10,USA
Jeffrey Michael,1981-11-19,4,2008,2012,11,19,USA
James W.,1862-08-07,9,1884,1893,8,7,USA
John Leonard,1926-12-11,4,1954,1958,12,11,USA
Jonathan Charles,1991-11-05,4,2015,2019,11,5,USA
Lorenzo,1958-03-04,1,1982,1983,3,4,USA
Milton Marshall,1914-02-21,0,1937,1937,2,21,USA
Peter J.,1915-03-06,0,1945,1945,3,6,USA
Sonny Douglas,1989-11-07,6,2013,2019,11,7,USA
Stanley Oscar,1888-12-10,0,1912,1912,12,10,USA
Ted Glenn,1924-12-31,9,1946,1955,12,31,USA
Eli,1934-08-09,4,1959,1963,8,9,USA
William Henry,1924-09-03,0,1954,1954,9,3,USA
John A.,1851-07-29,0,1873,1873,7,29,USA
Craig Allen,1964-12-29,11,1990,2001,12,29,USA
Adam Daniel,1981-02-21,7,2005,2012,2,21,USA
Altar Alfonse,1954-11-09,0,1979,1979,11,9,USA
Andrew Mulligan,1977-07-07,5,2004,2009,7,7,USA
William Fitter,1857-04-19,8,1882,1890,4,19,USA
Robert Chandler,1928-03-13,1,1954,1955,3,13,Mexico
Christopher DeWayne,1960-09-05,0,1984,1984,9,5,USA
Charles Patrick,1971-01-23,4,1996,2000,1,23,USA
Chad Keith,1991-05-24,3,2016,2019,5,24,USA
Edward,1876-11-06,7,1898,1905,11,6,USA
George Dallas,1934-08-04,7,1960,1967,8,4,USA
David Alejandro,1960-12-04,6,1981,1987,12,4,Nicaragua
Richard Larry,1941-04-21,11,1963,1974,4,21,USA
Fred Allen,1933-09-14,5,1959,1964,9,14,USA
Gary Allan,1962-01-14,6,1986,1992,1,14,USA
Gene Leroy,1933-06-26,6,1957,1963,6,26,USA
Grant Thomas,1987-09-27,4,2013,2017,9,27,USA
Henry Benjamin,1911-01-01,17,1930,1947,1,1,USA
Harvey George,1915-02-09,0,1935,1935,2,9,USA
David Jason,1975-06-05,0,2000,2000,6,5,CAN
James F.,1854-05-22,0,1884,1884,5,22,USA
James Raymond,1927-10-24,4,1952,1956,10,24,USA
Joseph Henry,1897-09-17,0,1924,1924,9,17,USA
Julius Foust,1899-06-25,1,1928,1929,6,25,USA
Kent,1902-07-01,5,1924,1929,7,1,USA
Khalil Thabit,1979-10-21,6,2003,2009,10,21,USA
Leonard Charles,1933-01-06,11,1957,1968,1,6,USA
Michael Lewis,1963-07-18,11,1985,1996,7,18,USA
Nelson George,1899-09-20,1,1924,1925,9,20,USA
Nicholas Anthony,1978-09-10,9,2004,2013,9,10,USA
Nicholas Richard,1987-09-28,1,2014,2015,9,28,USA
Patrick Joseph,1875-03-20,1,1902,1903,3,20,USA
Elijah Jerry,1933-10-27,4,1959,1963,10,27,USA
Richard Douglas,1971-01-02,0,1999,1999,1,2,USA
Bertrum Scarborough,1974-06-09,3,1997,2000,6,9,USA
Sean William,1979-04-20,5,2006,2011,4,20,USA
Shawn David,1972-11-10,14,1993,2007,11,10,USA
Shane,1988-11-17,5,2014,2019,11,17,USA
Steve,1978-01-26,0,2001,2001,1,26,CAN
Taylor William Andrew,1986-11-02,1,2011,2012,11,2,CAN
Ira Thomas,1967-04-06,8,1989,1997,4,6,USA
Todd Anthony,1971-05-08,10,1996,2006,5,8,USA
Tyler Scott,1970-02-18,5,1993,1998,2,18,USA
James Tyler,1983-08-17,4,2009,2013,8,17,USA
Willie Louis,1971-09-23,8,1992,2000,9,23,USA
Zachary,1994-03-07,0,2019,2019,3,7,USA
Brian Keith,1959-05-14,2,1977,1979,5,14,USA
Edward,1863-07-29,2,1885,1887,7,29,USA
Kenneth William,1967-05-12,2,1993,1995,5,12,USA
Thurman Clyde,1969-01-21,8,1994,2002,1,21,USA
Lucas John,1984-05-14,10,2009,2019,5,14,USA
David Charles,1891-03-14,0,1913,1913,3,14,USA
Harold Dana,1921-07-11,9,1943,1952,7,11,USA
Kevin Marschall,1978-06-20,12,2003,2015,6,20,USA
William Thomas,1963-07-29,10,1987,1997,7,29,USA
Sylveanus Augustus,1885-04-13,14,1911,1925,4,13,USA
Mariekson Julius,1990-02-18,7,2012,2019,2,18,Netherlands
Frank Ernst,1888-07-25,0,1912,1912,7,25,USA
Howard Watterson,1886-11-18,0,1911,1911,11,18,USA
Grover LeRoy,1938-06-02,0,1964,1964,6,2,USA
Paul Edwin,1908-06-09,1,1932,1933,6,9,USA
Thomas Andrew,1977-05-05,0,2003,2003,5,5,USA
William Briley,1950-04-25,5,1971,1976,4,25,USA
Grayson James,1992-10-11,1,2018,2019,10,11,USA
Donald Zachary,1983-10-21,15,2004,2019,10,21,USA
Seth Adam,1975-07-29,7,1998,2005,7,29,USA
Lorenzo Edward,1874-03-30,9,1895,1904,3,30,USA
Lewis Edward,1919-08-05,2,1940,1942,8,5,USA
William Joseph,1898-03-05,0,1919,1919,3,5,USA
William Tolan,1871-04-15,8,1890,1898,4,15,USA
Romer Carl,1875-04-08,0,1903,1903,4,8,USA
Robert Anthony,1949-01-15,16,1970,1986,1,15,USA
Randal Alexander,1991-08-13,5,2014,2019,8,13,USA
Carlos Phillipe,1897-12-10,0,1920,1920,12,10,USA
Benjamin,1976-05-04,8,1997,2005,5,4,USA
Thomas Alan,1948-03-04,9,1970,1979,3,4,USA
Arthur Joseph,1988-01-28,5,2012,2017,1,28,USA
Alfredo Claudino,1957-10-06,17,1976,1993,10,6,D.R.
Bartholomew Joseph,1896-03-03,2,1922,1924,3,3,USA
Clark Calvin,1869-11-20,23,1891,1914,11,20,USA
Robert Derrell,1943-12-12,3,1963,1966,12,12,USA
Douglas Lee,1947-06-04,7,1970,1977,6,4,USA
Frank Wesley,1872-11-18,2,1892,1894,11,18,USA
James Linton,1886-07-11,1,1911,1912,7,11,USA
Ivy Moore,1896-11-16,2,1919,1921,11,16,USA
Jeremy Richard,1978-03-22,1,2003,2004,3,22,USA
John-Ford David,1979-11-19,2,2005,2007,11,19,USA
George Kenneth,1950-04-10,18,1973,1991,4,10,USA
George Kenneth,1969-11-21,21,1989,2010,11,21,USA
Leon Clifford,1925-05-20,0,1946,1946,5,20,USA
Martin John,1901-09-02,0,1928,1928,9,2,USA
Michael Joseph,1865-03-20,11,1887,1898,3,20,USA
Michael Leroy,1957-06-26,10,1979,1989,6,26,USA
Patrick Richard,1893-05-06,0,1914,1914,5,6,USA
Francis Arthur,1896-04-24,3,1917,1920,4,24,USA
Tobias Charles,1858-10-24,9,1884,1893,10,24,USA
Thomas Herman,1889-10-26,12,1913,1925,10,26,USA
Thomas James,1948-02-22,13,1969,1982,2,22,USA
Arthur Carle,1883-12-10,9,1909,1918,12,10,USA
Harold Lloyd,1928-08-24,3,1956,1959,8,24,USA
Denver Clarence,1901-03-25,2,1923,1925,3,25,USA
Guido John,1939-01-09,0,1966,1966,1,9,USA
Jason Michael,1976-11-11,17,2000,2017,11,11,USA
Stephen Joseph,1949-05-02,4,1975,1979,5,2,USA
Robert Anton,1930-03-08,8,1954,1962,3,8,USA
Burleigh Arland,1893-08-18,18,1916,1934,8,18,USA
Edward Adelbert,1905-09-08,1,1931,1932,9,8,USA
John Thomas,1869-04-17,0,1897,1897,4,17,USA
Oscar Ray,1915-04-13,8,1938,1946,4,13,USA
Oscar Ray,1893-09-11,6,1920,1926,9,11,USA
Austin Roy,1893-09-11,0,1920,1920,9,11,USA
John Helm,1867-08-09,11,1888,1899,8,9,USA
Charles John,1898-08-28,20,1916,1936,8,28,USA
Justin Scott,1988-08-16,6,2012,2018,8,16,USA
Jason Alan,1967-08-07,17,1989,2006,8,7,USA
Myron Frederick,1875-11-30,2,1905,1907,11,30,USA
Ross Albert,1922-06-04,0,1951,1951,6,4,USA
Ross Albert,1950-01-07,11,1971,1982,1,7,USA
Donald Dexter,1888-03-07,6,1912,1918,3,7,USA
Trenton Marcus,1996-11-01,0,2019,2019,11,1,USA
Lee Theo,1907-10-23,7,1934,1941,10,23,USA
Marvin Edward,1918-03-31,13,1946,1959,3,31,USA
Marquis Deon,1967-04-17,16,1989,2005,4,17,USA
Richard Morrow,1930-11-04,15,1952,1967,11,4,USA
Conrad George,1932-11-09,0,1956,1956,11,9,USA
John,1917-02-26,6,1941,1947,2,26,USA
Henry Knight,1889-09-18,15,1912,1927,9,18,USA
Lewis Carl,1883-10-16,0,1919,1919,10,16,USA
Stephen Joseph,1920-01-15,16,1941,1957,1,15,USA
Lee Mathew,1978-08-21,0,2007,2007,8,21,USA
Robert,1884-09-12,9,1909,1918,9,12,USA
Wedsel Gary,1965-07-10,13,1992,2005,7,10,USA
Howard Hoffman,1906-04-10,2,1930,1932,4,10,USA
Donald John,1931-06-30,5,1955,1960,6,30,USA
Emil Michael,1858-03-04,5,1879,1884,3,4,USA
Gabriel Jordan,1979-10-21,6,2004,2010,10,21,USA
George Albert,1880-04-11,0,1901,1901,4,11,USA
Gregory Eugene,1952-08-01,16,1973,1989,8,1,USA
Harley Joseph,1930-05-05,0,1952,1952,5,5,USA
Kevin Frank,1961-06-08,14,1983,1997,6,8,USA
Kip Lee,1964-08-24,10,1990,2000,8,24,USA
Robert Edward,1989-09-16,6,2013,2019,9,16,USA
Ewell,1896-02-21,0,1925,1925,2,21,USA
Wayne Dale,1952-01-14,10,1976,1986,1,14,USA
Gerald Wayne,1942-10-06,18,1963,1981,10,6,USA
Jeffrey Scott,1965-12-08,3,1992,1995,12,8,USA
Ernest John,1884-12-24,0,1904,1904,12,24,USA
Ernest William,1922-05-03,2,1947,1949,5,3,USA
John Thomas,1926-07-23,14,1946,1960,7,23,USA
Matthew Allen,1967-12-05,0,1995,1995,12,5,USA
Zac,1993-02-17,0,2019,2019,2,17,USA
Charles Byrd,1890-06-20,0,1913,1913,6,20,USA
Robert Moses,1900-03-06,16,1925,1941,3,6,USA
Orval Leroy,1919-08-29,9,1940,1949,8,29,USA
Roy Arthur,1892-01-17,3,1916,1919,1,17,USA
Harvey Harrison,1890-09-18,0,1912,1912,9,18,USA
John Raymond,1948-08-04,15,1972,1987,8,4,USA
Thomas Dillard,1894-02-22,0,1920,1920,2,22,USA
Franklin Thomas,1905-01-07,10,1931,1941,1,7,USA
Henry John,1863-12-14,4,1887,1891,12,14,USA
Jarrett George,1981-11-05,0,2014,2014,11,5,USA
Kelly Wayne,1962-02-26,9,1984,1993,2,26,USA
Mark James,1970-06-30,15,1995,2010,6,30,USA
Deivy Wilfin,1996-02-17,0,2019,2019,2,17,D.R.
Kenneth Allan,1969-08-26,1,1996,1997,8,26,USA
Alfred Henry,1930-02-13,4,1955,1959,2,13,USA
Kevin John,1973-11-15,4,2002,2006,11,15,USA
Sigmund Stanley,1914-11-04,1,1938,1939,11,4,USA
Michael Edward,1972-08-24,0,1998,1998,8,24,USA
Joseph Charles,1937-06-08,11,1961,1972,6,8,USA
Robert John,1993-07-18,3,2016,2019,7,18,USA
Mayckol Martin,1990-08-11,1,2015,2016,8,11,Venezuela
Cecilio,1960-02-01,8,1982,1990,2,1,D.R.
Edward Adrain,1970-10-02,16,1993,2009,10,2,USA
Creighton Wade,1972-03-27,0,1999,1999,3,27,USA
Mark Steven,1962-08-14,13,1984,1997,8,14,USA
Marvin John,1903-08-27,3,1929,1932,8,27,USA
Reymin Yojairo,1992-03-16,2,2017,2019,3,16,D.R.
Alexander,1986-11-20,1,2014,2015,11,20,Cuba
Deolis Alexander,1989-04-17,4,2015,2019,4,17,Venezuela
Gabriel,1993-12-11,0,2018,2018,12,11,D.R.
Luis Javier,1985-10-31,8,2011,2019,10,31,USA
Javier Alexis,1995-09-25,1,2018,2019,9,25,Panama
Juan Antonio,1967-02-01,0,1992,1992,2,1,D.R.
Junior J.,1985-01-16,4,2015,2019,1,16,Venezuela
Mario Miguel,1949-09-28,7,1973,1980,9,28,D.R.
Matthew Olson,1978-08-02,10,2004,2014,8,2,USA
Fermin,1912-10-11,14,1937,1951,10,11,Cuba
Pedro,1956-06-29,14,1978,1992,6,29,D.R.
Tayron Luis,1991-01-09,3,2016,2019,1,9,Colombia
Christopher Taylor,1992-12-01,1,2018,2019,12,1,USA
Vladimir,1975-02-09,15,1996,2011,2,9,D.R.
Vladimir,1999-03-16,0,2019,2019,3,16,CAN
Wilton,1974-10-24,8,1996,2004,10,24,D.R.
Theodore,1872-01-24,0,1901,1901,1,24,USA
Arthur Lee,1958-11-22,12,1984,1996,11,22,USA
Jose Carlos,1982-03-18,0,2008,2008,3,18,USA
Giomar Antonio,1972-10-23,2,1997,1999,10,23,Venezuela
Ronald Ames,1950-08-28,13,1975,1988,8,28,USA
Aaron Colin,1972-10-05,4,2002,2006,10,5,CAN
Taylor Michael,1993-05-12,0,2019,2019,5,12,USA
Carlos Alfonso,1975-09-30,13,1998,2011,9,30,Venezuela
Jose Manuel,1976-05-17,13,1997,2010,5,17,D.R.
Luis Miguel,1994-09-27,1,2018,2019,9,27,Venezuela
Oswaldo Jose,1964-01-20,15,1985,2000,1,20,Venezuela
Preston Blake,1987-07-27,5,2013,2018,7,27,USA
Robert Joseph,1943-09-04,0,1964,1964,9,4,USA
Benjamin Franklin,1858-11-16,1,1883,1884,11,16,USA
Drannon Eugene,1944-10-25,3,1968,1971,10,25,USA
Benjamin John,1919-01-13,4,1946,1950,1,13,USA
Witt Orison,1908-09-18,0,1940,1940,9,18,USA
Louis Joseph,1895-01-16,7,1916,1923,1,16,USA
Michael Watts,1970-12-18,4,1997,2001,12,18,USA
Bradley Lee,1956-06-10,8,1978,1986,6,10,USA
Donald Edward,1951-01-06,8,1970,1978,1,6,USA
Thomas Jefferson,1899-12-25,3,1923,1926,12,25,USA
William Lee,1959-02-20,15,1979,1994,2,20,USA
Glenn James,1954-10-15,1,1982,1983,10,15,USA
Tedd Jasper,1907-01-02,3,1930,1933,1,2,USA
Addison Courtney,1867-10-10,8,1888,1896,10,10,USA
William Skeen,1865-08-08,3,1890,1893,8,8,USA
Harry Edwards,1909-11-05,15,1935,1950,11,5,USA
David Lawrence,1958-05-05,5,1982,1987,5,5,USA
Randall Pennington,1918-01-23,16,1936,1952,1,23,USA
Eric Andrew,1966-03-29,10,1990,2000,3,29,USA
Woodward William,1894-04-15,0,1916,1916,4,15,USA
Frederick William,1857-10-26,0,1879,1879,10,26,USA
Hyland,1888-08-06,0,1911,1911,8,6,USA
Thomas Francis,1862-03-04,5,1884,1889,3,4,USA
Joseph Brook,1863-03-23,9,1884,1893,3,23,USA
Lawrence Cyril,1947-11-26,15,1970,1985,11,26,USA
Jason Isidore,1988-01-10,2,2015,2017,1,10,USA
Lourdes Yunielki,1993-10-10,1,2018,2019,10,10,Cuba
Jandel Francisco,1992-10-12,3,2016,2019,10,12,D.R.
Ernest Herman Frank,1888-01-24,0,1911,1911,1,24,USA
Frank William,1920-02-20,11,1939,1950,2,20,USA
Charles Henry,1947-08-18,0,1972,1972,8,18,USA
Jeremy,1979-04-08,13,2004,2017,4,8,USA
Mark Andrew,1965-09-22,14,1989,2003,9,22,USA
Cesar Dario,1943-01-26,4,1967,1971,1,26,Venezuela
Franklin Rafael,1983-02-21,12,2005,2017,2,21,Venezuela
Joaquin Fernando,1960-06-27,5,1983,1988,6,27,Colombia
Juan Carlos,1983-07-14,7,2007,2014,7,14,Venezuela
Kelvin Manuel,1994-08-28,0,2019,2019,8,28,D.R.
Ricardo,1970-05-23,11,1993,2004,5,23,USA
Donald Joseph,1912-06-19,12,1936,1948,6,19,USA
Brandon Eric,1986-01-28,7,2011,2018,1,28,USA
Angel Moises,1981-12-14,3,2006,2009,12,14,Venezuela
Cristian,1978-03-21,11,1999,2010,3,21,D.R.
Domingo Serrano,1975-04-05,1,1999,2000,4,5,D.R.
Edwards,1976-09-11,4,1999,2003,9,11,P.R.
Freddy Antonio,1981-01-20,9,2004,2013,1,20,D.R.
Geraldo Moreno,1972-11-28,1,2000,2001,11,28,D.R.
Jesus Antonio,1984-06-14,5,2009,2014,6,14,Venezuela
Jose Alberto,1963-04-09,9,1985,1994,4,9,P.R.
Dionini Ramon,1971-01-21,1,1991,1992,1,21,D.R.
Irvin Joel Vigo,1984-11-24,1,2006,2007,11,24,D.R.
Juan Andres,1966-10-28,9,1991,2000,10,28,D.R.
Ronald Enmanuel,1994-10-20,1,2018,2019,10,20,D.R.
Santiago Donovan,1949-07-25,3,1969,1972,7,25,D.R.
Doug Wayne,1960-06-20,3,1981,1984,6,20,USA
Marcus Edwin,1977-11-04,0,2007,2007,11,4,USA
Christopher Karlton,1964-10-13,9,1987,1996,10,13,USA
Anthony Keith,1960-05-09,19,1982,2001,5,9,USA
Anthony Keith,1982-10-04,8,2006,2014,10,4,USA
Jedd Lindon,1988-09-23,6,2013,2019,9,23,USA
Richard Renald,1908-04-06,1,1933,1934,4,6,USA
Yamid Salcedo,1977-09-02,6,1999,2005,9,2,Colombia
Berthold John,1914-02-08,14,1937,1951,2,8,USA
Bruno Philip,1891-05-05,0,1915,1915,5,5,USA
Robert David,1965-10-19,2,1991,1993,10,19,USA
George Edwin,1935-05-26,3,1957,1960,5,26,USA
Eric Michael,1992-12-18,1,2018,2019,12,18,USA
Bryan Edmund,1956-04-22,11,1976,1987,4,22,USA
George William,1903-10-15,13,1925,1938,10,15,USA
Robert Julius,1926-02-13,2,1951,1953,2,13,USA
Emil Karl,1878-02-02,8,1901,1909,2,2,USA
John Gabriel,1964-01-29,11,1985,1996,1,29,USA
Irvin William,1873-06-05,0,1897,1897,6,5,USA
Eric Lynn,1983-03-26,3,2009,2012,3,26,USA
James Joseph,1877-10-01,1,1902,1903,10,1,USA
Mortimer Martin,1859-11-11,4,1883,1887,11,11,USA
Richard Warren,1947-10-06,0,1971,1971,10,6,USA
Walter Henry,1857-08-15,1,1884,1885,8,15,USA
Warren Louis,1924-11-21,13,1948,1961,11,21,USA
Luther Gean,1974-10-10,4,1999,2003,10,10,USA
Stanley Camfield,1909-12-06,15,1932,1947,12,6,USA
Harvey,1925-09-18,13,1952,1965,9,18,USA
George Silas,1866-12-25,6,1888,1894,12,25,USA
Josh Ronald,1994-04-07,2,2017,2019,4,7,USA
Irving Darius,1904-07-05,15,1926,1941,7,5,USA
Kent William,1934-12-17,2,1958,1960,12,17,USA
William Bernard,1894-07-18,13,1915,1928,7,18,USA
Milton Arnold,1912-10-09,7,1943,1950,10,9,USA
Charles Wallis,1983-09-19,4,2006,2010,9,19,USA
Daniel Albert,1912-08-06,4,1935,1939,8,6,USA
Charles James,1903-02-12,13,1924,1937,2,12,USA
Thomas Francis,1913-07-12,5,1939,1944,7,12,USA
Leo Edgar,1883-09-17,0,1906,1906,9,17,USA
Francis R.,1867-08-14,0,1888,1888,8,14,USA
Travis Lee,1977-06-03,11,2002,2013,6,3,USA
Nicholas Michael,1986-01-01,4,2011,2015,1,1,USA
Arthur Charles,1863-03-17,1,1883,1884,3,17,USA
Kurt Moritz,1887-05-12,3,1911,1914,5,12,USA
Bradin Carl,1989-05-12,0,2014,2014,5,12,USA
Kevin Eugene,1960-03-08,1,1983,1984,3,8,USA
Zerah Zequiel,1886-06-20,7,1909,1916,6,20,USA
Samuel Onofrio,1994-05-26,0,2019,2019,5,26,USA
Joe Clarence,1944-04-25,5,1968,1973,4,25,USA
Matthew Donald,1985-08-20,3,2012,2015,8,20,USA
Richard Frederick,1916-07-24,0,1940,1940,7,24,USA
Donald Antone,1948-11-16,6,1969,1975,11,16,USA
William Edgar,1875-08-27,5,1905,1910,8,27,USA
Frederick Aloys,1929-02-16,0,1952,1952,2,16,USA
Jesse Allen,1989-07-30,5,2014,2019,7,30,USA
Frank George,1879-04-29,7,1899,1906,4,29,USA
Harold Augustine,1897-12-21,14,1919,1933,12,21,USA
Edward E.,1867-02-07,0,1892,1892,2,7,USA
Henry Luther,1898-12-23,0,1923,1923,12,23,USA
Jesse Joseph,1893-07-22,19,1918,1937,7,22,USA
Jerry Wayne,1952-02-16,16,1973,1989,2,16,USA
Jerry Wayne,1976-05-29,15,1998,2013,5,29,USA
John Louis,1944-08-27,0,1969,1969,8,27,USA
Samuel Harding,1920-01-20,0,1951,1951,1,20,USA
Scott Alexander,1980-05-25,10,2004,2014,5,25,USA
James Clifton,1891-08-04,0,1913,1913,8,4,USA
Chester,1918-07-21,0,1941,1941,7,21,USA
David Vincent,1967-10-14,1,1995,1996,10,14,USA
John Thadeuz,1972-02-22,8,1998,2006,2,22,USA
George Stanley,1895-02-02,0,1919,1919,2,2,USA
Edward Lonzo,1860-02-02,0,1882,1882,2,2,USA
John Avery,1855-12-02,0,1877,1877,12,2,USA
Robert Houston,1933-11-07,6,1955,1961,11,7,USA
Walter William,1964-12-02,8,1989,1997,12,2,USA
Ray Luther,1880-02-18,0,1902,1902,2,18,USA
David E.,1987-09-27,6,2013,2019,9,27,USA
George Wagner,1894-08-03,4,1914,1918,8,3,USA
John Steven,1953-08-05,5,1974,1979,8,5,USA
Arvel Odell,1908-08-10,10,1931,1941,8,10,USA
Samuel Douglas,1896-09-10,10,1920,1930,9,10,USA
Justin Case,1991-06-16,1,2017,2018,6,16,USA
Raymond Timothy,1891-01-23,2,1915,1917,1,23,USA
Edward Louis,1950-10-04,6,1974,1980,10,4,USA
William Anthony,1902-08-04,13,1925,1938,8,4,USA
John Arthur,1884-05-13,0,1905,1905,5,13,USA
Albert,1958-03-07,8,1981,1989,3,7,USA
Harry Leroy,1977-05-14,15,1998,2013,5,14,USA
Herbert Earl,1889-10-15,0,1911,1911,10,15,USA
William Bernard,1894-02-22,0,1913,1913,2,22,USA
William Lemuel,1928-07-30,4,1954,1958,7,30,USA
William,1979-12-28,10,2002,2012,12,28,USA
Robert Prill,1878-12-20,1,1904,1905,12,20,USA
Robert Louis,1923-12-22,4,1949,1953,12,22,USA
Charles Walter,1863-08-24,0,1887,1887,8,24,USA
Charles Louis,1884-07-27,12,1906,1918,7,27,USA
Cody Kevin,1988-01-06,1,2015,2016,1,6,USA
Michael Darren,1964-07-14,4,1994,1998,7,14,USA
Richard Wallace,1930-09-27,19,1952,1971,9,27,USA
Andrew Clark,1963-03-27,4,1986,1990,3,27,USA
Jack Price,1914-11-13,8,1940,1948,11,13,USA
Thomas Frank,1937-06-23,11,1961,1972,6,23,USA
George William,1849-03-29,6,1871,1877,3,29,United Kingdom
Herbert Silas,1893-06-05,0,1918,1918,6,5,USA
Edward S.,1888-08-23,1,1911,1912,8,23,USA
James H.,1849-05-27,7,1871,1878,5,27,Ireland
William E.,1868-12-08,2,1890,1892,12,8,USA
Newton Schurz,1896-06-18,0,1916,1916,6,18,USA
Irvin Gladstone,1918-10-07,3,1943,1946,10,7,USA
Jimmie Randolph,1938-03-07,7,1963,1970,3,7,USA
John Sylvester,1924-01-09,0,1948,1948,1,9,USA
Joseph Geroy,1966-03-06,3,1994,1997,3,6,USA
Joshua Alan,1980-12-16,0,2003,2003,12,16,USA
Marcus,1887-08-12,4,1910,1914,8,12,USA
Matthew Thomas,1993-07-23,1,2018,2019,7,23,USA
William Wilson,1867-03-31,15,1888,1903,3,31,USA
William Harry,1876-03-15,6,1901,1907,3,15,USA
Melvin,1960-09-16,15,1981,1996,9,16,USA
Robert Russell,1871-09-29,3,1898,1901,9,29,USA
Charles Emil,1863-01-22,0,1885,1885,1,22,Sweden
Tom Edward,1947-11-23,9,1968,1977,11,23,USA
Toby Jason,1975-10-21,8,2000,2008,10,21,USA
Gregory Anthony,1987-08-26,1,2010,2011,8,26,Netherlands
James Nathaniel,1863-10-04,3,1882,1885,10,4,United Kingdom
Bradford Alexander,1981-02-14,2,2004,2006,2,14,USA
Alva William,1890-11-23,4,1914,1918,11,23,USA
Shane David,1969-11-08,7,1997,2004,11,8,USA
Sean Michael,1987-06-07,0,2013,2013,6,7,USA
Elmer Joseph,1900-12-21,0,1922,1922,12,21,USA
Roger Dee,1949-03-26,0,1971,1971,3,26,USA
Charles H.,1866-11-22,0,1890,1890,11,22,USA
Mark John,1987-02-05,0,2011,2011,2,5,USA
James Sanford,1897-07-29,1,1926,1927,7,29,USA
Robert James,1967-11-29,5,1993,1998,11,29,USA
Colbert Michael,1983-12-27,13,2006,2019,12,27,USA
William Robert,1866-02-15,13,1888,1901,2,15,USA
Billy R.,1990-09-09,6,2013,2019,9,9,USA
David Edward,1947-12-13,8,1972,1980,12,13,USA
Darryl Quinn,1964-12-03,13,1988,2001,12,3,USA
Earl Andrew,1891-07-19,13,1911,1924,7,19,USA
Ian Francis,1995-06-16,0,2018,2018,6,16,USA
Jack Edwin,1938-12-25,7,1962,1969,12,25,USA
Jeffrey Robert,1964-03-19,5,1986,1991,3,19,USA
John Alexander Charles,1860-12-18,0,1884,1884,12,18,USA
Johns Joseph,1970-09-09,9,1994,2003,9,9,USA
Joshua Holt,1981-05-21,8,2007,2015,5,21,USA
Mark Alan,1984-07-29,1,2010,2011,7,29,USA
Steven Absher,1934-11-30,11,1961,1972,11,30,USA
Thomas Bail,1925-09-29,1,1952,1953,9,29,USA
Kenneth Lee,1935-05-18,9,1957,1966,5,18,USA
Lewis Dennison,1904-07-03,11,1933,1944,7,3,USA
Charlton Atlee,1958-01-24,14,1981,1995,1,24,USA
Jason Aaron,1982-09-02,12,2006,2018,9,2,USA
John Dale,1994-07-12,0,2019,2019,7,12,USA
Christopher Andrew,1966-01-21,16,1990,2006,1,21,USA
Walter Charles,1891-02-26,7,1915,1922,2,26,USA
Jeffrey Bryan,1971-03-05,12,1993,2005,3,5,USA
Robert Wade,1977-05-13,8,2003,2011,5,13,USA
Steven Benjamin,1957-05-09,0,1982,1982,5,9,USA
Peter Whitfield,1947-09-20,1,1970,1971,9,20,USA
Wesley Garvin,1924-03-18,0,1945,1945,3,18,USA
Granville Wilbur,1927-04-26,18,1944,1962,4,26,USA
Ralph Conant,1916-09-12,3,1946,1949,9,12,USA
Garrett Reese,1994-10-10,1,2018,2019,10,10,USA
Justin Michael,1980-05-24,6,2006,2012,5,24,USA
Isaac Bernard,1951-08-22,5,1974,1979,8,22,USA
Michael William,1972-09-09,17,1993,2010,9,9,USA
Erik Kendall,1986-08-21,0,2011,2011,8,21,USA
Odbert Herman,1928-03-01,3,1955,1958,3,1,USA
Raymond Bernard,1921-08-01,1,1943,1944,8,1,USA
Timothy William,1976-11-14,1,2005,2006,11,14,USA
Morris Medlock,1914-08-30,0,1940,1940,8,30,USA
Fred James,1920-03-28,0,1949,1949,3,28,USA
Ronald Garry,1954-01-23,6,1978,1984,1,23,USA
Joshua Morgan,1978-04-11,5,2002,2007,4,11,USA
Justin D.,1990-10-28,0,2018,2018,10,28,USA
Leland David,1967-06-27,1,1995,1996,6,27,USA
Ryan Lee,1971-11-11,0,1996,1996,11,11,USA
Bradley Richard,1990-03-20,8,2011,2019,3,20,USA
Donovan Jay,1986-04-20,2,2013,2015,4,20,USA
James Edward,1866-07-17,0,1886,1886,7,17,USA
Aloysius James,1887-07-21,0,1911,1911,7,21,USA
Eugene Louis,1914-11-25,1,1946,1947,11,25,USA
Lee Elmer,1913-07-13,11,1936,1947,7,13,USA
Richard Allen,1948-07-10,3,1970,1973,7,10,USA
James Vernon,1936-11-27,2,1964,1966,11,27,CAN
William Alfred,1940-05-06,10,1965,1975,5,6,USA
Harry Aloysius,1927-11-12,6,1953,1959,11,12,USA
Christopher Deane,1968-11-16,11,1991,2002,11,16,USA
Fred Girard,1896-04-25,7,1922,1929,4,25,USA
Wallace Larry,1942-11-19,12,1966,1978,11,19,USA
Todd Michael,1965-07-30,6,1992,1998,7,30,USA
Charles Joseph,1882-06-03,1,1914,1915,6,3,United Kingdom
Eric Dru,1993-11-01,0,2018,2018,11,1,USA
Mitchell Evan,1990-12-23,3,2016,2019,12,23,USA
Ryan Michael,1980-08-16,10,2007,2017,8,16,USA
Donald Wayne,1902-02-09,0,1927,1927,2,9,USA
Frank Edward,1856-04-29,10,1878,1888,4,29,USA
Jay Nelson,1935-11-07,2,1961,1963,11,7,USA
James Patrick,1885-10-13,0,1913,1913,10,13,USA
William Joseph,1876-06-24,0,1903,1903,6,24,USA
Edward Hugh,1857-08-22,12,1880,1892,8,22,USA
Gerald Ellis,1953-03-06,3,1976,1979,3,6,USA
John Joseph,1980-03-04,8,2006,2014,3,4,USA
James John,1940-01-07,9,1962,1971,1,7,USA
John,1863-11-03,0,1884,1884,11,3,USA
Preston Lee,1954-09-10,7,1975,1982,9,10,USA
James Harrison,1889-06-05,2,1918,1920,6,5,USA
Jacob Howard,1991-04-29,0,2017,2017,4,29,USA
John Joseph,1883-02-25,2,1906,1908,2,25,USA
Loy Vernon,1917-10-18,3,1939,1942,10,18,USA
Patrick James,1866-04-20,0,1897,1897,4,20,CAN
Joel Ryan,1981-10-06,6,2007,2013,10,6,USA
Devern Brandon,1978-02-05,2,2006,2008,2,5,Nicaragua
Andrew Viggo,1924-11-12,9,1944,1953,11,12,USA
Robert Joseph,1948-05-26,2,1974,1976,5,26,USA
Craig Robert,1983-11-15,4,2005,2009,11,15,USA
David Andrew,1968-11-24,15,1990,2005,11,24,USA
Douglas William,1928-12-16,0,1951,1951,12,16,USA
Gregory Michael,1971-03-12,4,1995,1999,3,12,USA
Jed Ramon,1972-08-19,2,1997,1999,8,19,USA
Roy Inglof,1898-03-06,0,1918,1918,3,6,USA
Ronald Lavern,1938-04-05,14,1958,1972,4,5,USA
Roy Emil Frederick,1907-02-21,5,1930,1935,2,21,USA
Frank Cicero,1874-12-26,0,1898,1898,12,26,USA
Donald Thomas,1916-02-27,1,1943,1944,2,27,USA
Alen Rery,1992-10-22,3,2016,2019,10,22,D.R.
Erik Brian,1965-05-18,10,1988,1998,5,18,USA
Harry Francis,1896-01-17,0,1913,1913,1,17,USA
Earl Sylvester,1896-01-19,0,1921,1921,1,19,USA
Thomas J.,1986-08-28,4,2009,2013,8,28,USA
Edward Michael,1920-09-18,4,1942,1946,9,18,USA
John Clifford,1901-05-18,0,1923,1923,5,18,USA
Ian Edward,1994-08-12,2,2017,2019,8,12,USA
James Anthony,1982-10-19,12,2007,2019,10,19,USA
Aaron Michael,1978-05-09,13,2002,2015,5,9,USA
William Albert,1855-03-29,9,1875,1884,3,29,USA
Melvin Leroy,1909-10-15,19,1928,1947,10,15,USA
James Richard,1981-11-30,8,2003,2011,11,30,CAN
Scott Durbin,1870-01-26,0,1899,1899,1,26,USA
William Henry,1895-05-10,0,1918,1918,5,10,USA
William Edgar,1922-06-14,0,1952,1952,6,14,USA
Charles Harold,1891-01-03,0,1913,1913,1,3,USA
James Warren,1943-08-06,5,1967,1972,8,6,USA
Louis Winfred,1864-08-24,7,1884,1891,8,24,USA
Edward,1865-03-02,0,1886,1886,3,2,USA
Jason Robert,1971-09-15,2,1996,1998,9,15,USA
David Alexander,1876-09-30,1,1902,1903,9,30,CAN
Blaine Patrick,1987-03-14,5,2014,2019,3,14,USA
Carroll William,1933-05-18,9,1958,1967,5,18,USA
Harry,1875-11-05,1,1905,1906,11,5,USA
John Doolittle,1877-06-23,7,1903,1910,6,23,USA
John Graydon,1959-10-08,0,1989,1989,10,8,USA
James Jerry,1982-08-19,12,2005,2017,8,19,USA
Howard Lawrence,1948-01-10,2,1974,1976,1,10,USA
Francis Joseph,1923-01-06,0,1951,1951,1,6,USA
Daniel John,1980-09-17,12,2003,2015,9,17,USA
Shawn Robert,1967-03-26,4,1991,1995,3,26,USA
Steven Lowell,1942-09-08,12,1965,1977,9,8,USA
Alan Robert,1954-11-21,6,1980,1986,11,21,USA
Gary Lynn,1956-11-02,0,1979,1979,11,2,USA
Eugene Franklin,1892-07-15,17,1913,1930,7,15,USA
Charles Russell,1896-12-14,7,1923,1930,12,14,USA
Dudley Michael,1949-10-26,11,1974,1985,10,26,USA
William McKinley,1896-01-31,10,1923,1933,1,31,USA
Timothy Allan,1971-07-15,12,1995,2007,7,15,USA
Michael Anthony,1966-10-25,9,1988,1997,10,25,USA
John Joseph,1859-04-12,4,1884,1888,4,12,USA
Frederick Harvey,1887-12-13,1,1910,1911,12,13,USA
Thomas William,1937-12-23,3,1961,1964,12,23,CAN
Richard Joseph,1872-09-25,6,1897,1903,9,25,USA
Henry Risk,1874-08-18,0,1905,1905,8,18,USA
Larry Duane,1951-11-13,6,1975,1981,11,13,USA
William Bell,1919-01-02,0,1941,1941,1,2,USA
Bradley Christopher,1985-11-19,0,2008,2008,11,19,Australia
Robert Green,1887-10-15,9,1909,1918,10,15,USA
Charles Byron,1924-04-23,3,1954,1957,4,23,USA
Terry Walter,1944-04-12,10,1967,1977,4,12,USA
Peter Thomas,1966-09-23,13,1988,2001,9,23,USA
William Homer,1889-06-14,0,1911,1911,6,14,USA
Brian David,1959-10-16,16,1979,1995,10,16,USA
Brandon Scott,1976-04-29,0,2006,2006,4,29,USA
Bryce Aron Max,1992-10-16,7,2012,2019,10,16,USA
John George,1866-08-17,2,1894,1896,8,17,USA
George Washington,1892-06-24,13,1916,1929,6,24,USA
Harry Clayton,1895-04-24,10,1913,1923,4,24,USA
Charles William,1878-04-02,7,1899,1906,4,2,USA
John Wesley,1893-08-05,0,1915,1915,8,5,USA
Ryne Richard,1989-03-27,0,2019,2019,3,27,USA
Terry Joe,1955-08-19,7,1980,1987,8,19,USA
Tommy,1940-10-14,14,1962,1976,10,14,USA
Travis Boyd,1976-05-21,6,2000,2006,5,21,USA
Colbert Dale,1948-10-26,17,1969,1986,10,26,USA
William,1928-07-18,6,1955,1961,7,18,USA
William Charles,1945-11-17,0,1968,1968,11,17,USA
Derrel McKinley,1944-06-06,15,1965,1980,6,6,USA
John Robert,1947-11-27,0,1969,1969,11,27,USA
Kenneth Smith,1941-09-04,8,1963,1971,9,4,USA
Lucas William Bradley,1985-06-03,7,2010,2017,6,3,USA
Raymond James,1912-02-16,10,1935,1945,2,16,USA
Oscar Martin,1890-07-31,0,1912,1912,7,31,USA
Andrew Francis,1888-11-13,0,1913,1913,11,13,USA
Andrew Matthew,1903-02-12,0,1925,1925,2,12,USA
Ben Franklin,1889-12-17,1,1914,1915,12,17,USA
William Milton,1900-06-23,15,1923,1938,6,23,USA
William Womble,1927-10-03,3,1953,1956,10,3,USA
William Thomas,1930-12-03,2,1957,1959,12,3,CAN
James William,1943-11-24,1,1968,1969,11,24,USA
Robert Arthur,1915-05-01,4,1938,1942,5,1,USA
Robert Lee,1930-09-22,1,1955,1956,9,22,USA
Brendan Michael,1980-08-26,9,2004,2013,8,26,USA
Stanley Raymond,1896-11-08,12,1919,1931,11,8,USA
Charles,1926-02-15,3,1948,1951,2,15,USA
Walter Francis,1948-12-05,1,1970,1971,12,5,USA
Alonzo,1947-09-17,0,1967,1967,9,17,USA
Charles Jenkins,1877-10-21,0,1899,1899,10,21,USA
Charles William,1941-04-25,6,1965,1971,4,25,USA
David Stanley,1900-07-14,9,1925,1934,7,14,USA
Dennis Scott,1969-07-21,0,1998,1998,7,21,USA
Donald,1967-11-12,2,1991,1993,11,12,USA
Earl,1919-04-20,8,1945,1953,4,20,USA
Boyd Gail,1931-10-15,5,1955,1960,10,15,USA
Tyrone Eugene,1964-12-05,6,1989,1995,12,5,USA
Greg Allen,1955-11-02,14,1981,1995,11,2,USA
Gregory Wade,1963-12-01,7,1988,1995,12,1,USA
Herbert Benjamin,1913-04-24,0,1936,1936,4,24,USA
Jeremiah Peter,1868-08-12,3,1890,1893,8,12,USA
Jeffrey Austin,1974-07-04,1,2005,2006,7,4,USA
Joseph C.,1869-12-21,1,1895,1896,12,21,USA
Joseph Lionel White,1882-02-01,2,1905,1907,2,1,USA
Joseph,1891-05-20,14,1914,1928,5,20,USA
John Thomas,1954-09-13,2,1979,1981,9,13,USA
Joshua Isaiah,1987-07-08,8,2011,2019,7,8,USA
Leonard Anthony,1964-10-28,17,1988,2005,10,28,USA
Chalmer Luman,1915-01-17,6,1941,1947,1,17,USA
Matthew Reid,1985-09-16,7,2008,2015,9,16,USA
Maurice Charles,1917-01-30,12,1940,1952,1,30,USA
Charles Michael,1934-10-08,0,1963,1963,10,8,USA
Mitchell Andrew,1985-11-07,0,2015,2015,11,7,USA
Robert Ned,1916-07-09,5,1941,1946,7,9,USA
Hernando Petrocelli,1972-09-23,2,1996,1998,9,23,USA
Reginald Allen,1968-08-12,9,1990,1999,8,12,USA
Washington Ritter,1849-09-16,0,1875,1875,9,16,USA
Roric Edward,1946-09-20,6,1972,1978,9,20,USA
William Jennings Bryan,1897-12-11,8,1920,1928,12,11,USA
Anthony Spencer,1900-08-12,5,1925,1930,8,12,USA
Thomas James,1945-01-18,0,1965,1965,1,18,CAN
Victor Lanier,1950-03-27,8,1972,1980,3,27,USA
William Charles,1978-06-22,11,2001,2012,6,22,USA
William Taylor,1984-08-28,7,2012,2019,8,28,USA
William,1881-10-16,NA,NA,NA,10,16,USA
John Elvin,1927-07-12,12,1948,1960,7,12,USA
Samuel,1910-04-24,3,1937,1940,4,24,USA
Oscar Theander,1892-05-24,0,1915,1915,5,24,USA
William Franklin,1865-07-19,15,1886,1901,7,19,USA
Robert Lee,1866-05-16,0,1890,1890,5,16,USA
William Woodrow,1913-03-04,2,1943,1945,3,4,USA
Bodhi J.,1976-09-27,1,2003,2004,9,27,USA
James John,1875-11-27,0,1901,1901,11,27,USA
Jon Corey,1982-03-24,11,2004,2015,3,24,USA
Donnie Scott,1990-09-06,3,2016,2019,9,6,USA
Charles Oscar,1942-05-26,12,1965,1977,5,26,USA
Franklin Pierce,1886-09-19,2,1912,1914,9,19,USA
Bruce Daniel,1892-05-14,0,1914,1914,5,14,USA
Dean Charles,1966-08-12,3,1995,1998,8,12,USA
James Henry,1878-02-02,2,1905,1907,2,2,USA
Jason Wyatt,1977-09-05,0,2002,2002,9,5,USA
Christian Henry,1915-03-25,0,1939,1939,3,25,USA
James Ray,1941-10-30,11,1963,1974,10,30,USA
James Abner,1855-07-10,NA,NA,NA,7,10,USA
John Henry,1948-07-21,NA,NA,NA,7,21,USA
Kevin Richard,1982-12-29,2,2007,2009,12,29,USA
Walter Scott,1880-08-22,0,1902,1902,8,22,USA
Geoffery Thomas,1993-12-09,0,2019,2019,12,9,USA
Grover Allen,1888-07-02,23,1911,1934,7,2,USA
Michael Edward,1961-08-31,6,1989,1995,8,31,USA
Robert Louis,1937-08-28,3,1959,1962,8,28,USA
Charles Otto,1888-08-10,0,1908,1908,8,10,USA
Frederick Orrin,1865-04-21,8,1894,1902,4,21,USA
James Michael,1951-12-20,0,1980,1980,12,20,USA
Michael Lawrence,1958-02-17,3,1984,1987,2,17,USA
J C,1934-04-15,1,1962,1963,4,15,USA
Charles Leo,1900-12-20,19,1922,1941,12,20,USA
Patrick J.,1863-10-20,0,1890,1890,10,20,USA
Raymond Joseph,1890-09-19,0,1913,1913,9,19,USA
Gregory Rudolph,1950-04-21,0,1973,1973,4,21,USA
Jeffrey Roger,1966-11-19,0,1992,1992,11,19,USA
Roy Thomas,1925-10-25,2,1950,1952,10,25,USA
Tully Frederick,1874-06-26,13,1898,1911,6,26,USA
Thomas Henry,1869-06-15,0,1891,1891,6,15,USA
Clinton Clarence,1922-08-10,5,1947,1952,8,10,USA
Paul Franklin,1953-11-02,8,1976,1984,11,2,USA
Roy Allen,1881-07-06,10,1906,1916,7,6,USA
Bryan Stanley,1963-06-02,8,1987,1995,6,2,USA
Harold Douglas,1930-03-03,NA,NA,NA,3,3,USA
Hunter Luke,1994-12-09,0,2019,2019,12,9,USA
Joseph Robert,1992-01-09,0,2019,2019,1,9,USA
Kenneth Eugene,1978-03-01,4,2001,2005,3,1,USA
Luther Raymond,1905-09-30,0,1928,1928,9,30,USA
Matthew Edward,1989-03-27,7,2012,2019,3,27,USA
Ervin King,1879-01-05,2,1900,1902,1,5,USA
Chad Ashley,1976-09-16,7,1999,2006,9,16,USA
Robert Lyndon,1893-11-21,1,1916,1917,11,21,USA
Shigetoshi,1968-08-01,8,1997,2005,8,1,Japan
Adam Donald,1996-04-12,0,2019,2019,4,12,USA
William Joseph,1966-05-25,13,1990,2003,5,25,USA
Donald Irvin,1927-04-04,1,1945,1946,4,4,USA
Herbert Howard,1911-02-13,1,1940,1941,2,13,USA
Michael Joseph,1909-10-25,5,1933,1938,10,25,USA
Peter James,1865-05-26,0,1890,1890,5,26,United Kingdom
Alexander Edward,1988-04-01,0,2014,2014,4,1,USA
William Louis,1864-07-26,2,1894,1896,7,26,USA
John Aloysius,1911-09-05,6,1936,1942,9,5,USA
Ronald William,1953-02-27,13,1978,1991,2,27,USA
Andrew Earl,1951-10-18,14,1971,1985,10,18,USA
Joseph Frederick,1905-04-07,2,1928,1930,4,7,USA
Charles Eugene,1915-07-20,1,1937,1938,7,20,USA
Charles Morton,1870-11-11,5,1893,1898,11,11,USA
Winfield Scott,1847-08-10,6,1871,1877,8,10,USA
Robert Keller,1896-05-03,5,1919,1924,5,3,USA
William Augustus,1960-10-04,11,1984,1995,10,4,USA
Christopher Kenneth,1969-01-07,0,1998,1998,1,7,USA
David Christopher,1985-01-12,8,2010,2018,1,12,USA
Michael Vaughn,1955-03-15,11,1979,1990,3,15,USA
Fred James,1925-03-18,8,1950,1958,3,18,USA
Gilbert,1855-01-27,10,1885,1895,1,27,USA
John Van Buskirk,1847-07-20,5,1871,1876,7,20,USA
Hillary Houston,1969-09-12,1,1992,1993,9,12,USA
Ray Wilson,1916-10-13,0,1945,1945,10,13,USA
Steven Ryland,1990-09-13,0,2016,2016,9,13,USA
Marcus Allen,1988-03-26,0,2015,2015,3,26,USA
Clyde Melno,1908-08-07,2,1935,1937,8,7,USA
Joseph Hilarian,1916-11-07,6,1946,1952,11,7,USA
Scott Allen,1969-12-14,13,1995,2008,12,14,USA
John Duane,1980-02-27,0,2006,2006,2,27,Guam
Grady Edgebert,1922-10-07,14,1946,1960,10,7,USA
John Arthur,1891-11-18,0,1912,1912,11,18,USA
Christopher Francis,1925-10-03,0,1943,1943,10,3,USA
Gary Allen,1970-09-29,0,1997,1997,9,29,USA
Philip Donald,1924-02-23,5,1947,1952,2,23,USA
Michael,1990-01-22,1,2017,2018,1,22,USA
Arnold George,1888-09-25,5,1910,1915,9,25,USA
Joseph John,1899-01-12,7,1922,1929,1,12,USA
Clemens Ray,1919-08-17,5,1944,1949,8,17,USA
George John,1916-02-11,5,1944,1949,2,11,USA
Thomas Matthew,1953-03-31,7,1975,1982,3,31,USA
Charles A.,1852-02-05,9,1875,1884,2,5,USA
Bradley David,1959-11-17,8,1981,1989,11,17,USA
Ryan Wade,1971-04-30,0,1996,1996,4,30,USA
William Hildreth,1853-11-17,5,1879,1884,11,17,USA
Roy Lee,1926-07-05,0,1951,1951,7,5,USA
William Victor,1870-04-28,2,1892,1894,4,28,USA
Edward,1888-02-22,0,1911,1911,2,22,USA
Thorndike Proctor,1852-10-15,5,1879,1884,10,15,USA
Melton Andrew,1960-01-21,9,1982,1991,1,21,USA
LaTroy,1972-12-21,20,1995,2015,12,21,USA
Wynn Firth,1936-02-20,2,1960,1962,2,20,USA
Blake Edward,1983-03-01,2,2009,2011,3,1,CAN
Nelson Louis,1896-02-03,4,1921,1925,2,3,USA
Emerson Pink,1872-12-05,9,1892,1901,12,5,USA
Homer Harold,1893-08-27,0,1915,1915,8,27,USA
Bradley Bonte,1979-06-22,9,2004,2013,6,22,USA
John Harold,1944-07-09,1,1970,1971,7,9,USA
John Francis,1880-10-21,7,1901,1908,10,21,USA
Eugene Franklin,1935-04-14,0,1958,1958,4,14,USA
Ben Joseph,1957-08-04,1,1982,1983,8,4,USA
William Ernest,1957-10-24,1,1980,1981,10,24,USA
Brett Gregory,1984-02-13,6,2009,2015,2,13,USA
Charles Dewayne,1965-05-29,13,1988,2001,5,29,USA
Andrew Trent,1987-09-03,0,2016,2016,9,3,USA
Franklin Witman,1914-10-13,14,1933,1947,10,13,USA
John J.,1861-06-27,8,1882,1890,6,27,USA
Minter Carney,1906-07-19,13,1927,1940,7,19,USA
James Millard,1913-02-11,0,1935,1935,2,11,USA
Von Francis,1958-08-31,11,1981,1992,8,31,USA
Dirk Von,1981-03-24,1,2008,2009,3,24,USA
Fred Ames,1871-11-03,0,1890,1890,11,3,USA
Heath Burnett,1968-11-30,0,1994,1994,11,30,USA
Jimmy Wayne,1972-09-05,9,1995,2004,9,5,USA
Joseph Walton,1917-09-21,13,1939,1952,9,21,USA
Nathan Raymond Quinn,1979-09-07,1,2007,2008,9,7,USA
Austin Charles Brian,1995-07-05,2,2017,2019,7,5,USA
Raymond Alton,1961-04-27,2,1986,1988,4,27,USA
William Kiernan,1937-04-21,0,1968,1968,4,21,Panama
Raymond Hall,1904-01-29,19,1926,1945,1,29,USA
Myron Claude,1916-05-14,1,1944,1945,5,14,USA
Jeremy Philip,1987-08-14,1,2016,2017,8,14,USA
Drungo LaRue,1959-09-02,0,1980,1980,9,2,USA
Robert Sidney,1930-12-09,3,1955,1958,12,9,USA
Willard Carpenter,1876-08-28,0,1902,1902,8,28,USA
Edward Marvin,1918-01-25,6,1940,1946,1,25,USA
Jerad Lee,1982-11-15,0,2011,2011,11,15,USA
Chase Jordan,1984-05-09,11,2007,2018,5,9,USA
Ralph,1893-08-30,0,1923,1923,8,30,USA
Francis Xavier Paul,1910-07-29,4,1930,1934,7,29,USA
Francis Xavier,1946-09-06,9,1969,1978,9,6,USA
John J.,1866-10-27,7,1885,1892,10,27,USA
Ryon Christopher,1992-01-10,3,2016,2019,1,10,USA
Thomas Fitzgerald,1895-10-30,1,1915,1916,10,30,USA
Andrew M.,1991-06-05,5,2014,2019,6,5,USA
Charles,1872-01-30,0,1890,1890,1,30,USA
Jehosie,1920-01-17,0,1954,1954,1,17,USA
Charles Bunn,1891-05-21,10,1910,1920,5,21,USA
Elmer Lafayette,1904-01-13,3,1926,1929,1,13,USA
Edmund,1887-09-17,0,1910,1910,9,17,USA
Edward John,1960-08-23,2,1986,1988,8,23,USA
Hugh Joseph,1873-04-18,2,1901,1903,4,18,USA
James Tolbert,1921-04-11,12,1947,1959,4,11,USA
Taylor Lynn,1994-08-30,0,2019,2019,8,30,USA
Jeffrey Vernon,1961-11-19,1,1985,1986,11,19,USA
William Chris,1939-03-10,4,1965,1969,3,10,USA
Clifton Earl,1898-01-24,14,1918,1932,1,24,USA
Deunte Raymon,1985-08-08,1,2012,2013,8,8,USA
John Geoffrey,1915-04-01,13,1936,1949,4,1,CAN
Ronald Jeffrey,1959-11-18,5,1983,1988,11,18,USA
Kelly Mark,1957-09-04,0,1982,1982,9,4,USA
Minor Wilson,1903-10-30,1,1931,1932,10,30,USA
Michael Thomas,1955-02-05,13,1978,1991,2,5,USA
Michael Joseph,1969-05-16,0,1998,1998,5,16,USA
Zachary Slade,1990-09-28,0,2015,2015,9,28,USA
Spencer Paul,1893-11-05,0,1920,1920,11,5,USA
Thomas George,1913-08-18,3,1935,1938,8,18,USA
Neal,1960-03-03,11,1982,1993,3,3,USA
David Wallace,1950-08-25,6,1975,1981,8,25,USA
Wallace Andrew,1907-08-21,12,1931,1943,8,21,USA
Richard Joseph,1947-11-26,17,1968,1985,11,26,USA
Bryan McCall,1976-03-12,0,2003,2003,3,12,USA
Adeiny,1989-04-15,7,2012,2019,4,15,Cuba
Michael Vincent,1890-02-14,1,1912,1913,2,14,USA
Guy Jackson,1856-04-03,8,1882,1890,4,3,USA
Austin Charles,1992-08-18,4,2015,2019,8,18,USA
Harry Malcolm,1888-09-04,0,1913,1913,9,4,USA
Michael David,1946-08-11,7,1965,1972,8,11,USA
Daniel William,1957-07-03,12,1979,1991,7,3,USA
Bertram Alexander,1965-03-03,0,1992,1992,3,3,USA
Robert Frederic,1938-09-13,5,1963,1968,9,13,USA
Donald Henry,1911-02-08,10,1934,1944,2,8,USA
Bronson Wayne,1971-08-29,0,1996,1996,8,29,USA
Randolph Rutherford,1918-09-11,1,1945,1946,9,11,USA
Jeremy Scott,1986-03-11,1,2012,2013,3,11,USA
James Edward,1920-08-03,19,1941,1960,8,3,USA
James Michael,1942-07-21,13,1964,1977,7,21,USA
Robert Hilmer,1958-02-26,0,1985,1985,2,26,USA
Herman Charles,1899-12-10,0,1918,1918,12,10,USA
Jack Seale,1949-07-11,8,1969,1977,7,11,USA
R Emmet,1876-07-29,10,1898,1908,7,29,USA
Franklin,1854-01-18,0,1875,1875,1,18,USA
Louis Wilbur,1861-07-04,NA,NA,NA,7,4,USA
John George,1872-08-10,0,1901,1901,8,10,USA
Aaron Michael,1978-11-12,8,2003,2011,11,12,USA
Harry Edwin,1894-08-03,18,1914,1932,8,3,USA
Frederick Amos,1901-01-27,13,1920,1933,1,27,USA
Gorman John,1955-09-24,1,1983,1984,9,24,USA
Val Raymond,1920-11-04,0,1942,1942,11,4,USA
William Henry,1900-09-22,0,1921,1921,9,22,USA
Scott Matthew,1992-12-04,0,2019,2019,12,4,USA
Tyler Andrew,1991-06-19,0,2019,2019,6,19,USA
Donald Elliott,1959-10-20,1,1988,1989,10,20,USA
Christopher John,1974-08-06,2,2005,2007,8,6,USA
Kenneth Alphonse,1915-10-14,15,1937,1952,10,14,USA
Thomas Kenneth,1946-11-03,5,1973,1978,11,3,USA
John Peter,1863-09-27,0,1886,1886,9,27,USA
Robert Lowell,1947-05-12,10,1967,1977,5,12,USA
Chris J.,1984-12-14,7,2010,2017,12,14,USA
Clarence Edward,1907-08-07,0,1934,1934,8,7,USA
James Edward,1930-10-02,0,1957,1957,10,2,USA
Richard Michael,1973-02-22,0,1999,1999,2,22,USA
Leroy Barton,1942-06-22,0,1961,1961,6,22,USA
Christian Ernst,1880-04-16,1,1901,1902,4,16,USA
Alfred Michael,1927-10-05,2,1960,1962,10,5,USA
Henry Anton,1896-10-06,0,1918,1918,10,6,USA
William Frederick,1883-05-25,1,1909,1910,5,25,USA
Melvin Nicholas,1929-04-12,0,1956,1956,4,12,USA
Woodson George,1932-03-25,15,1954,1969,3,25,USA
Eric James,1969-03-25,2,1993,1995,3,25,USA
Henry Hartz,1913-08-26,8,1938,1946,8,26,USA
Emory Wilbur,1890-10-09,0,1915,1915,10,9,USA
Benjamin,1991-08-05,3,2016,2019,8,5,USA
Jeremy Robert,1987-04-08,9,2010,2019,4,8,USA
Ricky Allen,1970-12-15,12,1994,2006,12,15,USA
Anthony Joseph,1861-05-29,0,1886,1886,5,29,USA
Johnny David,1988-10-29,0,2013,2013,10,29,USA
Horace Willing,1867-08-27,0,1890,1890,8,27,USA
Tommy Vann,1941-05-05,13,1964,1977,5,5,USA
Wesley Ray,1976-05-12,13,1998,2011,5,12,USA
Ryan Dalton,1994-07-18,0,2019,2019,7,18,USA
Todd Lynn,1973-08-20,16,1997,2013,8,20,USA
William Wade,1913-12-21,1,1943,1944,12,21,USA
Russell Frederick,1933-02-10,0,1961,1961,2,10,USA
Richard Heath,1989-01-13,6,2013,2019,1,13,USA
Edson Marshall,1893-05-08,4,1914,1918,5,8,USA
George Earl,1868-12-15,7,1890,1897,12,15,USA
Roland,1929-10-26,NA,NA,NA,10,26,USA
Scott Mathew,1965-11-18,6,1989,1995,11,18,USA
William H.,1862-12-27,3,1887,1890,12,27,USA
Bret Ryan,1971-12-17,0,1999,1999,12,17,USA
Charles Judson,1876-04-20,12,1899,1911,4,20,USA
Frank Vernon,1878-05-13,3,1906,1909,5,13,USA
Ralston Burdett,1907-06-24,19,1928,1947,6,24,USA
Solomon Joseph,1923-04-17,10,1949,1959,4,17,USA
Bernard,1899-04-12,0,1921,1921,4,12,USA
William Maxwell,1901-11-04,0,1930,1930,11,4,USA
William C.,1857-09-16,NA,NA,NA,9,16,USA
David Lee,1958-07-21,13,1981,1994,7,21,USA
Edward J.,1884-12-25,0,1914,1914,12,25,USA
James Harding,1862-10-31,5,1883,1888,10,31,USA
James Duffy,1982-10-21,4,2012,2016,10,21,CAN
Joseph Lee,1946-07-04,3,1974,1977,7,4,USA
Kenneth Joseph,1946-06-15,15,1965,1980,6,15,USA
Rickey Nelson Henley,1958-12-25,24,1979,2003,12,25,USA
Rodney Wood,1971-03-11,4,1994,1998,3,11,USA
Steven Curtis,1952-11-18,11,1977,1988,11,18,USA
Charles Robert,1939-04-30,6,1961,1967,4,30,USA
Benjamin John,1981-02-04,2,2004,2006,2,4,USA
Claude Raymond,1889-04-13,9,1911,1920,4,13,USA
Donald William,1913-07-14,1,1945,1946,7,14,USA
Edward,1885-06-20,0,1910,1910,6,20,USA
Elrod Jerome,1940-12-22,11,1968,1979,12,22,V.I.
George Andrew,1949-10-18,17,1971,1988,10,18,USA
Harvey,1897-11-09,11,1923,1934,11,9,USA
John Charles,1875-04-09,1,1902,1903,4,9,USA
Kyle Christian,1989-12-07,5,2014,2019,12,7,USA
Liam Johnson,1989-02-10,8,2011,2019,2,10,Australia
Mark Allan,1974-06-23,9,2002,2011,6,23,USA
Timothy Green,1891-01-31,10,1911,1921,1,31,USA
David Lee,1961-12-18,3,1986,1989,12,18,USA
Edward Siegfried,1855-09-15,NA,NA,NA,9,15,USA
Emery J.,1857-10-07,1,1884,1885,10,7,USA
Lafayette Marion,1899-06-07,0,1919,1919,6,7,USA
Thomas Anthony,1957-12-21,13,1982,1995,12,21,USA
Robert Clifton,1973-01-30,0,1998,1998,1,30,USA
Gail Curtice,1928-10-15,0,1954,1954,10,15,USA
Weldon,1880-10-25,4,1903,1907,10,25,USA
Walter John,1894-12-20,10,1921,1931,12,20,USA
Brad Martin,1980-02-07,4,2004,2008,2,7,USA
George,1907-10-28,8,1937,1945,10,28,USA
Lester Baker,1893-12-12,0,1913,1913,12,12,USA
Michael Alan,1961-12-11,9,1987,1996,12,11,USA
Ernest Herman,1887-12-28,1,1914,1915,12,28,USA
Phillip Winston,1946-04-10,4,1969,1973,4,10,USA
Randall Philip,1965-12-16,0,1990,1990,12,16,USA
Richard Lee,1948-01-11,0,1973,1973,1,11,USA
Sean Michael,1981-04-23,8,2005,2013,4,23,USA
Robert Edward,1938-12-24,2,1957,1959,12,24,USA
Frank Wilde,1899-05-08,0,1924,1924,5,8,USA
Olaf,1888-04-26,6,1911,1917,4,26,Denmark
Oscar Eduardo,1974-01-28,5,1997,2002,1,28,Venezuela
Thomas David,1913-02-20,13,1937,1950,2,20,USA
William Rodman,1927-10-15,17,1952,1969,10,15,USA
William Francis,1942-02-15,0,1966,1966,2,15,USA
Floyd Bluford,1968-10-07,7,1992,1999,10,7,USA
Richard Douglas,1963-12-10,10,1991,2001,12,10,USA
Frank John,1902-05-12,9,1921,1930,5,12,USA
Dwayne Allen,1962-02-16,11,1984,1995,2,16,USA
Earl Clifford,1917-06-10,1,1944,1945,6,10,USA
George Washington,1863-08-10,0,1893,1893,8,10,USA
James Francis,1910-06-26,3,1936,1939,6,26,USA
John Michael,1863-09-02,6,1884,1890,9,2,USA
John Park,1889-12-26,8,1910,1918,12,26,USA
Ronald Baxter,1936-08-07,3,1961,1964,8,7,USA
Frederick Marshall,1895-07-19,1,1922,1923,7,19,USA
Roy Kniklebine,1911-07-29,11,1933,1944,7,29,USA
Philip Frank,1901-10-13,0,1935,1935,10,13,USA
Charles Floyd,1959-03-11,0,1986,1986,3,11,USA
Clayton Allen,1979-08-31,7,2005,2012,8,31,USA
Matthew Davis,1978-08-18,0,2004,2004,8,18,USA
Drew Daniel,1980-02-13,1,2002,2003,2,13,USA
Patrick George,1968-11-13,13,1991,2004,11,13,USA
William Lewis,1945-09-25,0,1966,1966,9,25,USA
Earn Albert,1887-01-30,2,1913,1915,1,30,USA
Frederick,1887-03-04,0,1915,1915,3,4,USA
Raymond Ernest,1929-12-15,16,1950,1966,12,15,USA
Ronald Samuel,1938-01-16,8,1963,1971,1,16,USA
Felix,1975-06-18,9,1996,2005,6,18,D.R.
Gilbert,1965-10-26,10,1991,2001,10,26,USA
Guillermo,1991-01-31,3,2016,2019,1,31,Cuba
Ubaldo Jose,1956-05-04,0,1987,1987,5,4,Venezuela
Wilson,1972-03-30,2,1995,1997,3,30,D.R.
Jimmy Matthew,1993-09-09,0,2019,2019,9,9,USA
Matthew Tyler,1970-04-01,10,1999,2009,4,1,USA
Albert Bartel,1899-03-28,1,1923,1924,3,28,USA
Arthur,1871-05-11,1,1896,1897,5,11,USA
Floyd Caves,1903-06-26,19,1926,1945,6,26,USA
William Jennings Bryan,1909-07-07,16,1931,1947,7,7,USA
Chad Bruce,1977-09-10,5,1999,2004,9,10,USA
Dustin Michael,1972-12-21,11,1995,2006,12,21,USA
Eugene Victor,1920-05-11,10,1943,1953,5,11,USA
Jeremy Ryan,1984-01-30,7,2005,2012,1,30,USA
Michael,1995-01-17,1,2018,2019,1,17,USA
Angel Remigio,1947-10-01,7,1967,1974,10,1,Venezuela
Adrian R.,1975-03-25,3,2001,2004,3,25,Cuba
Alexander,1977-05-28,1,2000,2001,5,28,P.R.
Anderson Mejia,1982-10-30,5,2005,2010,10,30,D.R.
Ariel,1992-03-02,0,2017,2017,3,2,D.R.
Carlos Alberto,1967-05-24,10,1990,2000,5,24,Venezuela
Carlos Eduardo,1975-12-12,1,1999,2000,12,12,Venezuela
Carlos Enrique,1980-04-22,3,2001,2004,4,22,Venezuela
Cesar Dario,1966-09-28,1,1992,1993,9,28,D.R.
Cesar Augusto,1990-05-23,6,2013,2019,5,23,Venezuela
Salvador Jose,1916-01-03,1,1942,1943,1,3,Cuba
David Jose,1985-05-13,10,2009,2019,5,13,USA
Darwinzon David,1996-12-17,0,2019,2019,12,17,Venezuela
Diory,1984-04-08,2,2009,2011,4,8,D.R.
Elieser Alexis,1995-05-03,1,2018,2019,5,3,Venezuela
Enzo Octavio,1949-02-12,7,1971,1978,2,12,Venezuela
Enrique J.,1991-08-24,5,2014,2019,8,24,P.R.
Gregorio Evelio,1930-12-24,1,1956,1957,12,24,Cuba
Fernando,1971-06-16,0,1997,1997,6,16,D.R.
Felix Abraham,1986-04-08,14,2005,2019,4,8,Venezuela
Fernando,1984-07-31,0,2008,2008,7,31,USA
Gorkys Gustavo,1987-09-07,7,2012,2019,9,7,Venezuela
Jacinto,1940-09-11,8,1965,1973,9,11,Cuba
Jesus Rafael,1945-01-08,0,1974,1974,1,8,P.R.
Jeremy Stuart,1966-07-06,4,1991,1995,7,6,USA
Jose Antonio,1969-07-14,15,1991,2006,7,14,P.R.
Jonathan,1996-07-06,0,2019,2019,7,6,USA
Keith,1953-10-20,16,1974,1990,10,20,USA
Leonardo Jesus,1959-11-06,4,1982,1986,11,6,Venezuela
Eisler Livan,1975-02-20,16,1996,2012,2,20,Cuba
Luis Armando,1984-06-26,5,2007,2012,6,26,Venezuela
Manuel Antonio,1961-05-07,3,1986,1989,5,7,D.R.
Marco Antonio,1992-09-06,3,2016,2019,9,6,D.R.
Michel,1978-08-12,6,2003,2009,8,12,Cuba
Orlando P.,1965-10-11,9,1998,2007,10,11,Cuba
Oscar Eduardo,1993-07-09,1,2015,2016,7,9,Venezuela
Pedro Julio Montas,1959-04-04,3,1979,1982,4,4,D.R.
Pedro Michel,1989-04-12,2,2012,2014,4,12,Venezuela
Ramon,1940-08-31,10,1967,1977,8,31,P.R.
Ramon Jose,1976-05-20,14,1999,2013,5,20,Venezuela
Roberto Manuel,1964-11-11,16,1991,2007,11,11,P.R.
Rudolph Albert,1931-12-10,1,1960,1961,12,10,D.R.
Rodolfo,1951-10-18,0,1972,1972,10,18,Mexico
Runelvys Antonio,1978-04-27,6,2002,2008,4,27,D.R.
Teoscar Jose,1992-10-15,3,2016,2019,10,15,D.R.
Tobias Rafael,1958-11-30,0,1984,1984,11,30,Venezuela
Guillermo,1954-11-14,12,1977,1989,11,14,P.R.
Francis Xavier,1965-08-16,9,1989,1998,8,16,USA
Yoel Alejandro,1980-04-15,0,2007,2007,4,15,Venezuela
Kenneth David,1985-09-04,2,2010,2012,9,4,USA
Harry Francis,1978-09-11,0,2001,2001,9,11,USA
Larry Darnell,1953-11-03,14,1974,1988,11,3,USA
Thomas H.,1866-11-04,0,1897,1897,11,4,USA
Alexander Jose,1979-11-05,1,2002,2003,11,5,Venezuela
Procopio,1926-07-26,0,1951,1951,7,26,Mexico
Joseph,1865-03-04,3,1887,1890,3,4,USA
Daniel Ray,1984-10-21,3,2008,2011,10,21,USA
Dilson Jose,1994-03-03,4,2014,2018,3,3,Colombia
Elian,1985-02-01,3,2012,2015,2,1,D.R.
Jose Concepcion,1942-04-08,3,1967,1970,4,8,Venezuela
Jose Ramon,1972-08-30,1,1995,1996,8,30,D.R.
Jonathan Alejandro,1984-11-03,7,2008,2015,11,3,Venezuela
Kelvin De Jesus,1989-12-31,8,2011,2019,12,31,D.R.
Ramon,1897-12-19,1,1925,1926,12,19,Cuba
David Odubel,1991-12-29,4,2015,2019,12,29,Venezuela
Juan Francisco,1934-06-16,3,1958,1961,6,16,Cuba
Ronald Jose,1995-05-03,0,2017,2017,5,3,Venezuela
Rosell Amado,1992-10-16,1,2018,2019,10,16,D.R.
Walter William,1889-02-19,0,1911,1911,2,19,USA
Yoslan,1981-04-28,6,2008,2014,4,28,Cuba
Arthur L.,1906-03-10,18,1929,1947,3,10,USA
William Francis,1893-10-31,0,1915,1915,10,31,USA
Herbert Lee,1891-07-22,0,1912,1912,7,22,USA
Silas Clarke,1880-03-04,5,1899,1904,3,4,USA
Thomas Edward,1929-09-12,0,1954,1954,9,12,USA
William Troy,1930-12-20,0,1956,1956,12,20,USA
Christopher Ryan,1987-11-24,7,2012,2019,11,24,USA
Edward Martin,1946-08-27,11,1967,1978,8,27,USA
Frank Joseph,1984-05-30,6,2010,2016,5,30,USA
Leroy George,1906-02-27,3,1932,1935,2,27,USA
Martin John,1893-01-10,0,1918,1918,1,10,USA
John Ellett,1938-03-31,4,1962,1966,3,31,USA
Richard Franklin,1936-11-03,0,1962,1962,11,3,USA
Thomas Mitchell,1956-04-04,12,1979,1991,4,4,USA
Earl Walter,1932-05-21,0,1956,1956,5,21,USA
Frank,1877-12-13,0,1905,1905,12,13,USA
Norman Michael,1939-10-09,10,1961,1971,10,9,USA
Orel Leonard,1958-09-16,17,1983,2000,9,16,USA
Willard McKee,1910-05-28,2,1938,1940,5,28,USA
Neal Charles,1931-11-22,0,1952,1952,11,22,USA
Stephen Allan,1945-02-26,0,1964,1964,2,26,USA
Charles Lincoln,1885-07-09,12,1908,1920,7,9,USA
Dorrel Norman Elvert,1931-11-09,7,1956,1963,11,9,USA
Joseph Thomas,1959-02-15,10,1984,1994,2,15,USA
David James,1993-07-10,1,2018,2019,7,10,USA
George Edward,1895-01-18,0,1916,1916,1,18,USA
Keith Alexander,1989-03-15,1,2015,2016,3,15,USA
Michael Steven,1978-03-05,7,2003,2010,3,5,USA
Otto C.,1878-10-10,13,1902,1915,10,10,Switzerland
Thomas Joseph,1875-08-15,0,1892,1892,8,15,USA
John Graves,1983-09-14,4,2009,2013,9,14,USA
Lawrence,1878-06-09,0,1901,1901,6,9,USA
Christopher L.,1988-04-10,3,2014,2017,4,10,USA
John Edward,1922-05-12,9,1945,1954,5,12,USA
August Julius,1885-11-21,0,1906,1906,11,21,USA
Eric Paul,1963-09-25,1,1989,1990,9,25,USA
George A.,1849-06-20,5,1871,1876,6,20,Germany
Edward Burlton,1909-05-07,13,1935,1948,5,7,USA
John Aloysius,1896-04-29,12,1920,1932,4,29,USA
Joseph William,1900-09-02,15,1930,1945,9,2,USA
Charles Jacob,1870-06-06,0,1895,1895,6,6,USA
Gregory George,1952-01-02,0,1973,1973,1,2,USA
Marion Edward,1874-07-15,9,1898,1907,7,15,USA
Jason Alias,1989-08-09,9,2010,2019,8,9,USA
Jack E.,1942-07-27,8,1964,1972,7,27,USA
Philip Farrell,1969-05-01,8,1993,2001,5,1,USA
James Gregory,1964-09-13,5,1989,1994,9,13,USA
John Denison,1864-12-02,0,1884,1884,12,2,USA
James Kerr,1944-09-10,0,1967,1967,9,10,USA
Bryan David,1963-10-13,4,1991,1995,10,13,USA
Edward Arthur,1872-08-18,0,1901,1901,8,18,USA
John William,1881-11-03,0,1904,1904,11,3,USA
James Robert,1920-10-22,2,1942,1944,10,22,USA
Kevin John,1956-02-25,10,1981,1991,2,25,USA
Michael Francis,1871-12-25,0,1899,1899,12,25,USA
Charles Taylor,1876-05-04,11,1897,1908,5,4,USA
Jesse Owens,1939-02-18,1,1965,1966,2,18,USA
David James,1892-05-19,4,1915,1919,5,19,USA
James Lucius,1937-05-10,12,1962,1974,5,10,USA
Aaron Michael,1989-10-02,6,2013,2019,10,2,USA
Brandon Ryan,1985-09-14,4,2010,2014,9,14,USA
Clarence Walter,1927-02-15,0,1956,1956,2,15,USA
James Edward,1940-05-18,6,1964,1970,5,18,USA
William Joseph,1933-04-07,4,1959,1963,4,7,USA
John Austin,1989-08-31,4,2015,2019,8,31,USA
Jordan McKinley,1996-09-06,1,2018,2019,9,6,USA
Nathan Woodhull,1845-04-19,5,1872,1877,4,19,USA
Richard Jose,1975-06-28,8,1997,2005,6,28,Venezuela
Joseph Carl,1979-05-01,0,2004,2004,5,1,USA
Kyle Harris,1990-04-20,2,2017,2019,4,20,USA
Walter Kirby,1915-04-08,13,1937,1950,4,8,USA
Mahlon Jesse,1901-08-16,0,1922,1922,8,16,USA
William Travis,1924-04-27,0,1949,1949,4,27,USA
William Edward,1859-12-04,2,1888,1890,12,4,USA
Robert Stone,1886-09-23,3,1909,1912,9,23,USA
Robert Leigh,1970-08-18,10,1995,2005,8,18,USA
Dennis Dean,1939-08-04,6,1966,1972,8,4,USA
Thomas Edward,1888-03-18,1,1909,1910,3,18,USA
Irving Clinton,1882-04-26,3,1906,1909,4,26,USA
Kevin Wayne,1967-01-22,0,1993,1993,1,22,USA
Mark Douglas,1963-07-09,0,1989,1989,7,9,USA
Michael Franklin,1909-05-27,16,1930,1946,5,27,USA
Richard,1851-07-24,9,1871,1880,7,24,United Kingdom
Andrew Aird,1897-11-21,12,1922,1934,11,21,USA
Charles Edwin,1898-12-01,1,1919,1920,12,1,USA
Edward Thomas,1873-10-26,0,1901,1901,10,26,USA
Hugh Jenkin,1887-10-24,5,1913,1918,10,24,USA
Teodoro Valenzuela,1957-11-09,9,1985,1994,11,9,Mexico
Walter Frank,1909-02-28,5,1931,1936,2,28,USA
George Albert,1878-09-06,0,1902,1902,9,6,USA
Oral Clyde,1907-04-07,9,1931,1940,4,7,USA
Palmer Marion,1884-12-23,0,1913,1913,12,23,USA
Trevor Sean,1990-12-15,2,2017,2019,12,15,USA
Thomas Eugene,1942-03-10,6,1969,1975,3,10,USA
Erik Kristian,1972-12-25,3,1999,2002,12,25,USA
Aaron Walter,1982-03-21,12,2005,2017,3,21,USA
Belden L.,1864-08-24,0,1890,1890,8,24,USA
William Cicero,1874-08-02,3,1896,1899,8,2,USA
William Robert,1978-04-03,3,2002,2005,4,3,USA
Carmen Proctor,1895-10-01,15,1915,1930,10,1,USA
David Burnham,1937-11-11,0,1957,1957,11,11,USA
Donald Earl,1960-11-12,9,1983,1992,11,12,USA
Charles Joseph,1934-10-01,7,1961,1968,10,1,USA
Edward Garfield,1879-06-17,0,1903,1903,6,17,USA
Frank Walter,1920-07-13,7,1946,1953,7,13,USA
Homer Hiller Henry,1879-10-10,3,1905,1908,10,10,USA
Harvey Max,1893-05-12,1,1920,1921,5,12,USA
John Frederick,1943-04-08,15,1965,1980,4,8,CAN
Shawn Patrick,1964-08-21,6,1987,1993,8,21,USA
Shea Matthew,1975-07-27,6,2001,2007,7,27,USA
Garry Alton,1946-11-03,0,1969,1969,11,3,USA
Glenallen,1965-03-22,12,1989,2001,3,22,USA
Herbert Lee,1891-08-19,0,1915,1915,8,19,USA
Herman Alexander,1945-10-12,1,1969,1970,10,12,USA
Hunter Benjamin,1879-06-21,2,1903,1905,6,21,USA
Hugh Ellis,1879-07-21,1,1903,1904,7,21,USA
Malcolm David,1901-07-23,4,1924,1928,7,23,USA
Samuel Beauman,1994-02-21,0,2019,2019,2,21,USA
Jesse Terrill,1907-01-20,2,1935,1937,1,20,USA
Jeremy Dee,1977-08-08,1,2002,2003,8,8,USA
Kenneth Wade,1965-12-14,13,1988,2001,12,14,USA
Koyie Dolan,1979-03-09,11,2003,2014,3,9,USA
Marc Kevin,1952-02-18,13,1973,1986,2,18,USA
Darius Dutton,1927-09-14,7,1955,1962,9,14,USA
John Eric,1966-04-27,2,1992,1994,4,27,USA
Milton Giles,1965-08-22,3,1991,1994,8,22,USA
Thomas Brad,1963-01-04,NA,NA,NA,1,4,USA
Oliver Clinton,1909-10-16,0,1939,1939,10,16,USA
John Preston,1882-10-12,NA,NA,NA,10,12,USA
Clifford Joseph,1893-01-20,0,1917,1917,1,20,USA
Richard Joseph,1980-03-11,14,2005,2019,3,11,USA
Shawn Richard,1981-04-28,8,2004,2012,4,28,CAN
Steven Douglas,1985-03-14,2,2010,2012,3,14,USA
David Taylor,1989-03-12,1,2014,2015,3,12,USA
Timothy,1990-02-10,1,2018,2019,2,10,USA
William Edward,1887-02-22,0,1914,1914,2,22,USA
Charles T.,1864-03-23,1,1883,1884,3,23,USA
John David,1950-09-15,3,1972,1975,9,15,USA
Howard James,1964-01-03,0,1990,1990,1,3,USA
John Herby,1878-09-22,1,1905,1906,9,22,USA
Avitus Bernard,1917-04-02,NA,NA,NA,4,2,USA
Andrew Jay,1974-05-15,6,1998,2004,5,15,USA
William White,1883-04-04,15,1905,1920,4,4,USA
Brett,1974-07-21,2,1999,2001,7,21,USA
Harry Sibley,1878-08-04,0,1907,1907,8,4,USA
Michael David,1982-10-05,1,2008,2009,10,5,USA
Samuel Russell,1953-07-11,0,1977,1977,7,11,USA
Henry Fred,1867-09-29,0,1895,1895,9,29,USA
Paul Aloysius,1855-03-01,19,1872,1891,3,1,USA
Daniel Gordon,1905-04-03,0,1934,1934,4,3,USA
Dalier,1986-02-10,1,2015,2016,2,10,Cuba
William Louis,1889-04-27,0,1910,1910,4,27,USA
Paul Edwin,1925-08-31,0,1951,1951,8,31,USA
Alexander Omar,1982-10-31,4,2008,2012,10,31,USA
George Addison,1959-10-23,1,1982,1983,10,23,USA
Eric Scott,1977-08-05,11,2002,2013,8,5,USA
Jerry Dean,1945-04-09,3,1964,1967,4,9,USA
James Paul,1904-05-09,0,1928,1928,5,9,USA
Charles Edward,1934-05-03,10,1961,1971,5,3,USA
John Robert,1876-06-19,0,1901,1901,6,19,USA
Richard Michael,1947-05-22,8,1971,1979,5,22,USA
Thomas Lee,1964-06-18,2,1987,1989,6,18,USA
Herbert August,1939-05-09,0,1966,1966,5,9,USA
Yoshihisa,1984-03-08,1,2018,2019,3,8,Japan
Jason Michael,1982-02-20,2,2006,2008,2,20,USA
Gene Taylor,1948-12-11,4,1971,1975,12,11,USA
Larry Eugene,1947-05-05,14,1968,1982,5,5,USA
Harley Parnell,1926-11-06,0,1951,1951,11,6,USA
William Clyde,1916-07-31,11,1942,1953,7,31,USA
James Franklin,1911-06-28,0,1938,1938,6,28,USA
Sterling Alex,1971-04-29,12,1992,2004,4,29,USA
Bruce Smith,1897-03-14,0,1917,1917,3,14,USA
Lloyd Eldon,1924-02-21,1,1949,1950,2,21,USA
Roy Wesley,1884-06-22,0,1907,1907,6,22,USA
Keston Wee Hing Natsuo,1996-08-02,0,2019,2019,8,2,USA
Myrill Oliver,1908-03-09,14,1931,1945,3,9,USA
Donald Albert,1928-02-05,10,1954,1964,2,5,USA
Edward Russell,1934-06-27,2,1961,1963,6,27,USA
Glen Frederick,1936-04-24,7,1957,1964,4,24,USA
William Lee,1893-05-07,3,1913,1916,5,7,USA
John Douglas,1955-11-11,0,1981,1981,11,11,USA
Richard Carleton,1888-10-26,10,1908,1918,10,26,USA
Clell Lavern,1951-08-17,7,1975,1982,8,17,USA
Luke Anthony,1983-09-15,9,2007,2016,9,15,USA
Harry Keller,1887-01-09,7,1908,1915,1,9,USA
Charles Marion,1950-12-15,0,1975,1975,12,15,USA
Edward Francis,1899-03-27,4,1920,1924,3,27,USA
George Edward,1908-04-07,1,1934,1935,4,7,USA
Oris Leon,1909-09-29,7,1938,1945,9,29,USA
Dennis Lee,1970-04-02,12,1993,2005,4,2,USA
Urban John,1905-09-26,8,1925,1933,9,26,USA
Melvin Anthony,1923-06-24,3,1951,1954,6,24,USA
Edward Burton,1917-05-25,0,1942,1942,5,25,USA
Ed Oliver,1958-04-19,0,1984,1984,4,19,USA
Gilbert Raymond,1924-04-04,20,1943,1963,4,4,USA
Harold Morris,1944-04-03,0,1971,1971,4,3,USA
Kevin Jon,1973-06-24,0,2000,2000,6,24,USA
Ronald Wray,1949-06-22,11,1973,1984,6,22,USA
Clarence Clemet,1893-07-06,2,1920,1922,7,6,USA
Trey Alan,1978-06-29,1,2002,2003,6,29,USA
Elmer Ralph,1915-02-10,9,1939,1948,2,10,USA
Paul Joseph Denis,1960-04-14,0,1980,1980,4,14,CAN
Aloysius Joseph,1917-11-03,0,1946,1946,11,3,USA
William Frederick,1932-05-17,14,1952,1966,5,17,USA
Arthur William,1882-09-30,3,1905,1908,9,30,USA
Joseph Walter,1936-11-12,14,1963,1977,11,12,USA
Nicholas Mackie,1997-05-13,0,2019,2019,5,13,USA
Frank Joseph,1917-08-11,7,1940,1947,8,11,USA
Jerome O'Bryan,1990-03-05,3,2012,2015,3,5,USA
Frederick Chamberlain,1865-01-21,NA,NA,NA,1,21,USA
John Bernard,1881-11-10,2,1906,1908,11,10,USA
James Urban,1982-12-30,5,2006,2011,12,30,USA
Chester Cornelius,1891-05-08,4,1911,1915,5,8,USA
William Leopold,1870-11-08,6,1895,1901,11,8,USA
Stewart Edward,1913-01-27,2,1944,1946,1,27,USA
William Joseph,1918-03-03,0,1939,1939,3,3,USA
Daniel John,1880-03-02,8,1903,1911,3,2,USA
Clarence Casper,1904-01-28,0,1929,1929,1,28,USA
Glenn Edward,1958-07-07,9,1980,1989,7,7,USA
Guy Alan,1956-07-09,9,1979,1988,7,9,USA
Harry Camp,1875-01-05,3,1904,1907,1,5,USA
Jamie Richard,1984-08-20,2,2009,2011,8,20,USA
Jesse H.,1877-03-17,0,1897,1897,3,17,USA
Jeffrey Robert,1993-01-08,3,2016,2019,1,8,USA
John Edward,1943-10-31,1,1964,1965,10,31,USA
Lawrence Charles,1878-07-18,0,1901,1901,7,18,USA
Raymond Lamont,1917-06-14,0,1942,1942,6,14,USA
Edward Adolph,1893-11-30,0,1915,1915,11,30,USA
Trevor William,1967-10-13,17,1993,2010,10,13,USA
John William,1863-05-25,1,1885,1886,5,25,USA
Jarrett Lee,1983-06-18,1,2009,2010,6,18,USA
James Micah,1980-03-01,2,2008,2010,3,1,USA
Robert George,1925-10-05,8,1949,1957,10,5,USA
Fred,1894-06-10,9,1919,1928,6,10,USA
Arthur Frederick,1882-10-29,13,1903,1916,10,29,USA
Robert Edward,1862-04-06,0,1882,1882,4,6,USA
George Augustine,1885-09-25,0,1914,1914,9,25,USA
Harry Sweet,1876-11-01,0,1901,1901,11,1,USA
Kenneth Timothy,1902-10-09,3,1921,1924,10,9,USA
Martin F.,1869-10-25,1,1894,1895,10,25,United Kingdom
James Francis,1906-03-21,12,1925,1937,3,21,USA
William Henry,1884-09-14,1,1911,1912,9,14,USA
Wilbert George,1913-04-21,0,1934,1934,4,21,USA
William Johnston,1881-09-11,3,1905,1908,9,11,USA
Carter Bradley,1889-03-26,8,1911,1919,3,26,USA
George C.,1869-03-17,6,1895,1901,3,17,USA
Elon Chester,1903-11-02,15,1929,1944,11,2,USA
Robert Clinton,1921-04-05,4,1948,1952,4,5,USA
Calvin Grey,1927-10-24,2,1952,1954,10,24,USA
William Henry,1903-11-27,0,1927,1927,11,27,USA
Edward Hicks,1885-01-31,2,1910,1912,1,31,USA
Christopher Allen,1965-03-20,9,1989,1998,3,20,USA
John Bryan,1987-11-19,7,2012,2019,11,19,USA
Aaron Keith,1973-01-09,9,1996,2005,1,9,USA
William Henry,1855-03-14,12,1876,1888,3,14,USA
Ray Arthur,1970-09-25,6,1994,2000,9,25,USA
Walter Albert,1913-11-30,4,1944,1948,11,30,USA
James Marbury,1910-07-17,0,1935,1935,7,17,USA
Kenneth Edward,1918-08-23,8,1945,1953,8,23,USA
William Paul,1889-09-07,1,1913,1914,9,7,USA
Joseph Francis,1913-06-04,2,1934,1936,6,4,USA
Jonathan Blake,1993-06-09,3,2016,2019,6,9,USA
David Allen,1969-02-05,0,1998,1998,2,5,USA
Frederick William,1952-05-29,8,1972,1980,5,29,USA
James,1850-07-14,12,1872,1884,7,14,USA
John Stephen,1987-10-19,0,2014,2014,10,19,USA
Walter Henry,1892-12-25,11,1914,1925,12,25,USA
Alfred Willis,1952-08-16,10,1977,1987,8,16,USA
William James,1896-11-22,0,1920,1920,11,22,USA
William David,1915-06-04,0,1939,1939,6,4,USA
Derek Lane,1986-10-09,10,2009,2019,10,9,USA
Robert Clyde,1903-10-12,2,1932,1934,10,12,USA
Gregory Scott,1985-11-20,9,2010,2019,11,20,USA
Mario Eduardo Lemus,1988-08-26,0,2014,2014,8,26,USA
Howard Arthur,1903-01-06,3,1926,1929,1,6,USA
Todd Mathew,1973-04-20,11,1995,2006,4,20,USA
Edward Edgar,1899-07-23,6,1928,1934,7,23,USA
Gary Charles,1954-08-11,0,1979,1979,8,11,USA
Albert Wayne,1908-02-25,11,1935,1946,2,25,USA
John Burnette,1895-12-26,6,1922,1928,12,26,USA
James Wear,1867-02-08,9,1889,1898,2,8,USA
Carl Theodore,1896-07-09,1,1921,1922,7,9,USA
David Michael,1966-05-25,12,1990,2002,5,25,USA
Damon Jamall,1974-06-12,8,1998,2006,6,12,USA
John Samuel,1853-01-17,3,1872,1875,1,17,USA
Jessie Edward,1970-01-27,0,1992,1992,1,27,USA
John Henry,1870-05-03,0,1892,1892,5,3,USA
Matthew Thomas,1980-01-15,14,2004,2018,1,15,USA
Michael Travis,1982-06-14,0,2008,2008,6,14,USA
Stanley Ernest,1926-01-02,2,1949,1951,1,2,USA
Alva Lee,1923-03-07,0,1953,1953,3,7,USA
Charles Jacob,1896-06-11,6,1918,1924,6,11,USA
James Madison,1908-09-22,0,1929,1929,9,22,USA
Kenneth Eugene,1897-08-08,8,1922,1930,8,8,USA
Edward William,1879-07-06,9,1906,1915,7,6,USA
Jeffrey Owen,1953-03-01,2,1977,1979,3,1,USA
Brian Scott,1965-01-25,3,1988,1991,1,25,USA
Bradley Thomas,1968-02-09,0,1993,1993,2,9,USA
Gary Richard,1944-01-25,1,1968,1969,1,25,USA
Randy Scott,1958-09-18,3,1980,1983,9,18,USA
Shawn Leroy,1964-11-10,0,1989,1989,11,10,USA
David A.,1991-07-19,4,2013,2017,7,19,USA
William Frederick,1912-07-21,2,1943,1945,7,21,USA
Elwood Marter,1896-03-22,0,1918,1918,3,22,USA
Clayton Walter,1993-03-27,1,2018,2019,3,27,USA
Darren Lee,1966-04-25,13,1990,2003,4,25,USA
James William,1869-01-28,10,1895,1905,1,28,USA
Howard Elbert,1883-07-08,0,1906,1906,7,8,USA
Frederick Clarence,1878-07-01,1,1903,1904,7,1,USA
James Scott,1881-08-02,2,1906,1908,8,2,USA
Thomas Francis,1917-03-29,10,1942,1952,3,29,USA
Stephen Robert,1979-10-21,3,2008,2011,10,21,USA
Roscoe Albert,1901-12-28,8,1924,1932,12,28,USA
Herman Alexander,1907-01-20,0,1930,1930,1,20,USA
Brock Wyatt,1988-06-11,7,2012,2019,6,11,USA
Christopher Michael,1971-09-18,5,1996,2001,9,18,USA
Lavern George,1942-10-18,0,1965,1965,10,18,USA
James William,1944-05-27,8,1968,1976,5,27,USA
Brian John,1959-11-29,5,1985,1990,11,29,USA
James Emmett Madison,1894-07-25,0,1925,1925,7,25,USA
Roger Boyd,1956-04-08,0,1980,1980,4,8,USA
Tyler Andrew,1989-03-10,2,2014,2016,3,10,USA
Kenneth Dale,1945-11-03,14,1965,1979,11,3,USA
Michael James,1972-10-10,10,1996,2006,10,10,USA
Mark Harold,1969-08-20,7,1993,2000,8,20,USA
Martin Weldon,1869-05-29,1,1890,1891,5,29,USA
Frederick Wayne,1954-06-29,20,1977,1997,6,29,USA
Albie Larrison,1903-01-31,0,1925,1925,1,31,USA
Destin Dwane,1990-04-03,0,2016,2016,4,3,USA
Donald Harris,1949-10-16,10,1973,1983,10,16,USA
Wallace James,1895-02-09,2,1920,1922,2,9,USA
Wallace James,1925-09-24,0,1949,1949,9,24,USA
Christopher Wayne,1968-08-04,1,1995,1996,8,4,USA
William Edward,1880-08-28,1,1902,1903,8,28,USA
James Wesley,1936-11-18,7,1957,1964,11,18,USA
Alexander Marcus,1906-08-29,0,1935,1935,8,29,USA
Robert Nelson,1922-05-30,5,1950,1955,5,30,CAN
Harry Bartholomew,1887-08-24,16,1909,1925,8,24,USA
Kevin James,1976-12-07,1,2005,2006,12,7,USA
Michael H.,1850-02-07,0,1873,1873,2,7,USA
Michael Leon,1948-04-04,0,1974,1974,4,4,USA
Burt Carlton,1950-02-07,14,1971,1985,2,7,USA
William James,1863-04-12,8,1884,1892,4,12,USA
Charles E.,1865-09-09,1,1888,1889,9,9,USA
Richard Lloyd,1925-12-11,0,1952,1952,12,11,USA
James Allen,1987-08-13,6,2012,2018,8,13,USA
Robert Joseph,1915-04-15,2,1943,1945,4,15,USA
John Nicklaus,1962-12-22,0,1990,1990,12,22,USA
Paul Chester,1976-04-14,9,2001,2010,4,14,USA
John Alan,1970-12-21,3,1993,1996,12,21,USA
Samuel Everett,1878-12-04,0,1907,1907,12,4,USA
John Winton,1883-01-03,0,1907,1907,1,3,USA
Donald,1952-01-09,1,1975,1976,1,9,USA
Gail Eason,1943-02-19,6,1968,1974,2,19,USA
Meredith Hilliard,1907-02-22,1,1934,1935,2,22,USA
Michael Joseph,1872-11-01,0,1902,1902,11,1,United Kingdom
Paul Henry,1904-09-25,2,1927,1929,9,25,USA
William Booth,1891-08-26,2,1913,1915,8,26,USA
James McDaniel,1919-09-01,0,1946,1946,9,1,USA
Clarence Franklin,1875-05-27,0,1898,1898,5,27,USA
Norris Stephen,1979-03-24,2,2006,2008,3,24,USA
John Leonard,1916-07-18,13,1939,1952,7,18,USA
Joseph Patrick,1895-09-06,0,1924,1924,9,6,USA
Joseph Paul,1977-06-07,1,2004,2005,6,7,USA
Joel Edward,1937-08-14,11,1961,1972,8,14,USA
James Robert,1957-08-06,10,1978,1988,8,6,USA
William Frank,1863-09-21,0,1894,1894,9,21,USA
Berlyn Dale,1898-04-12,0,1929,1929,4,12,USA
Samuel Lee,1963-11-02,8,1987,1995,11,2,USA
Rogers,1896-04-27,22,1915,1937,4,27,USA
Michael Joseph,1857-06-12,11,1879,1890,6,12,USA
Hanson,1889-11-26,0,1912,1912,11,26,USA
Vincent Stanley Joseph,1967-03-09,4,1991,1995,3,9,CAN
Jeremy Michael,1985-10-01,2,2011,2013,10,1,USA
Oscar Theodore,1891-06-02,2,1917,1919,6,2,USA
Elmer E.,1869-09-04,2,1896,1898,9,4,USA
Ricky Neal,1959-07-30,6,1984,1990,7,30,USA
Anthony Darrin,1944-12-06,6,1964,1970,12,6,USA
William Wattison,1942-10-18,17,1963,1980,10,18,USA
Brian Jeffery,1982-11-07,0,2008,2008,11,7,USA
Dwayne Samuel,1967-03-11,1,1995,1996,3,11,USA
Steven Bernard,1969-04-02,1,1992,1993,4,2,USA
David Taylor,1925-08-03,1,1953,1954,8,3,USA
Rhys Dean,1993-03-17,2,2017,2019,3,17,USA
Timothy Kenneth,1947-05-10,11,1970,1981,5,10,USA
Eric John,1989-10-24,8,2011,2019,10,24,USA
Charles Cloyd,1903-09-22,1,1944,1945,9,22,USA
David Alan,1956-03-27,7,1981,1988,3,27,USA
Eugene Earl,1933-01-01,1,1956,1957,1,1,USA
Peter James,1856-12-16,9,1879,1888,12,16,USA
Kenneth Roger,1948-05-07,0,1971,1971,5,7,USA
Thomas Lee,1981-07-09,1,2011,2012,7,9,USA
Byron Simon,1891-08-28,6,1912,1918,8,28,USA
Sargent Perry,1856-02-29,8,1879,1887,2,29,USA
Charles Oliver,1948-01-05,24,1970,1994,1,5,USA
Ralph George,1919-08-09,7,1947,1954,8,9,USA
Dennis Sean,1979-08-12,2,2005,2007,8,12,USA
Adrian David,1993-02-02,4,2015,2019,2,2,USA
Benjamin Franklin,1883-11-30,2,1910,1912,11,30,USA
Charles F.,1855-08-21,0,1884,1884,8,21,USA
Charles W.,1854-02-08,2,1882,1884,2,8,USA
Craig Michael,1977-07-08,0,2000,2000,7,8,Japan
Edward H.,1869-10-12,0,1903,1903,10,12,USA
Willard Edwin,1890-10-03,0,1913,1913,10,3,USA
Henry Franklin,1930-02-18,11,1950,1961,2,18,USA
James Robert,1984-12-15,0,2010,2010,12,15,USA
John Franklin,1870-01-10,3,1894,1897,1,10,Netherlands
Joseph William,1891-07-03,0,1914,1914,7,3,USA
James Rodger,1979-11-11,5,2003,2008,11,11,USA
Patrick Lory,1940-09-01,1,1967,1968,9,1,USA
Paul Wesley,1958-09-04,7,1980,1987,9,4,USA
Glenn Anthony,1989-09-29,3,2014,2017,9,29,USA
Thomas Ross,1947-04-29,7,1971,1978,4,29,USA
Wayne Tyrone,1965-05-20,2,1991,1993,5,20,USA
Tyler Sam,1971-01-17,7,1996,2003,1,17,USA
Arthur Joseph,1927-08-07,12,1945,1957,8,7,USA
Fred Fritz,1875-09-04,0,1899,1899,9,4,USA
Stephen Eugene,1944-12-18,4,1969,1973,12,18,USA
Edward Charles,1891-08-20,1,1918,1919,8,20,USA
Joseph,1884-08-16,2,1909,1911,8,16,Austria
Benjamin Richard,1979-01-15,2,2002,2004,1,15,USA
Bruce Ernest,1943-03-23,5,1963,1968,3,23,USA
Christopher Hugh,1966-02-27,3,1991,1994,2,27,USA
Christian,1965-11-18,2,1993,1995,11,18,USA
David Austin,1889-05-01,3,1912,1915,5,1,USA
David Wayne,1967-02-26,8,1991,1999,2,26,USA
George Elmer,1877-12-24,4,1905,1909,12,24,USA
Douglas Lynn,1948-02-06,4,1972,1976,2,6,USA
Earl Nycum,1893-06-25,0,1918,1918,6,25,USA
Elston Gene,1929-02-23,13,1955,1968,2,23,USA
Frank Oliver,1936-08-08,15,1958,1973,8,8,USA
Fred Irving,1956-09-02,0,1979,1979,9,2,USA
Ivan Chester,1882-10-12,3,1914,1917,10,12,USA
James Eugene,1947-03-07,3,1971,1974,3,7,USA
Lawrence Rayford,1945-06-06,3,1970,1973,6,6,USA
Lee Vincent,1923-11-11,1,1946,1947,11,11,USA
Matthew Christopher,1967-09-22,0,1996,1996,9,22,USA
Michael Frederic,1958-04-02,2,1981,1983,4,2,USA
Paul Joseph,1884-05-20,0,1909,1909,5,20,USA
Ryan James,1979-11-19,12,2004,2016,11,19,USA
Sam James,1993-03-05,1,2018,2019,3,5,USA
Steven Bernard,1963-12-07,0,1990,1990,12,7,USA
Thomas Sylvester,1964-12-11,10,1990,2000,12,11,USA
Wilbur Leon,1949-01-08,5,1973,1978,1,8,USA
Arthur Henry,1946-12-15,11,1974,1985,12,15,USA
Calvin Earl,1924-11-27,0,1952,1952,11,27,USA
Millard,1920-01-07,18,1940,1958,1,7,USA
Homer Elliott,1920-04-24,9,1947,1956,4,24,USA
Lester Curtis,1895-08-24,1,1923,1924,8,24,USA
Harry Taylor,1876-11-14,12,1898,1910,11,14,USA
Jay Canfield,1955-11-26,14,1980,1994,11,26,USA
Jack Robert,1961-08-18,14,1985,1999,8,18,USA
James Phillip,1983-04-25,12,2005,2017,4,25,USA
Kenneth,1960-11-28,6,1984,1990,11,28,USA
Patrick O'Neal,1968-08-31,0,1992,1992,8,31,USA
Murray Donald,1909-01-29,0,1941,1941,1,29,USA
Roland Boatner,1892-01-03,0,1912,1912,1,3,USA
Roy Lee,1953-12-18,10,1974,1984,12,18,USA
William Ray,1921-12-12,3,1949,1952,12,12,USA
Steven Roy,1958-03-10,16,1980,1996,3,10,USA
Dann Paul John,1964-02-13,5,1989,1994,2,13,USA
Daniel Philip,1885-10-16,0,1913,1913,10,16,USA
Bobby Dean,1973-08-04,12,1998,2010,8,4,USA
Richard Dalton,1936-05-14,7,1961,1968,5,14,USA
William Ellsworth,1862-05-23,14,1888,1902,5,23,USA
Jared William,1989-05-18,1,2016,2017,5,18,USA
Roland Edison,1921-07-17,0,1952,1952,7,17,USA
Peter Alexander,1966-06-29,0,1992,1992,6,29,CAN
James Allen,1986-09-30,3,2016,2019,9,30,USA
Dewey LaMarr,1955-01-01,7,1979,1986,1,1,USA
Waite Charles,1899-09-09,20,1918,1938,9,9,USA
Alan Thomas,1949-07-21,12,1970,1982,7,21,USA
Kent Allen,1960-05-21,13,1981,1994,5,21,USA
Walter John,1943-05-22,1,1968,1969,5,22,USA
Wei-Chieh,1993-09-26,0,2019,2019,9,26,Taiwan
Allen,1860-12-09,0,1883,1883,12,9,USA
Robert Calvin,1900-10-31,NA,NA,NA,10,31,USA
Glenn Dee,1957-09-25,11,1978,1989,9,25,Germany
Michael Wayne,1971-02-16,6,1995,2001,2,16,USA
Trenidad Aviel,1964-05-11,9,1994,2003,5,11,USA
Wilbert William,1897-06-17,6,1919,1925,6,17,USA
Carl Owen,1903-06-22,15,1928,1943,6,22,USA
Kenneth Douglass,1941-12-23,2,1961,1963,12,23,USA
Clarence Bill,1895-10-27,6,1920,1926,10,27,USA
Jonathan Lloyd,1981-07-07,1,2006,2007,7,7,USA
Justin Patrick,1982-07-01,4,2005,2009,7,1,Australia
Otto,1914-03-12,0,1939,1939,3,12,USA
Chin-lung,1984-02-02,4,2007,2011,2,2,Taiwan
Chih-Wei,1993-11-04,1,2017,2018,11,4,Taiwan
Kenneth Paul,1971-01-27,5,2001,2006,1,27,USA
Earl Eugene,1910-05-23,0,1935,1935,5,23,USA
John Raymond,1966-08-08,5,1994,1999,8,8,USA
David Mark,1956-12-05,0,1983,1983,12,5,USA
James Price,1902-08-24,3,1923,1926,8,24,USA
Rex Allen,1960-09-02,14,1984,1998,9,2,USA
George Willis,1906-05-23,18,1926,1944,5,23,USA
Charles,1949-08-18,3,1972,1975,8,18,USA
Charles Lynn,1959-03-16,6,1983,1989,3,16,USA
Daniel Claiborne,1987-03-09,10,2009,2019,3,9,USA
Dakota Ryan,1994-09-15,1,2018,2019,9,15,USA
Hal Campbell,1927-05-04,1,1952,1953,5,4,USA
Jesse James,1948-07-22,0,1969,1969,7,22,USA
John Wilson,1912-06-30,9,1936,1945,6,30,USA
Joseph Paul,1970-09-29,3,1995,1998,9,29,USA
Joseph Thaddeus,1991-05-21,1,2018,2019,5,21,USA
Kyle Jordan,1987-01-07,0,2011,2011,1,7,USA
Luke Stephen,1977-05-02,5,2002,2007,5,2,USA
Nathaniel P.,1869-01-12,3,1886,1889,1,12,USA
Orlando Thill,1977-12-12,10,2002,2012,12,12,USA
Rex Haughton,1953-08-11,0,1974,1974,8,11,USA
Sidney Charles,1915-01-03,14,1940,1954,1,3,USA
Timothy Adam,1975-07-14,16,1999,2015,7,14,USA
Frank Elmer,1874-06-05,8,1897,1905,6,5,USA
Albert Alfred,1891-06-26,0,1914,1914,6,26,USA
Aubrey Lewis,1976-12-20,12,2000,2012,12,20,USA
David Gregory,1984-08-22,7,2009,2016,8,22,USA
George Alexander,1872-06-11,NA,NA,NA,6,11,USA
Benjamin Franklin,1914-07-18,0,1937,1937,7,18,USA
Chad Daniel,1985-04-29,7,2010,2017,4,29,USA
Michael Kale,1963-08-11,7,1989,1996,8,11,USA
Phillip Lee,1958-06-20,6,1979,1985,6,20,USA
Edward Ambrose,1880-07-14,0,1903,1903,7,14,USA
Miller James,1878-03-27,12,1904,1916,3,27,USA
William Nesbert,1896-11-18,0,1921,1921,11,18,USA
Robert E.,1971-03-10,1,1998,1999,3,10,USA
Richard Henry,1938-02-13,2,1966,1968,2,13,USA
Dustin Robert,1982-06-29,2,2009,2011,6,29,USA
Edward John,1880-10-05,4,1902,1906,10,5,USA
James H.,1874-01-22,4,1898,1902,1,22,USA
William Jared,1985-07-04,8,2011,2019,7,4,USA
James Ulysses,1869-03-08,9,1891,1900,3,8,USA
James Robert,1923-03-21,5,1952,1957,3,21,USA
James Michael,1951-08-11,3,1974,1977,8,11,USA
Joseph Thompson,1880-02-21,0,1902,1902,2,21,USA
Keith Wills,1963-09-12,6,1987,1993,9,12,USA
Luke Trevor,1984-08-02,2,2010,2012,8,2,Australia
Michael F.,1866-10-25,2,1888,1890,10,25,USA
Philip Joseph,1986-06-24,11,2007,2018,6,24,USA
John Rhyne,1983-09-09,0,2010,2010,9,9,USA
Roy John,1911-01-11,11,1935,1946,1,11,USA
Terry Wayne,1949-05-13,4,1970,1974,5,13,USA
Thomas James,1878-11-29,13,1900,1913,11,29,USA
Thomas L.,1884-01-28,12,1906,1918,1,28,USA
Thomas Franklin,1907-08-06,0,1930,1930,8,6,USA
Thomas Owen,1919-10-07,7,1941,1948,10,7,USA
Thomas Edward,1934-09-13,0,1959,1959,9,13,Panama
Travis Wade,1978-05-25,2,2004,2006,5,25,USA
Vernon Alexander,1893-04-15,0,1914,1914,4,15,USA
Cecil Carlton,1916-02-09,8,1941,1949,2,9,USA
Emil Hugo,1892-03-10,2,1915,1917,3,10,USA
Justin Ray,1979-04-16,0,2004,2004,4,16,USA
Mark Lawrence,1958-05-11,8,1983,1991,5,11,USA
Richard Allen,1969-05-17,1,1995,1996,5,17,USA
William A.,1832-10-23,NA,NA,NA,10,23,USA
William Franklin,1870-03-12,3,1896,1899,3,12,USA
Timothy Craig,1960-01-12,12,1983,1995,1,12,USA
Timothy Craig,1983-02-28,1,2008,2009,2,28,USA
Harry Joseph,1899-04-18,0,1922,1922,4,18,USA
Eric Eugene,1979-12-03,0,2007,2007,12,3,USA
David Lindsey,1968-02-25,4,1992,1996,2,25,USA
Rudolph Edward,1877-02-23,11,1899,1910,2,23,USA
Daniel Alexander,1989-11-28,0,2019,2019,11,28,USA
James Hensel,1897-07-18,0,1923,1923,7,18,USA
Philip Gregory,1982-12-21,7,2006,2013,12,21,USA
Thomas Hubert,1953-03-29,10,1977,1987,3,29,USA
John Edwin,1883-04-04,13,1905,1918,4,4,USA
Timothy Robert,1978-11-18,1,2003,2004,11,18,USA
Albert,1886-02-28,0,1911,1911,2,28,USA
Albert,1880-09-26,5,1910,1915,9,26,USA
Byron William,1911-06-17,0,1938,1938,6,17,USA
Robert William,1935-08-18,8,1962,1970,8,18,USA
John Henry,1861-11-12,1,1883,1884,11,12,CAN
John William,1915-06-23,8,1938,1946,6,23,USA
Michael Butler,1967-04-10,2,1991,1993,4,10,USA
Terryal Gene,1949-08-04,8,1971,1979,8,4,USA
Nicholas John,1983-09-08,11,2008,2019,9,8,USA
Cecil Randolph,1942-06-01,13,1964,1977,6,1,USA
Todd Randolph,1969-05-27,13,1990,2003,5,27,USA
Bernard Herman,1896-03-05,8,1922,1930,3,5,USA
William Fenton,1899-01-05,5,1926,1931,1,5,USA
Benjamin Franklin,1888-11-10,3,1910,1913,11,10,USA
William Ellsworth,1887-07-08,0,1912,1912,7,8,USA
Gordon William,1928-06-04,5,1953,1958,6,4,USA
Brian Raynold,1968-03-04,9,1991,2000,3,4,USA
Brian Lee,1971-03-05,9,1994,2003,3,5,USA
Harold James,1947-08-09,4,1971,1975,8,9,USA
James Augustus,1946-04-08,14,1965,1979,4,8,USA
Cedric Scott,1988-03-10,5,2011,2016,3,10,USA
Edison Franklin,1905-02-06,0,1933,1933,2,6,USA
George Henry,1887-07-08,1,1909,1910,7,8,USA
Herbert Harrison,1895-12-25,5,1916,1921,12,25,USA
James MacGregor,1964-06-22,0,1991,1991,6,22,USA
Robert Lemuel,1863-01-16,0,1883,1883,1,16,USA
Frederick Creighton,1880-01-05,0,1911,1911,1,5,USA
Richard Thomas,1974-09-25,0,1996,1996,9,25,USA
Torii Kedar,1975-07-18,18,1997,2015,7,18,USA
Raymond Thomas,1986-07-03,11,2008,2019,7,3,USA
Willard Mitchell,1934-03-08,2,1962,1964,3,8,USA
Oliver Joel,1905-10-11,1,1931,1932,10,11,USA
Kenneth Lawrence,1934-07-13,5,1959,1964,7,13,USA
Kenneth Raymond,1938-12-14,0,1961,1961,12,14,USA
James Randall,1960-01-03,1,1985,1986,1,3,USA
Ronald Kenneth,1941-02-23,11,1963,1974,2,23,USA
Stephen Michael,1945-12-03,8,1967,1975,12,3,USA
Walter Henry,1899-02-06,3,1923,1926,2,6,USA
David Blain,1957-04-17,2,1983,1985,4,17,USA
Clinton Merrick,1957-07-30,10,1977,1987,7,30,USA
Thomas Carr,1924-05-27,2,1954,1956,5,27,USA
Eric William,1985-09-17,0,2008,2008,9,17,USA
Jeremiah Joseph,1863-06-15,2,1889,1891,6,15,USA
Jason Brewster,1991-10-02,1,2016,2017,10,2,USA
William Hansel,1970-04-28,0,1996,1996,4,28,USA
Bruce Vee,1958-03-24,14,1980,1994,3,24,USA
Frank O'Donnell,1905-08-12,6,1928,1934,8,12,USA
James Lavon,1967-06-01,0,1994,1994,6,1,USA
Jimmy O'Neal,1972-03-01,0,1997,1997,3,1,USA
Jonathan,1966-10-20,2,1992,1994,10,20,USA
Timothy Carroll,1865-06-30,NA,NA,NA,6,30,USA
Edwin Amilgar,1970-02-01,2,1995,1997,2,1,Venezuela
Robert Leon,1971-11-10,7,1993,2000,11,10,USA
Jeffrey Kent,1964-08-15,12,1988,2000,8,15,USA
Carl Lawrence,1902-04-08,0,1925,1925,4,8,USA
William Jones,1866-10-11,0,1890,1890,10,11,USA
Berthold Juneau,1878-03-06,2,1900,1902,3,6,USA
Harry Emanuel Kress,1883-10-14,0,1906,1906,10,14,USA
Warren Llewellyn,1913-10-31,7,1937,1944,10,31,USA
William Forrest,1859-12-17,13,1884,1897,12,17,USA
Chad Martin,1977-02-21,0,2001,2001,2,21,USA
Andrew Scott,1990-08-22,6,2012,2018,8,22,USA
Edwin Forrest,1867-05-19,0,1890,1890,5,19,USA
Frederick Charles,1919-08-12,14,1939,1953,8,12,USA
Ira Kendall,1910-08-31,12,1933,1945,8,31,USA
Joseph Johnson,1905-02-05,0,1933,1933,2,5,USA
John Richard Joseph,1916-04-14,6,1940,1946,4,14,USA
George Herbert,1949-07-17,0,1974,1974,7,17,USA
Roy Lee,1902-02-27,0,1925,1925,2,27,USA
James Neamon,1947-10-17,5,1970,1975,10,17,USA
Mark Steven,1970-02-06,5,1993,1998,2,6,Australia
Thomas George,1946-04-20,15,1966,1981,4,20,USA
Jae-gyun,1987-07-28,0,2017,2017,7,28,South Korea
Robert Hamilton,1884-11-01,9,1909,1918,11,1,USA
Brandon Michael,1973-10-03,NA,NA,NA,10,3,USA
Richard Elde,1928-08-03,6,1955,1961,8,3,USA
Timothy James,1971-10-03,5,1994,1999,10,3,USA
William S.,1854-10-01,NA,NA,NA,10,1,USA
Joshua Colt,1985-06-28,2,2013,2015,6,28,USA
Patrick J.,1884-03-12,1,1903,1904,3,12,USA
Adam Davis,1971-12-06,6,2000,2006,12,6,USA
Christopher Domenic,1983-04-08,13,2006,2019,4,8,USA
Raul Javier,1972-06-02,18,1996,2014,6,2,USA
Edgar Alexander,1989-05-31,0,2015,2015,5,31,Venezuela
Herman Edward,1873-10-30,0,1902,1902,10,30,USA
Ryota,1979-05-28,2,2010,2012,5,28,Japan
Kei,1979-07-13,1,2007,2008,7,13,Japan
Jose Antonio,1990-01-05,8,2011,2019,1,5,Cuba
Raisel,1990-01-04,4,2015,2019,1,4,Cuba
Gary Raymond,1949-09-01,0,1973,1973,9,1,USA
Michael James,1966-03-12,4,1991,1995,3,12,USA
Tadahito,1974-12-04,3,2005,2008,12,4,Japan
Blaise Francis,1964-04-09,0,1994,1994,4,9,USA
Harry Miller,1889-01-12,0,1913,1913,1,12,USA
Peter Joseph,1964-04-02,12,1986,1998,4,2,USA
Ender David,1990-10-29,5,2014,2019,10,29,Venezuela
Fermin Alexis,1961-12-04,3,1987,1990,12,4,Venezuela
Gregory Alexander,1987-07-10,8,2010,2018,7,10,Venezuela
Omar Rafael,1981-12-26,14,2002,2016,12,26,Venezuela
Charles Brandon,1977-05-19,12,2001,2013,5,19,USA
Robert Randolph,1883-01-08,0,1914,1914,1,8,USA
William John,1886-04-19,0,1911,1911,4,19,USA
Joseph Steven,1978-06-29,5,2006,2011,6,29,USA
Charles W.,1860-04-08,0,1883,1883,4,8,USA
Garey Lamar,1970-07-25,3,1994,1997,7,25,USA
Melvin David,1904-07-04,0,1929,1929,7,4,USA
Riccardo Benay,1966-09-10,1,1994,1995,9,10,USA
Albert John,1871-01-27,5,1891,1896,1,27,USA
Jeffrey David,1962-07-05,6,1987,1993,7,5,USA
Dane Charles,1950-05-11,9,1977,1986,5,11,USA
Garth Ray,1954-10-12,9,1978,1987,10,12,USA
Frederick Bidds,1876-07-07,0,1903,1903,7,7,USA
Clarence Eugene,1919-12-03,6,1941,1947,12,3,USA
Hideki,1969-05-05,5,1997,2002,5,5,Japan
Harold,1890-08-05,0,1914,1914,8,5,USA
Timothy Neal Christopher,1953-03-14,1,1981,1982,3,14,USA
Hernan Alcides,1984-06-29,8,2008,2016,6,29,Venezuela
Cole R.,1994-01-31,0,2019,2019,1,31,USA
Daryl Keith,1964-11-15,2,1990,1992,11,15,USA
Monford Merrill,1919-02-25,7,1949,1956,2,25,USA
Arthur Albert,1858-02-14,14,1880,1894,2,14,CAN
William Franklin,1859-09-16,0,1886,1886,9,16,USA
Charles Edwin,1869-02-15,9,1893,1902,2,15,USA
John,1861-07-21,14,1882,1896,7,21,CAN
Phillip Andrew,1987-02-25,1,2013,2014,2,25,USA
Thomas Andrew,1912-12-20,0,1938,1938,12,20,USA
Walter Kingsley,1897-09-23,0,1921,1921,9,23,USA
Orlando,1959-12-22,0,1980,1980,12,22,P.R.
William Frank,1875-08-21,11,1898,1909,8,21,USA
Kazuhisa,1973-09-09,3,2002,2005,9,9,Japan
Travis Takashi,1983-09-24,9,2006,2015,9,24,USA
Jason Derik,1972-09-07,17,1995,2012,9,7,USA
Michael Wilson,1952-08-08,12,1971,1983,8,8,USA
Hisashi,1981-04-12,5,2012,2017,4,12,Japan
Akinori,1979-02-09,3,2007,2010,2,9,Japan
Enrique Roberto,1931-03-20,0,1967,1967,3,20,Cuba
Hansel,1977-01-02,0,2002,2002,1,2,Cuba
Cesar David,1980-02-10,12,2001,2013,2,10,Venezuela
Maicer,1980-09-12,10,2004,2014,9,12,Venezuela
Raymond Leo,1926-12-17,7,1953,1960,12,17,USA
Frederick Lawrence,1876-05-24,17,1900,1917,5,24,USA
Alvin Neill,1935-12-26,10,1959,1969,12,26,USA
Alex J.,1995-12-25,0,2019,2019,12,25,USA
Austin Jarriel,1987-02-01,8,2010,2018,2,1,USA
William Riley,1881-04-04,1,1914,1915,4,4,USA
Vincent Edward,1962-11-30,8,1986,1994,11,30,USA
Brett Elliott,1988-08-02,2,2012,2014,8,2,USA
Herbert Benjamin,1883-09-24,0,1905,1905,9,24,USA
Charles Herbert,1894-02-07,2,1915,1917,2,7,USA
Charles Leo,1963-03-19,7,1987,1994,3,19,USA
Conor Sims,1982-05-07,6,2005,2011,5,7,USA
Darrell Preston,1956-04-03,4,1978,1982,4,3,USA
Danny Lynn,1962-01-05,14,1983,1997,1,5,USA
Darrin Jay,1963-08-22,14,1985,1999,8,22,USA
Damian Jacques,1973-08-16,10,1996,2006,8,16,USA
Drew Hamilton,1993-07-28,0,2019,2019,7,28,USA
Edwin,1983-09-09,16,2003,2019,9,9,Germany
George Christopher,1882-01-02,2,1911,1913,1,2,USA
Grant Dwight,1942-09-28,17,1965,1982,9,28,USA
Henry Everett,1861-06-23,0,1887,1887,6,23,USA
Randy,1987-10-27,4,2015,2019,10,27,USA
James Benner,1877-11-28,5,1901,1906,11,28,USA
Joseph Walker,1887-07-16,12,1908,1920,7,16,USA
John Lewis,1909-07-15,0,1933,1933,7,15,USA
Kenneth Bernard,1963-08-21,0,1987,1987,8,21,USA
Lawrence Curtis,1931-06-02,13,1955,1968,6,2,USA
Louis Clarence,1935-07-26,6,1958,1964,7,26,USA
Luke Ray,1991-08-24,4,2015,2019,8,24,USA
Michael Warren,1946-03-27,3,1970,1973,3,27,USA
Michael Ray,1964-12-22,18,1986,2004,12,22,USA
Ransom Joseph,1926-02-10,9,1950,1959,2,10,USA
Reginald Martinez,1946-05-18,20,1967,1987,5,18,USA
Ronald Harris,1933-10-22,6,1954,1960,10,22,USA
Ronnie Damien,1953-05-09,9,1975,1984,5,9,USA
Roy Lee,1954-05-01,9,1977,1986,5,1,USA
Ryan Dewitte,1971-11-15,4,1998,2002,11,15,USA
Ryan Christopher,1988-05-10,3,2012,2015,5,10,USA
Samuel,1849-03-24,1,1871,1872,3,24,United Kingdom
Roland Thomas,1944-07-09,11,1963,1974,7,9,USA
Steven Nash,1982-03-15,1,2009,2010,3,15,USA
Travis Calvin,1903-11-02,14,1922,1936,11,2,USA
Zachary Thomas,1983-05-13,3,2006,2009,5,13,USA
Arthur Edward,1902-08-28,0,1939,1939,8,28,USA
William Chester,1890-08-16,12,1915,1927,8,16,USA
Albert Leonard,1881-06-05,3,1904,1907,6,5,USA
Brook Wallace,1959-11-23,11,1981,1992,11,23,USA
Newton Smith,1913-03-21,3,1937,1940,3,21,USA
Larry William,1975-08-30,0,2004,2004,8,30,USA
William Elmer,1892-08-10,13,1914,1927,8,10,USA
Lamar Gary,1937-06-09,1,1960,1961,6,9,USA
Stuart Louis,1894-12-13,0,1918,1918,12,13,USA
Merwin John William,1894-03-07,12,1915,1927,3,7,USA
Elmore Michael,1876-04-17,0,1902,1902,4,17,USA
Michael James,1980-10-30,7,2005,2012,10,30,USA
Otto Albert,1889-04-19,0,1918,1918,4,19,USA
Raymond Frederick,1902-01-02,0,1928,1928,1,2,USA
Forrest Vandergrift,1925-11-04,2,1954,1956,11,4,USA
Anthony Robert,1925-08-05,7,1948,1955,8,5,USA
Jason James,1970-11-24,4,1994,1998,11,24,USA
Patrick Thomas,1947-04-23,0,1971,1971,4,23,USA
Thomas Patrick,1975-12-29,0,2000,2000,12,29,USA
Paul Henry,1942-04-01,0,1964,1964,4,1,USA
Charles Thomas,1875-04-17,0,1904,1904,4,17,USA
Joseph Peter,1895-03-03,0,1920,1920,3,3,USA
John Emil,1966-05-27,9,1992,2001,5,27,USA
Arthur Charles,1895-12-02,3,1925,1928,12,2,USA
Juan Jose,1987-08-02,1,2014,2015,8,2,D.R.
Christopher James,1978-12-22,2,2009,2011,12,22,USA
Sigmund,1909-08-20,9,1936,1945,8,20,USA
Charles Dewey,1900-01-26,0,1924,1924,1,26,USA
Arthur,1952-08-02,0,1975,1975,8,2,USA
Berton Hulon,1886-07-07,0,1909,1909,7,7,USA
Robert Byrne,1905-09-02,4,1929,1933,9,2,USA
William Henry,1887-01-20,8,1911,1919,1,20,USA
William Lawrence,1892-03-12,6,1913,1919,3,12,USA
Robert Harvey,1958-08-18,9,1978,1987,8,18,USA
Charles Wesley,1937-12-22,5,1960,1965,12,22,USA
Donald Chris,1962-10-04,9,1986,1995,10,4,USA
Charles Hamilton,1981-11-09,6,2005,2011,11,9,USA
Cleo Joel,1940-08-31,5,1968,1973,8,31,USA
Delvin DeWayne,1978-01-03,0,2002,2002,1,3,USA
Dion,1962-11-09,13,1983,1996,11,9,USA
Jeffrey Lynn,1941-09-29,1,1968,1969,9,29,USA
John Phillip,1933-07-23,3,1958,1961,7,23,USA
Joshua,1993-03-08,1,2018,2019,3,8,USA
Justin Duane,1981-09-13,0,2010,2010,9,13,USA
William L.,1889-07-01,2,1912,1914,7,1,USA
Michael Elmo,1967-08-15,7,1995,2002,8,15,USA
Richard Lee,1947-10-11,0,1967,1967,10,11,USA
Philip Robert,1949-10-21,1,1977,1978,10,21,USA
Charles Devine,1893-02-07,17,1915,1932,2,7,USA
Gerald Joseph,1946-04-18,2,1970,1972,4,18,USA
Paul Ryan,1982-10-12,9,2008,2017,10,12,USA
Jordan Jacob,1989-05-17,0,2017,2017,5,17,USA
Travis Paul,1991-06-15,4,2015,2019,6,15,USA
Victor Felix,1930-02-26,1,1953,1954,2,26,USA
Daniel Robert,1995-04-15,1,2018,2019,4,15,USA
Kenley Geronimo,1987-09-30,9,2010,2019,9,30,Curacao
Lawrence Joseph,1920-07-16,9,1947,1956,7,16,USA
Raymond William,1889-01-16,0,1910,1910,1,16,USA
Robert Casey,1981-09-17,9,2006,2015,9,17,USA
Walter Charles,1890-04-09,0,1912,1912,4,9,USA
Harold Chandler,1892-08-27,11,1911,1922,8,27,USA
Martin Thomas,1973-05-31,1,1996,1997,5,31,USA
Jason Cory,1982-10-09,2,2009,2011,10,9,USA
Kevin Thomas,1969-08-01,12,1994,2006,8,1,USA
Robert Patrick,1941-03-18,7,1966,1973,3,18,USA
Raymond Arnold,1946-05-10,1,1969,1970,5,10,USA
Leroy Gilbert,1926-06-07,3,1944,1947,6,7,USA
John Edward,1983-09-19,9,2008,2017,9,19,USA
Henry W.,1886-05-24,5,1914,1919,5,24,USA
Larry Edward,1944-01-13,7,1965,1972,1,13,USA
Paul,1949-09-04,0,1972,1972,9,4,USA
Alva William,1918-06-05,6,1940,1946,6,5,USA
Ignacio Alfred,1954-02-04,0,1976,1976,2,4,D.R.
Manuel Julian,1936-08-09,12,1960,1972,8,9,D.R.
Stanley Julian Antonio,1964-01-09,17,1984,2001,1,9,D.R.
Myles Joseph,1991-12-28,0,2017,2017,12,28,USA
Joseph Richard,1935-08-15,13,1953,1966,8,15,USA
Jonathan Henry,1985-03-15,9,2010,2019,3,15,USA
Domingo,1969-01-09,0,1993,1993,1,9,D.R.
Ernest Lee,1900-12-19,6,1921,1927,12,19,USA
George Edward,1913-12-24,7,1936,1943,12,24,USA
Harold Bentley,1924-09-06,11,1948,1959,9,6,USA
James Michael,1959-08-03,11,1983,1994,8,3,USA
Gregory Scott,1967-08-01,13,1987,2000,8,1,USA
Jesse Harrison,1949-03-03,8,1973,1981,3,3,USA
Reginald Jirod,1968-09-25,8,1991,1999,9,25,USA
Stanley,1962-12-04,5,1986,1991,12,4,USA
Irvine Franklin,1905-09-10,4,1930,1934,9,10,USA
Jeremy Ross,1987-09-21,9,2010,2019,9,21,USA
Christopher John,1963-12-16,0,1990,1990,12,16,USA
Frank Anthony,1917-09-03,0,1941,1941,9,3,USA
Gregory Dion,1961-08-16,0,1987,1987,8,16,USA
Larry Steven,1959-05-28,7,1983,1990,5,28,France
Stephen Chadwick,1987-12-22,3,2012,2015,12,22,USA
Ferguson Arthur,1942-12-13,18,1965,1983,12,13,CAN
Geoffrey Scott,1974-07-21,10,1998,2008,7,21,USA
Warren Washington,1942-12-22,7,1962,1969,12,22,USA
Joseph Daniel,1890-10-12,5,1914,1919,10,12,USA
John Robert,1896-07-07,0,1922,1922,7,7,USA
Thomas Griffith,1898-04-10,7,1925,1932,4,10,USA
Tyrell Deon,1992-07-20,0,2016,2016,7,20,USA
Robert Scott,1981-03-14,6,2005,2011,3,14,USA
Alfred Gorden,1850-11-30,0,1878,1878,11,30,USA
William Lee,1925-09-28,0,1951,1951,9,28,USA
Daniel Lee,1987-04-17,7,2012,2019,4,17,USA
Daniel Ray,1960-09-16,NA,NA,NA,9,16,USA
Desmond Delane,1986-10-30,6,2010,2016,10,30,USA
James Douglas,1964-09-30,5,1988,1993,9,30,USA
Hugh Ambrose,1869-04-02,27,1891,1918,4,2,USA
Jason Ryan,1978-07-17,8,2001,2009,7,17,USA
Robin Christopher,1972-04-11,5,1996,2001,4,11,Singapore
Jack Eugene,1927-03-09,11,1950,1961,3,9,USA
Kyle Gregory,1988-05-20,0,2016,2016,5,20,USA
Marcus Christian,1972-12-14,6,1996,2002,12,14,USA
Larry Ryan,1975-09-17,4,2001,2005,9,17,USA
William Christian,1889-11-17,2,1912,1914,11,17,USA
Forrest Docenus,1907-08-11,8,1931,1939,8,11,USA
Kevin Martin,1984-07-26,10,2008,2018,7,26,USA
Williams Alexander,1992-05-16,1,2018,2019,5,16,D.R.
Michael Joseph,1972-05-18,0,1998,1998,5,18,USA
Daniel Edward,1901-02-22,0,1929,1929,2,22,USA
Garry Arthur,1947-03-19,3,1969,1972,3,19,USA
Virgil Milton,1927-07-23,1,1952,1953,7,23,USA
Derek Sanderson,1974-06-26,19,1995,2014,6,26,USA
John,1944-10-24,5,1969,1974,10,24,USA
Shawn Darrell,1966-06-28,0,1992,1992,6,28,USA
Samuel,1917-01-23,4,1950,1954,1,23,USA
Jake R.,1993-05-16,1,2018,2019,5,16,USA
Nathan W.,1844-12-25,0,1872,1872,12,25,USA
Antonio Jamil,1990-05-01,0,2017,2017,5,1,P.R.
Cesar Enrique,1984-11-12,9,2006,2015,11,12,Venezuela
D'Angelo,1977-12-21,8,1999,2007,12,21,D.R.
Eduardo Rafael,1995-04-04,0,2019,2019,4,4,Venezuela
Felix Elvio,1940-01-06,0,1964,1964,1,6,D.R.
Eloy Arturo,1996-11-27,0,2019,2019,11,27,D.R.
German,1962-12-05,0,1988,1988,12,5,Mexico
Alfonso,1957-10-30,5,1983,1988,10,30,Mexico
Jason Jon,1976-01-10,0,2002,2002,1,10,USA
Jose,1973-07-07,6,1998,2004,7,7,D.R.
Joe Alexander,1995-01-17,2,2017,2019,1,17,P.R.
Juan Antonio,1949-03-08,0,1974,1974,3,8,D.R.
Kelvin Rogelio,1980-10-27,1,2007,2008,10,27,D.R.
Luis Antonio,1982-05-07,0,2012,2012,5,7,Venezuela
Luis Domingo,1988-01-18,2,2013,2015,1,18,D.R.
Manuel Emilio,1938-11-19,7,1962,1969,11,19,D.R.
Miguel Anthony,1969-08-19,1,1993,1994,8,19,USA
Ubaldo,1984-01-22,11,2006,2017,1,22,D.R.
Charlton Maxwell,1979-09-22,3,2005,2008,9,22,USA
Waldis,1986-12-25,2,2009,2011,12,25,D.R.
Brett Paul,1977-03-25,0,2001,2001,3,25,USA
Connor Kok-Wy,1992-08-16,0,2019,2019,8,16,USA
Kenji,1976-06-08,3,2006,2009,6,8,Japan
Ebenezer Tremayne,1871-01-19,1,1896,1897,1,19,CAN
Adam Bryant,1979-07-12,2,2001,2003,7,12,USA
Alexander,1942-12-07,12,1964,1976,12,7,USA
Thomas Alan,1983-08-24,0,2011,2011,8,24,USA
Arthur Gilbert,1897-02-15,0,1927,1927,2,15,USA
Arthur Henry,1919-07-16,2,1940,1942,7,16,USA
Augustus Francis,1899-09-10,1,1926,1927,9,10,USA
Clair Barth,1950-01-03,8,1969,1977,1,3,USA
Byron Bancroft,1865-01-05,NA,NA,NA,1,5,USA
Benjamin Franklin,1931-05-15,1,1959,1960,5,15,USA
Benjamin Joseph,1981-06-18,2,2005,2007,6,18,USA
William F.,1861-09-28,8,1884,1892,9,28,USA
William Lawrence,1892-10-18,1,1916,1917,10,18,USA
William Russell,1918-08-30,10,1943,1953,8,30,USA
William Charles,1960-10-06,1,1983,1984,10,6,USA
Robert Lee,1905-11-26,12,1933,1945,11,26,USA
Robert Wallace,1936-03-04,10,1960,1970,3,4,USA
Robert Dale,1943-04-25,8,1969,1977,4,25,USA
Bobby Earl,1959-07-31,2,1981,1983,7,31,USA
Brian David,1968-01-08,7,1994,2001,1,8,USA
Christopher Brian,1990-12-07,4,2015,2019,12,7,USA
William Penn,1848-06-01,0,1871,1871,6,1,USA
Charles Cleveland,1885-03-12,0,1908,1908,3,12,USA
George Howard,1886-03-30,2,1913,1915,3,30,USA
Chester Lillis,1917-08-01,0,1946,1946,8,1,USA
Charles Edward,1971-07-20,11,1994,2005,7,20,USA
Christopher Dalton,1984-10-01,7,2009,2016,10,1,USA
Clifford,1947-07-22,14,1972,1986,7,22,USA
Clifford,1922-12-27,5,1953,1958,12,27,USA
Darrell Dean,1928-08-25,10,1952,1962,8,25,USA
David Allen,1943-01-30,13,1965,1978,1,30,USA
David Charles,1948-10-04,4,1974,1978,10,4,USA
David Wayne,1959-10-24,6,1987,1993,10,24,USA
Dane Edward,1963-02-10,3,1994,1997,2,10,USA
Daniel Ryan,1979-08-10,10,2005,2015,8,10,USA
Deron Roger,1938-07-17,16,1960,1976,7,17,USA
Richard Frederick,1863-04-06,7,1884,1891,4,6,USA
Daniel Stuart,1989-08-30,1,2018,2019,8,30,USA
Wheeler Roger,1887-09-09,13,1909,1922,9,9,USA
Donald Spore,1911-12-07,5,1943,1948,12,7,USA
Donald Roy,1926-11-12,11,1947,1958,11,12,USA
Douglas Alan,1967-12-19,4,1995,1999,12,19,USA
Earl Douglas,1919-04-02,11,1940,1951,4,2,USA
Edwin Cyril,1899-03-31,0,1920,1920,3,31,USA
Elmer Ellsworth,1884-06-12,0,1914,1914,6,12,USA
Elliot Tyler,1984-03-09,6,2008,2014,3,9,USA
Ernest Rudolph,1888-04-29,13,1912,1925,4,29,USA
Ernest Thorwald,1924-06-16,9,1950,1959,6,16,USA
Erik Anthony,1965-10-11,1,1993,1994,10,11,USA
Erik Craig,1989-12-30,3,2013,2016,12,30,USA
Richard Allan,1932-02-15,0,1958,1958,2,15,USA
Frederick Edward,1894-03-10,17,1922,1939,3,10,USA
Wilfred Ivy,1899-07-09,0,1924,1924,7,9,USA
Frank Herbert,1942-07-22,5,1966,1971,7,22,USA
Gerald Clyde,1975-10-29,0,2003,2003,10,29,USA
Gregory Bernard,1955-02-12,2,1979,1981,2,12,USA
Henry Ward,1906-05-21,14,1925,1939,5,21,USA
Howard Michael,1960-11-29,13,1982,1995,11,29,USA
John William,1945-11-20,19,1966,1985,11,20,USA
Jason Michael,1973-10-27,11,1997,2008,10,27,USA
Jerry Michael,1943-12-03,9,1968,1977,12,3,USA
William Jeffrey,1966-08-04,2,1991,1993,8,4,USA
James Harle,1889-12-10,15,1911,1926,12,10,USA
Russell Conwell,1894-10-09,12,1916,1928,10,9,USA
James Brian,1945-11-03,0,1970,1970,11,3,USA
James Robert,1983-06-27,12,2006,2018,6,27,USA
John Louis,1869-11-18,0,1894,1894,11,18,USA
John Thomas,1890-03-28,0,1913,1913,3,28,USA
John Clifford,1914-09-29,1,1944,1945,9,29,USA
John Henry,1956-08-21,9,1978,1987,8,21,USA
Joseph Richard,1961-10-30,2,1985,1987,10,30,USA
Joel Raymond,1967-03-08,4,1991,1995,3,8,USA
John William,1968-11-25,7,1993,2000,11,25,USA
Jonathan Kent,1974-07-16,5,1998,2003,7,16,USA
Joshua Michael,1984-01-31,8,2005,2013,1,31,USA
William Julius,1899-12-26,NA,NA,NA,12,26,USA
Kenneth Wandersee,1923-01-14,5,1947,1952,1,14,USA
Kenneth Travis,1933-06-16,12,1958,1970,6,16,USA
Robert Keith,1971-07-19,0,1998,1998,7,19,USA
Keith,1971-04-17,0,2000,2000,4,17,USA
Kelly Andrew,1982-02-22,11,2005,2016,2,22,USA
Kristofer Michael,1984-10-14,1,2013,2014,10,14,USA
Larry Doby,1950-08-17,6,1972,1978,8,17,USA
Lamar,1950-09-02,8,1974,1982,9,2,USA
Kenneth Lance,1963-07-06,13,1987,2000,7,6,USA
Lloyd William,1910-12-24,0,1934,1934,12,24,USA
Louis Brown,1934-09-22,9,1960,1969,9,22,USA
Mark Patrick,1967-10-17,7,1995,2002,10,17,USA
Mark Landon,1975-09-12,10,1998,2008,9,12,USA
Mark J.,1975-05-02,0,2000,2000,5,2,USA
Michael Norton,1951-03-02,0,1974,1974,3,2,USA
Michael Keith,1975-10-03,4,1997,2001,10,3,CAN
Michael Charles,1979-03-30,1,2004,2005,3,30,USA
Micah Drew,1990-12-18,2,2015,2017,12,18,USA
Nicholas Robert,1978-09-19,11,2001,2012,9,19,USA
Oliver Tracy,1879-08-21,0,1905,1905,8,21,USA
Otis L.,1883-11-05,0,1911,1911,11,5,USA
Paul Oscar,1896-09-02,1,1920,1921,9,2,USA
William R.,1888-01-17,3,1915,1918,1,17,USA
Pierce William,1991-05-10,1,2017,2018,5,10,USA
Adam Rankin,1888-02-04,4,1914,1918,2,4,USA
Adam Rankin,1917-03-01,0,1941,1941,3,1,USA
Randall Stuart,1958-08-15,2,1980,1982,8,15,USA
Randall Glenn,1956-06-10,2,1982,1984,6,10,USA
Randall David,1963-09-10,21,1988,2009,9,10,USA
Rex David,1937-11-08,0,1964,1964,11,8,USA
Reed Cameron,1976-12-08,12,2003,2015,12,8,USA
Roy,1895-10-01,0,1918,1918,10,1,USA
Roy Cleveland,1903-02-23,9,1929,1938,2,23,USA
Ronald David,1956-03-23,2,1982,1984,3,23,USA
Roy Edward,1959-06-27,3,1982,1985,6,27,USA
Rondin Allen,1958-12-16,0,1986,1986,12,16,USA
Rontrez DeMon,1976-12-08,0,2003,2003,12,8,USA
Robert James,1982-07-22,6,2007,2013,7,22,USA
William Russell,1973-02-22,8,1997,2005,2,22,USA
Sherman Lee,1990-07-15,0,2018,2018,7,15,USA
Silas Kenneth,1906-10-05,19,1928,1947,10,5,USA
Stanley Lucius,1937-02-12,1,1960,1961,2,12,USA
Steven David,1987-08-31,4,2012,2016,8,31,USA
Sylvester W.,1900-12-31,18,1922,1940,12,31,USA
Timothy Evald,1949-07-22,6,1973,1979,7,22,USA
Thomas Pearce,1851-09-07,0,1873,1873,9,7,USA
Thomas Raymond,1951-04-02,4,1974,1978,4,2,USA
Anthony Clair,1956-06-23,1,1981,1982,6,23,USA
Tyler James,1981-06-07,2,2005,2007,6,7,USA
Victor Oscar,1920-08-03,2,1944,1946,8,3,USA
Walter Perry,1887-11-06,20,1907,1927,11,6,USA
Ellis Walter,1892-12-08,5,1912,1917,12,8,USA
Wallace Darnell,1956-12-25,9,1981,1990,12,25,USA
John Gottfred,1873-07-22,2,1897,1899,7,22,USA
Thomas Edward,1943-05-22,26,1963,1989,5,22,USA
Roy Merrill,1906-10-30,6,1934,1940,10,30,USA
Eric Spenser,1989-07-29,0,2014,2014,7,29,USA
Stanley Edward,1926-05-03,1,1954,1955,5,3,USA
Smead Powell,1902-01-14,3,1930,1933,1,14,USA
David,1924-10-14,4,1953,1957,10,14,USA
Levin Thomas,1847-07-04,1,1873,1874,7,4,USA
Adam LaMarque,1985-08-01,13,2006,2019,8,1,USA
Alexander M.,1869-12-25,14,1889,1903,12,25,USA
Alfornia,1959-02-10,2,1983,1985,2,10,USA
Andruw Rudolf,1977-04-23,16,1996,2012,4,23,Curacao
Arthur Lennox,1906-02-07,0,1932,1932,2,7,USA
Barry Louis,1963-02-15,7,1986,1993,2,15,USA
William Dennis,1887-04-08,1,1911,1912,4,8,CAN
John Joseph,1899-07-11,0,1924,1924,7,11,USA
Robert Walter,1889-12-02,8,1917,1925,12,2,USA
Robert Oliver,1949-10-11,12,1974,1986,10,11,USA
Robert Joseph,1970-02-10,9,1993,2002,2,10,USA
Robert Mitchell,1972-04-11,7,1997,2004,4,11,USA
Jesse Frank,1898-11-15,0,1923,1923,11,15,USA
Brandon Lamon,1983-12-10,2,2007,2009,12,10,USA
Charles Leander,1870-01-01,1,1892,1893,1,1,USA
Calvin Douglas,1963-09-26,1,1991,1992,9,26,USA
Charles Wesley,1852-04-30,13,1875,1888,4,30,USA
Charles F.,1861-10-24,0,1884,1884,10,24,USA
Charles Claude,1876-06-02,7,1901,1908,6,2,USA
Christopher Dale,1957-07-13,1,1985,1986,7,13,USA
Christopher Carlos,1965-12-16,9,1991,2000,12,16,USA
Larry Wayne,1972-04-24,19,1993,2012,4,24,USA
Cleon Joseph,1942-08-04,13,1963,1976,8,4,USA
Clarence Woodrow,1940-11-07,1,1967,1968,11,7,USA
Albert Edward,1874-08-23,3,1898,1901,8,23,USA
Coburn Dyas,1907-08-21,1,1928,1929,8,21,USA
David Jefferson,1880-06-30,17,1901,1918,6,30,USA
Dale Eldon,1918-12-17,0,1941,1941,12,17,USA
James Dalton,1943-12-10,8,1964,1972,12,10,USA
Darryl Lee,1951-06-05,0,1979,1979,6,5,USA
Dax Xenos,1970-08-04,0,1996,1996,8,4,USA
David E.,1861-04-05,0,1882,1882,4,5,USA
Carroll Elmer,1893-12-20,2,1916,1918,12,20,USA
Grover William,1934-04-18,4,1962,1966,4,18,USA
Decatur Poindexter,1902-05-22,1,1926,1927,5,22,USA
Douglas Reid,1957-06-24,18,1982,2000,6,24,USA
Earl Leslie,1919-06-11,0,1945,1945,6,11,USA
Elijah Albert,1882-01-27,2,1907,1909,1,27,USA
Fielder Allison,1871-08-13,19,1896,1915,8,13,USA
Frank M.,1858-08-25,0,1884,1884,8,25,USA
Gareth Howell,1945-06-12,1,1970,1971,6,12,USA
Garrett Thomas,1981-06-21,8,2007,2015,6,21,USA
Gordon Bassett,1930-04-02,11,1954,1965,4,2,USA
Greg Alan,1976-11-15,4,2003,2007,11,15,USA
Harold Marion,1936-04-09,1,1961,1962,4,9,USA
Henry Monroe,1857-05-10,0,1884,1884,5,10,USA
Henry,1860-07-27,0,1890,1890,7,27,USA
Howard,1897-03-01,0,1921,1921,3,1,USA
David Hunter,1984-01-10,1,2009,2010,1,10,USA
Uriah Louis,1859-02-04,1,1883,1884,2,4,USA
Daniel Albion,1860-10-23,0,1883,1883,10,23,USA
James Murrell,1920-11-23,7,1941,1948,11,23,USA
Jacque Dewayne,1975-04-25,9,1999,2008,4,25,USA
Jason Dewey,1976-10-17,0,2003,2003,10,17,USA
James Steven,1988-09-24,1,2014,2015,9,24,USA
JaCoby Mylon,1992-05-10,3,2016,2019,5,10,USA
Jeffrey Allen,1956-07-29,4,1980,1984,7,29,USA
Jeffrey Raymond,1957-10-22,0,1983,1983,10,22,USA
James Tilford,1876-12-25,5,1897,1902,12,25,USA
James Condia,1964-04-20,7,1986,1993,4,20,USA
John Paul,1892-08-25,1,1919,1920,8,25,USA
John William,1901-05-13,9,1923,1932,5,13,USA
Kenneth Frederick,1903-04-13,6,1924,1930,4,13,USA
Lynn Morris,1953-01-01,7,1979,1986,1,1,USA
Mack F.,1938-11-06,10,1961,1971,11,6,USA
Marcus Ray,1975-03-29,0,2000,2000,3,29,USA
Michael,1865-07-06,0,1890,1890,7,6,CAN
Michael Carl,1959-07-30,5,1980,1985,7,30,USA
Mitchell C.,1977-10-15,0,2009,2009,10,15,USA
Nathan Andrew,1986-01-28,7,2012,2019,1,28,USA
Vernal Leroy,1925-06-29,11,1946,1957,6,29,USA
Odell,1953-01-13,13,1975,1988,1,13,USA
Oscar Lafayette,1879-10-22,2,1903,1905,10,22,USA
Percy Lee,1899-10-28,10,1920,1930,10,28,USA
Randall Leo,1950-01-12,9,1973,1982,1,12,USA
Morris Elijah,1911-11-02,0,1940,1940,11,2,USA
Thomas Frederick,1955-04-16,2,1976,1978,4,16,USA
Ricky Miron,1958-06-04,0,1986,1986,6,4,USA
Ross A.,1960-01-14,3,1984,1987,1,14,USA
Ronald Glen,1964-06-11,3,1988,1991,6,11,USA
Ruppert Sanderson,1955-03-12,11,1976,1987,3,12,USA
Ryder McKinley,1994-06-07,1,2017,2018,6,7,USA
Samuel Pond,1892-07-26,21,1914,1935,7,26,USA
Samuel,1925-12-14,13,1951,1964,12,14,USA
Sheldon Leslie,1922-02-02,7,1946,1953,2,2,USA
Sherman Jarvis,1935-02-10,2,1960,1962,2,10,USA
Steven Howell,1941-04-22,2,1967,1969,4,22,USA
Joseph Stacy,1967-05-26,5,1991,1996,5,26,USA
William Roderick,1885-08-04,0,1911,1911,8,4,USA
Terry Lee,1971-02-15,5,1996,2001,2,15,USA
Timothy Byron,1954-01-24,0,1977,1977,1,24,USA
William Timothy,1962-12-01,5,1988,1993,12,1,USA
Thomas,1874-06-21,8,1902,1910,6,21,USA
Todd Barton Givin,1968-04-24,15,1993,2008,4,24,USA
Tracy Donald,1961-03-31,5,1986,1991,3,31,USA
Willie Edward,1925-08-16,14,1947,1961,8,16,USA
Clarence James,1897-11-23,15,1920,1935,11,23,USA
Claude Alfred,1897-11-23,8,1921,1929,11,23,USA
Edwin David,1916-06-05,19,1936,1955,6,5,USA
Brian O'Neal,1967-03-29,14,1992,2006,3,29,USA
Baxter Byerly,1907-01-16,11,1927,1938,1,16,USA
Charles T.,1871-10-04,0,1896,1896,10,4,USA
Adolf Otto,1880-01-05,1,1903,1904,1,5,USA
Harry James,1873-02-14,1,1894,1895,2,14,USA
James William,1908-01-13,3,1933,1936,1,13,USA
Kevin Wayne,1969-10-09,6,1995,2001,10,9,USA
Michael Henry,1863-02-07,0,1890,1890,2,7,USA
Milton Mignot,1927-05-24,0,1953,1953,5,24,USA
Niles Chapman,1925-12-01,1,1951,1952,12,1,USA
Raymond Willis,1889-09-28,7,1912,1919,9,28,USA
Paul Scott,1965-05-26,8,1988,1996,5,26,USA
Ricardo,1970-06-27,3,1995,1998,6,27,USA
Scott Allan,1963-05-27,0,1988,1988,5,27,USA
Clarence Veasey,1878-09-27,1,1901,1902,9,27,USA
Taylor J.,1989-01-17,2,2013,2015,1,17,USA
Timothy Joseph,1879-02-14,9,1901,1910,2,14,USA
Thomas Jefferson,1919-09-05,4,1944,1948,9,5,USA
Arndt Ludwig,1905-05-18,10,1929,1939,5,18,Norway
Felix De Jesus,1994-01-02,0,2017,2017,1,2,D.R.
Michael,1948-08-16,17,1968,1985,8,16,USA
Orville Edwin,1908-06-04,2,1935,1937,6,4,USA
Carl,1914-11-21,0,1937,1937,11,21,USA
Ryan Wayne,1979-05-04,3,2005,2008,5,4,USA
John Donald,1919-11-03,4,1947,1951,11,3,USA
Terry Allen,1966-09-02,4,1989,1993,9,2,USA
Domingo Felix Andujar,1965-05-02,15,1988,2003,5,2,D.R.
Caleb Martin,1986-06-18,5,2014,2019,6,18,USA
Corban Raymond,1988-10-28,6,2013,2019,10,28,USA
Don Atley,1987-11-01,1,2013,2014,11,1,USA
Duane Charles,1942-06-03,7,1965,1972,6,3,USA
Kevin John,1976-08-01,0,2002,2002,8,1,USA
Ricardo Emelindo,1939-08-24,6,1964,1970,8,24,D.R.
Thomas Richard,1991-07-16,1,2016,2017,7,16,USA
Von Everett,1948-05-01,11,1969,1980,5,1,USA
Adrian,1880-04-12,8,1902,1910,4,12,USA
Theodore Charles,1895-09-05,4,1916,1920,9,5,USA
James Richard,1977-12-29,2,2003,2005,12,29,USA
William Michael,1867-09-22,8,1890,1898,9,22,USA
Robert Emmett,1915-01-14,7,1939,1946,1,14,USA
Richard Edward,1943-11-18,0,1965,1965,11,18,USA
Matthew Ryan,1984-08-03,11,2008,2019,8,3,USA
Michael Lewis,1941-02-12,1,1962,1963,2,12,USA
Wallace Keith,1962-06-16,15,1986,2001,6,16,USA
Aloysius C.,1860-06-11,0,1884,1884,6,11,USA
Michael Galen,1975-06-30,4,1997,2001,6,30,USA
Thomas William Oscar,1908-02-14,7,1941,1948,2,14,CAN
Ralph Wesley,1901-12-07,3,1927,1930,12,7,USA
Frank,1884-11-11,0,1906,1906,11,11,USA
Jeffrey Daniel,1971-01-19,8,1991,1999,1,19,USA
Aaron James,1992-04-26,3,2016,2019,4,26,USA
Joseph Ignatius,1894-05-25,19,1915,1934,5,25,USA
Walter Franklin,1916-01-24,9,1940,1949,1,24,USA
Howard Kolls,1926-02-16,6,1948,1954,2,16,USA
Josh Steven,1986-02-09,0,2011,2011,2,9,USA
Lyle Leroy,1913-11-15,0,1935,1935,11,15,USA
John Samuel,1916-09-20,0,1939,1939,9,20,USA
Jorge Dandys,1979-03-03,8,2001,2009,3,3,Venezuela
George Benedict,1917-05-16,1,1940,1941,5,16,USA
Eric DeBari,1977-01-05,1,2002,2003,1,5,USA
Kenneth Peter,1916-06-23,5,1937,1942,6,23,USA
Taylor Heath,1989-12-18,2,2015,2017,12,18,USA
Jakob Benjamin Lee,1992-09-16,2,2017,2019,9,16,USA
Ariel Bolivar,1996-01-30,1,2018,2019,1,30,Panama
Edward James,1957-10-24,7,1982,1989,10,24,USA
Michael Allen,1945-09-20,0,1965,1965,9,20,USA
William Frederick,1908-05-09,16,1931,1947,5,9,USA
Alvin Joseph,1921-08-25,3,1944,1947,8,25,USA
Jair Francoise,1986-01-29,7,2007,2014,1,29,Curacao
David Christopher,1966-04-14,13,1989,2002,4,14,USA
Walter Newton,1883-08-17,0,1905,1905,8,17,USA
Joseph Erwin,1916-01-08,1,1944,1945,1,8,USA
Alfred Henry,1946-05-28,5,1972,1977,5,28,USA
Herbert Victor,1886-02-02,0,1911,1911,2,2,USA
Earl Harold,1893-05-21,0,1914,1914,5,21,USA
Micah Kila,1984-03-29,4,2008,2012,3,29,USA
James Lee,1938-11-07,24,1959,1983,11,7,USA
Kevin,1991-12-31,0,2018,2018,12,31,USA
John Frederick,1884-11-27,4,1910,1914,11,27,USA
Frank Jacob,1888-10-16,1,1913,1914,10,16,USA
Isaac Leonard,1899-10-22,0,1922,1922,10,22,USA
Robert Wayne,1915-11-23,0,1938,1938,11,23,USA
George Runnells,1889-09-06,4,1910,1914,9,6,USA
Nicholas Alexander,1879-04-10,0,1905,1905,4,10,USA
Thomas Robert,1989-08-07,5,2014,2019,8,7,USA
Owen Earle,1903-06-15,0,1930,1930,6,15,USA
Michael Joseph,1873-09-03,14,1895,1909,9,3,USA
Donald Wayne,1955-09-03,0,1980,1980,9,3,USA
Alfred Edward,1886-08-03,3,1911,1914,8,3,USA
Robert Thomas,1950-04-29,0,1971,1971,4,29,USA
Clyde Donald,1935-02-03,2,1955,1957,2,3,USA
George,1893-05-12,1,1914,1915,5,12,USA
Jeffrey Patrick,1960-07-24,8,1985,1993,7,24,USA
John Joseph,1878-09-30,0,1903,1903,9,30,USA
Charles Henry,1864-12-28,0,1884,1884,12,28,USA
William Philip,1916-03-03,0,1937,1937,3,3,USA
Albert William,1934-12-19,21,1953,1974,12,19,USA
Frank Bruno,1917-10-03,3,1940,1943,10,3,USA
Ryan Michael,1988-03-28,6,2010,2016,3,28,USA
Rudolph,1892-12-14,7,1918,1925,12,14,USA
Scott Andrew,1964-04-19,9,1991,2000,4,19,USA
Robert Lynn,1950-12-02,1,1978,1979,12,2,USA
William Edward,1900-02-02,12,1923,1935,2,2,USA
Alphonse Francis,1900-09-05,1,1924,1925,9,5,USA
Alexis William,1912-11-13,9,1934,1943,11,13,USA
Francis Thomas,1895-03-09,4,1915,1919,3,9,USA
Harry,1883-07-27,4,1902,1906,7,27,USA
Roderick Edwin,1934-04-01,2,1962,1964,4,1,USA
William Jeremiah,1866-04-04,0,1890,1890,4,4,USA
James Joseph,1881-11-27,0,1908,1908,11,27,USA
John Francis,1882-09-24,3,1907,1910,9,24,USA
John Francis,1900-02-19,0,1925,1925,2,19,USA
Thomas Joseph,1906-12-15,0,1938,1938,12,15,USA
Jung Ho,1987-04-05,4,2015,2019,4,5,South Korea
Erving Leslie,1892-07-31,2,1914,1916,7,31,USA
Gabriel Stefan,1975-07-31,12,1998,2010,7,31,USA
Joseph,1857-04-27,6,1884,1890,4,27,USA
Matthew Dean,1967-06-28,5,1995,2000,6,28,USA
Paul Otto,1915-09-19,0,1936,1936,9,19,USA
Edwin,1883-05-06,5,1906,1911,5,6,USA
James Stephen,1995-09-22,0,2019,2019,9,22,USA
Ronald Joseph,1963-08-08,11,1986,1997,8,8,USA
Anton Andrew,1914-04-08,4,1943,1947,4,8,USA
William John,1909-01-21,0,1930,1930,1,21,USA
Randall Scott,1971-08-09,5,1995,2000,8,9,USA
William Arthur,1875-12-28,0,1901,1901,12,28,USA
Nathan Alan,1987-11-25,6,2013,2019,11,25,USA
Jason Andre,1976-05-15,4,2001,2005,5,15,USA
Martin Gregory,1904-07-18,0,1927,1927,7,18,USA
Herbert,1917-12-27,0,1946,1946,12,27,USA
Ryan Jason,1970-04-05,2,1995,1997,4,5,USA
Benjamin Joyce,1893-11-28,7,1920,1927,11,28,USA
Eric Peter,1967-11-04,13,1991,2004,11,4,USA
Stefan Andrew,1972-03-24,13,1993,2006,3,24,USA
Jeffrey Wayne,1982-09-24,6,2006,2012,9,24,USA
John Gottlieb,1893-10-15,0,1915,1915,10,15,USA
Takashi,1971-05-14,0,1997,1997,5,14,Japan
Edward Michael,1931-06-27,9,1957,1966,6,27,USA
Matthew John,1978-03-14,6,2003,2009,3,14,USA
John,1872-06-24,4,1898,1902,6,24,Germany
Raymond Frederick,1927-05-09,7,1952,1959,5,9,USA
Robert Clyde,1911-01-30,0,1944,1944,1,30,USA
Bennie Michael,1890-01-05,8,1912,1920,1,5,USA
Howard Richard,1888-06-22,1,1914,1915,6,22,USA
Curt Gerrard,1957-07-19,2,1982,1984,7,19,USA
Anthony Charles,1900-12-16,14,1921,1935,12,16,USA
Charles Hugh,1891-06-09,0,1914,1914,6,9,USA
Leo Daniel,1894-08-09,0,1914,1914,8,9,USA
Martin Joseph,1891-06-13,4,1914,1918,6,13,USA
Kenshin,1975-06-22,1,2009,2010,6,22,Japan
Munenori,1981-06-03,4,2012,2016,6,3,Japan
Anthony Benjamin,1995-03-21,0,2019,2019,3,21,USA
Walter Brocton,1878-02-14,0,1907,1907,2,14,USA
Justin Malcolm,1976-06-09,0,2002,2002,6,9,USA
Edward Terrance,1920-07-18,4,1948,1952,7,18,USA
Theodore Stanley,1934-01-25,5,1953,1958,1,25,USA
Sean Frank,1984-08-05,0,2008,2008,8,5,USA
Scott Edward,1984-01-24,12,2004,2016,1,24,USA
Gregory Charles,1971-06-28,2,1996,1998,6,28,USA
Steven William,1947-05-13,5,1968,1973,5,13,USA
John Joseph,1911-11-03,NA,NA,NA,11,3,USA
Austin Ryan,1980-05-20,11,2002,2013,5,20,USA
Robert Henry,1956-10-03,8,1979,1987,10,3,USA
Edward Joseph,1900-01-01,5,1920,1925,1,1,USA
Thomas J.,1860-11-09,4,1880,1884,11,9,USA
Edward Paul,1916-02-23,0,1942,1942,2,23,USA
Edward James,1863-01-02,0,1888,1888,1,2,USA
Robert M.,1862-09-22,0,1887,1887,9,22,USA
Walter Francis,1891-08-08,13,1913,1926,8,8,USA
Raymond Herbert,1893-07-21,7,1912,1919,7,21,USA
Gregory Steven,1953-09-12,0,1981,1981,9,12,USA
Frank Joseph,1899-01-13,1,1922,1923,1,13,USA
Charles Patrick,1958-01-10,4,1985,1989,1,10,USA
Robert Francis,1882-06-16,5,1907,1912,6,16,USA
David Edwin,1897-01-09,5,1917,1922,1,9,USA
George Washington,1867-01-07,5,1886,1891,1,7,USA
John Thomas,1867-07-16,0,1890,1890,7,16,USA
Timothy John,1857-01-01,13,1880,1893,1,1,USA
Robert Charles,1920-08-04,5,1953,1958,8,4,USA
Edward Charles,1939-07-08,3,1959,1962,7,8,USA
Burton Elwood,1879-11-02,1,1908,1909,11,2,USA
William Henry,1872-03-03,18,1892,1910,3,3,USA
Robert William,1909-08-22,1,1944,1945,8,22,USA
James W.,1856-02-10,16,1875,1891,2,10,USA
James William,1899-05-25,1,1920,1921,5,25,USA
John M.,1869-01-01,0,1891,1891,1,1,USA
William Brown,1892-08-16,0,1911,1911,8,16,USA
Joshua Harry,1868-08-18,0,1896,1896,8,18,USA
Jeffrey Bruce,1959-01-14,1,1982,1983,1,14,USA
Joseph Donald,1953-04-21,0,1976,1976,4,21,USA
Howard Victor,1899-03-16,9,1918,1927,3,16,USA
George Henry,1847-04-10,0,1875,1875,4,10,USA
James Ward,1902-10-27,5,1925,1930,10,27,USA
Rickey,1957-03-18,1,1980,1981,3,18,USA
Charles Franklin,1861-07-01,0,1890,1890,7,1,USA
Chester Lawrence,1921-10-30,0,1942,1942,10,30,USA
Sherman Carl,1891-09-03,0,1914,1914,9,3,USA
Randy Dean,1976-02-24,7,2000,2007,2,24,USA
William Hoffman,1871-08-17,7,1896,1903,8,17,USA
Michael Dennis,1945-04-02,12,1965,1977,4,2,USA
Keone Cole,1993-04-16,4,2015,2019,4,16,USA
George Francis,1870-07-17,0,1898,1898,7,17,USA
Maurice Michael,1890-01-11,1,1911,1912,1,11,USA
Alfred Henry,1901-10-30,1,1923,1924,10,30,USA
Brad Michael,1995-07-27,1,2018,2019,7,27,USA
Charles Ernest,1916-09-12,13,1939,1952,9,12,USA
Richard Anthony,1940-01-08,7,1964,1971,1,8,USA
Albert Aloysius,1893-09-30,0,1916,1916,9,30,USA
Francis Eugene,1916-08-22,1,1942,1943,8,22,USA
Frank William,1924-07-06,3,1953,1956,7,6,USA
Harry Leroy,1906-02-13,14,1925,1939,2,13,USA
Harold Joseph,1914-06-24,3,1935,1938,6,24,USA
Harold Kefauver,1927-07-07,3,1949,1952,7,7,USA
Joseph James,1871-12-09,17,1891,1908,12,9,USA
John Patrick,1893-09-13,12,1912,1924,9,13,USA
Kristopher Shane,1978-03-01,0,2002,2002,3,1,USA
Kyle Robert,1993-04-28,0,2019,2019,4,28,USA
Michael Joseph,1875-12-02,0,1899,1899,12,2,USA
Michael Dennis,1947-07-25,10,1972,1982,7,25,USA
Mitch Thomas,1996-04-04,0,2019,2019,4,4,USA
Donald Stafford,1909-07-15,0,1934,1934,7,15,USA
Ronald Lee,1943-06-03,2,1966,1968,6,3,USA
Shawn Andrew,1984-04-26,10,2009,2019,4,26,USA
Thomas Henry,1944-01-05,9,1964,1973,1,5,USA
Trevor Michael,1993-10-20,0,2019,2019,10,20,USA
George Clyde,1922-08-23,14,1943,1957,8,23,USA
Francis Mortiford,1899-05-23,0,1919,1919,5,23,USA
Alexander Raymond,1924-08-26,11,1948,1959,8,26,USA
Walter Joseph,1929-04-26,1,1952,1953,4,26,USA
Albert Clement,1886-09-09,0,1908,1908,9,9,USA
William Dearstyne,1884-05-25,0,1914,1914,5,25,USA
Nathaniel Monroe,1858-09-28,0,1885,1885,9,28,USA
Everett Lee,1929-10-11,0,1952,1952,10,11,USA
Winford Ansley,1876-04-11,4,1901,1905,4,11,CAN
William Joseph,1886-05-01,3,1910,1913,5,1,USA
William Henry,1898-12-28,8,1920,1928,12,28,USA
Robert Edward,1927-10-04,7,1951,1958,10,4,USA
Bryan Keith,1959-02-24,1,1986,1987,2,24,USA
Casey Patrick,1989-10-04,6,2012,2018,10,4,USA
Carson Franklin,1994-07-14,3,2016,2019,7,14,USA
Charles J.,1862-02-25,3,1883,1886,2,25,USA
Donald Thomas,1980-02-15,9,2007,2016,2,15,USA
Edward Leo,1888-12-10,0,1914,1914,12,10,USA
George Lange,1895-09-10,17,1915,1932,9,10,USA
Herbert Barrett,1892-06-04,1,1914,1915,6,4,USA
James Robert,1884-02-01,4,1914,1918,2,1,USA
John Francis,1859-03-03,5,1879,1884,3,3,USA
John Benedict,1879-03-13,0,1907,1907,3,13,USA
Joseph Henry,1886-09-23,5,1914,1919,9,23,USA
Joseph James,1900-04-23,2,1926,1928,4,23,USA
Joseph William,1988-06-09,7,2012,2019,6,9,USA
Kenneth Alphonso,1979-01-26,5,2000,2005,1,26,USA
Michael Joseph,1857-12-31,15,1878,1893,12,31,USA
John O.,1856-10-31,0,1879,1879,10,31,USA
Kenneth Merrill,1988-10-14,0,2019,2019,10,14,USA
Michael J.,1902-11-09,0,1926,1926,11,9,USA
Michael Raymond,1970-06-02,5,1994,1999,6,2,USA
Harold Patrick,1944-07-30,14,1967,1981,7,30,USA
Dale Patrick,1955-08-27,0,1980,1980,8,27,USA
Patrick Franklin,1967-10-14,8,1991,1999,10,14,USA
Albert Michael,1884-11-15,0,1910,1910,11,15,USA
Reynolds Joseph,1899-11-18,0,1923,1923,11,18,USA
Roberto Conrado,1964-10-01,13,1987,2000,10,1,Panama
William Ryan,1987-10-30,0,2015,2015,10,30,USA
R. B.,1884-08-19,0,1909,1909,8,19,USA
Jay Thomas,1950-08-15,0,1975,1975,8,15,USA
Tyler Patrick,1988-07-20,2,2016,2018,7,20,USA
Van Howard,1946-03-18,1,1969,1970,3,18,USA
George William,1881-08-24,0,1907,1907,8,24,USA
William Eugene,1940-02-19,4,1964,1968,2,19,USA
Kenneth Frederick,1916-10-31,13,1937,1950,10,31,USA
David Wayne,1979-12-17,1,2003,2004,12,17,USA
John James,1871-03-10,0,1890,1890,3,10,USA
William Edward,1873-11-15,0,1895,1895,11,15,USA
Russell Paul,1930-11-01,9,1954,1963,11,1,USA
Herman John,1899-03-04,0,1929,1929,3,4,USA
Matthew Ryan,1984-09-23,13,2006,2019,9,23,USA
Steven F.,1954-08-07,11,1977,1988,8,7,USA
Anthony Allen,1991-10-31,3,2016,2019,10,31,USA
Fred Lyn,1949-01-31,11,1969,1980,1,31,USA
Jason Daniel,1974-06-26,14,1996,2010,6,26,USA
Albert Daniel George,1937-04-04,0,1961,1961,4,4,USA
Howard Joseph,1983-07-12,13,2006,2019,7,12,USA
Kyle Rodney,1984-08-26,10,2007,2017,8,26,USA
Edward Benninghaus,1877-10-17,0,1902,1902,10,17,USA
Edward Aloysius,1897-09-30,0,1928,1928,9,30,USA
Adam Thomas,1976-01-10,13,1999,2012,1,10,USA
Arthur Joseph,1916-04-29,0,1938,1938,4,29,USA
William Gorman,1918-12-22,5,1942,1947,12,22,USA
William Aulton,1921-03-14,9,1948,1957,3,14,USA
Robert Daniel,1920-08-18,18,1939,1957,8,18,USA
William Park,1867-10-07,11,1892,1903,10,7,USA
Brett,1994-08-04,0,2018,2018,8,4,USA
Michael Joseph,1853-08-11,4,1879,1883,8,11,USA
Edward,1856-04-01,3,1883,1886,4,1,USA
William Edward,1861-04-05,0,1884,1884,4,5,USA
Ian Patrick,1984-12-19,12,2007,2019,12,19,USA
Gerald Tennyson,1945-06-30,6,1967,1973,6,30,USA
James Earl,1946-11-01,0,1970,1970,11,1,USA
John Irvin,1926-10-12,0,1957,1957,10,12,USA
John Edward,1941-05-29,12,1962,1974,5,29,USA
Joseph Darley,1979-05-24,6,2001,2007,5,24,USA
Junior Raymond,1950-08-09,9,1974,1983,8,9,USA
Kevin Curtis,1954-05-26,NA,NA,NA,5,26,USA
Montia Calvin,1922-05-11,7,1946,1953,5,11,USA
Raymond Lincoln,1895-05-19,0,1916,1916,5,19,USA
Sherman Montgomery,1878-11-01,0,1902,1902,11,1,USA
Theodore A.,1865-02-07,1,1885,1886,2,7,USA
Terrance Edward,1956-06-04,13,1978,1991,6,4,USA
Lloyd Vernon,1907-03-20,11,1934,1945,3,20,USA
Logan French,1982-07-03,12,2004,2016,7,3,USA
Edward C.,1859-09-17,0,1884,1884,9,17,USA
Jeffrey Franklin,1968-03-07,16,1992,2008,3,7,USA
Maurice Allen,1885-09-17,1,1912,1913,9,17,USA
Steven Patrick,1978-10-03,0,2002,2002,10,3,Germany
William Jennings,1886-07-04,5,1912,1917,7,4,USA
Richard Lee,1941-04-01,6,1962,1968,4,1,USA
Joseph William,1946-01-07,5,1968,1973,1,7,USA
Richard Martin,1934-04-14,10,1956,1966,4,14,USA
Matthew Lon,1955-07-03,9,1977,1986,7,3,USA
Maximilian,1993-02-10,4,2015,2019,2,10,Germany
Robert Griffin,1982-06-11,3,2006,2009,6,11,USA
Jeffrey Scott,1980-04-21,9,2004,2013,4,21,USA
Kurt David,1959-07-03,2,1984,1986,7,3,USA
Charles Patrick,1963-09-28,5,1985,1990,9,28,USA
Constantine Nicholas,1931-07-28,5,1950,1955,7,28,USA
John Nelson,1858-07-15,6,1884,1890,7,15,USA
Wayman William,1913-12-06,0,1939,1939,12,6,USA
Orie Milton,1891-01-23,0,1915,1915,1,23,USA
William George,1933-02-28,0,1962,1962,2,28,USA
George Boyd,1940-01-12,1,1965,1966,1,12,USA
James Lester,1949-03-15,12,1974,1986,3,15,USA
Russell Eldon,1920-11-10,0,1945,1945,11,10,USA
John Joseph,1922-11-06,8,1943,1951,11,6,USA
Richard Henry,1893-07-03,6,1919,1925,7,3,USA
John Jonas,1882-01-17,1,1914,1915,1,17,USA
Joseph Thomas,1954-01-30,4,1976,1980,1,30,USA
John Francis,1898-11-26,11,1923,1934,11,26,USA
John Melville,1903-05-22,0,1925,1925,5,22,CAN
Clayton Edward,1988-03-19,11,2008,2019,3,19,USA
Jason Ashley,1976-12-19,2,2002,2004,12,19,USA
Daniel Patrick,1874-07-09,0,1903,1903,7,9,USA
Donald Eulon,1942-07-17,15,1964,1979,7,17,USA
Robert Keith,1967-02-19,0,1993,1993,2,19,USA
Henry,1851-07-27,4,1873,1877,7,27,USA
Richard Lee,1946-07-07,2,1968,1970,7,7,USA
Frederick L.,1875-07-27,2,1899,1901,7,27,USA
Augustus Franklin,1897-03-21,0,1922,1922,3,21,USA
Philip,1884-04-13,0,1912,1912,4,13,USA
Dallas,1988-01-01,7,2012,2019,1,1,USA
Henry John,1887-06-24,0,1914,1914,6,24,USA
James Edward,1961-04-22,14,1984,1998,4,22,USA
Brian Lee,1966-10-31,1,1995,1996,10,31,USA
Sam,1963-12-05,2,1985,1987,12,5,USA
Horace Kent,1903-07-18,0,1925,1925,7,18,USA
John Westly,1892-01-02,0,1912,1912,1,2,USA
Michael Joseph,1988-12-12,1,2013,2014,12,12,USA
Masao,1968-09-12,6,1999,2005,9,12,Japan
Carter Alswinn,1997-09-03,0,2019,2019,9,3,USA
Spencer John,1991-03-16,2,2016,2018,3,16,USA
Dana Ervin,1961-02-25,1,1990,1991,2,25,USA
Joseph William,1899-07-19,6,1920,1926,7,19,USA
Mark Andrew,1968-11-13,3,1993,1996,11,13,USA
Steven George,1960-10-18,5,1984,1989,10,18,USA
Dean Allen,1989-06-07,2,2016,2018,6,7,USA
Robert Michael,1976-08-05,6,2001,2007,8,5,USA
John Francis,1964-10-04,2,1991,1993,10,4,USA
Leo Patrick,1929-11-30,9,1951,1960,11,30,USA
William,1860-03-12,2,1882,1884,3,12,USA
Kevin James,1990-04-22,6,2013,2019,4,22,USA
Michael Brooks,1972-06-06,8,1996,2004,6,6,USA
Roger Keith,1987-01-21,1,2013,2014,1,21,USA
Mark Winston,1980-05-30,0,2006,2006,5,30,USA
Yusei,1991-06-17,0,2019,2019,6,17,Japan
Brad Thomas,1983-02-19,1,2009,2010,2,19,USA
Peter John,1893-04-04,4,1917,1921,4,4,USA
Darryl Andrew,1968-12-02,11,1991,2002,12,2,USA
John Frederick,1859-07-01,7,1884,1891,7,1,USA
Paul Nelson,1962-02-02,6,1987,1993,2,2,USA
Joseph Isadore,1890-08-10,0,1914,1914,8,10,USA
Michael David,1945-04-11,4,1969,1973,4,11,CAN
William,1887-10-10,12,1909,1921,10,10,USA
Evans Henry,1936-02-27,0,1959,1959,2,27,USA
Frank Bissell,1870-11-30,9,1891,1900,11,30,USA
Harmon Clayton,1936-06-29,21,1954,1975,6,29,USA
Wade,1885-04-13,9,1907,1916,4,13,USA
Edwin Henry,1876-11-12,7,1903,1910,11,12,USA
John William,1887-05-24,0,1911,1911,5,24,USA
Matthew Aloysius,1866-06-21,12,1886,1898,6,21,USA
Michael Joseph,1869-11-04,3,1888,1891,11,4,USA
Cole A.,1985-08-01,0,2011,2011,8,1,USA
Eugene Boynton,1850-08-31,0,1871,1871,8,31,USA
Newell Whitney,1915-03-27,6,1937,1943,3,27,USA
Harry Lydle,1909-03-13,3,1936,1939,3,13,USA
Samuel Jackson,1852-10-29,1,1884,1885,10,29,USA
Richard Lewis,1915-07-27,0,1945,1945,7,27,USA
Craig Michael,1988-05-28,9,2010,2019,5,28,USA
Byung-Hyun,1979-01-19,8,1999,2007,1,19,South Korea
Harold Lee,1898-03-15,0,1920,1920,3,15,USA
Hyun Soo,1988-01-12,1,2016,2017,1,12,South Korea
Bruce Edward,1951-06-29,4,1976,1980,6,29,USA
Walter Lyons,1897-05-30,7,1919,1926,5,30,USA
Clyde Elias,1906-08-06,7,1929,1936,8,6,USA
Sun-Woo,1977-09-04,5,2001,2006,9,4,South Korea
Gerald Donald,1935-05-27,9,1956,1965,5,27,USA
Ellis Raymond,1914-07-26,11,1946,1957,7,26,USA
Isiah,1995-03-23,1,2018,2019,3,23,USA
Ralph McPherran,1922-10-27,9,1946,1955,10,27,USA
Charles Gilbert,1930-11-10,5,1954,1959,11,10,USA
Clyde Edward,1924-05-23,9,1944,1953,5,23,USA
Curtis Albert,1970-10-25,2,1997,1999,10,25,USA
Westcott William,1900-07-04,0,1932,1932,7,4,USA
Michael Scott,1961-03-29,10,1986,1996,3,29,USA
Eric Steven,1964-04-10,6,1986,1992,4,10,USA
Scott M.,1994-04-29,1,2018,2019,4,29,USA
Harold,1944-02-01,7,1967,1974,2,1,USA
Nicholas Gordon,1991-11-08,1,2018,2019,11,8,USA
Jeffrey Wayne,1964-12-26,10,1989,1999,12,26,USA
James Hubert,1932-08-27,12,1955,1967,8,27,USA
Kevin Ray,1969-02-11,2,1993,1995,2,11,USA
Edward Lee,1894-03-28,3,1916,1919,3,28,USA
Edward Lee,1892-12-26,6,1916,1922,12,26,USA
Lynn Paul,1907-11-28,4,1935,1939,11,28,USA
Brian Paul,1954-07-27,4,1979,1983,7,27,USA
David Arthur,1948-12-21,15,1971,1986,12,21,USA
Henry Lees,1892-04-03,0,1914,1914,4,3,China
Michael McRae,1995-05-25,0,2019,2019,5,25,USA
Nelson Joseph,1928-03-15,3,1954,1957,3,15,USA
Raymond Keith,1974-01-15,9,1999,2008,1,15,USA
Samuel Warren,1852-05-17,0,1884,1884,5,17,USA
Eugene Humphrey,1976-08-20,7,1996,2003,8,20,Aruba
Charles Frederick,1868-01-11,11,1886,1897,1,11,USA
Michael Arthur,1973-05-06,5,1998,2003,5,6,USA
Tyler Harrison,1991-01-31,1,2018,2019,1,31,USA
William Francis,1874-03-21,0,1895,1895,3,21,USA
Dennis Paul,1952-02-26,4,1978,1982,2,26,USA
Joshua Thomas,1979-03-31,6,2006,2012,3,31,USA
Matthew John,1976-12-16,5,2000,2005,12,16,USA
Walter William,1893-09-09,5,1918,1923,9,9,USA
Michael John,1958-04-01,7,1980,1987,4,1,USA
Robert Francis,1899-01-05,1,1919,1920,1,5,USA
Edward William,1880-01-15,5,1905,1910,1,15,USA
William H.,1867-11-09,0,1893,1893,11,9,USA
Ian Michael,1982-06-22,13,2006,2019,6,22,USA
Thomas F.,1866-01-12,12,1886,1898,1,12,USA
Brandon Lee,1984-08-01,9,2010,2019,8,1,USA
Matthew Roy,1963-06-17,1,1989,1990,6,17,USA
Walter Henry,1857-03-16,2,1882,1884,3,16,USA
Harry Hersel,1910-07-19,0,1934,1934,7,19,USA
Jason Michael,1987-04-03,8,2011,2019,4,3,USA
Robert Wayne,1964-07-08,7,1985,1992,7,8,USA
Edward August,1879-01-23,0,1914,1914,1,23,USA
Thornton John,1928-09-27,2,1953,1955,9,27,USA
Fred Leo,1931-10-01,3,1957,1960,10,1,USA
Clayton Laws,1948-06-25,7,1969,1976,6,25,USA
James Herschel,1923-05-05,0,1949,1949,5,5,USA
John F.,1865-01-13,4,1884,1888,1,13,USA
LaRue,1889-12-30,3,1912,1915,12,30,USA
Wayne Leonard,1964-01-22,7,1991,1998,1,22,USA
Michael Andrew,1897-09-30,2,1919,1921,9,30,USA
William Partlemore,1934-07-19,0,1961,1961,7,19,USA
Judson Fabian,1888-06-16,8,1910,1918,6,16,USA
Willie Charles,1934-02-17,8,1958,1966,2,17,USA
Michael Scott,1986-09-18,6,2010,2016,9,18,USA
Edgar Leon,1944-10-08,15,1962,1977,10,8,USA
Enos Claire,1884-12-09,3,1912,1915,12,9,USA
Thomas Daniel,1927-09-27,0,1947,1947,9,27,USA
Donald Paul,1949-09-24,4,1974,1978,9,24,USA
Joseph John,1931-10-04,4,1950,1954,10,4,USA
Harry Louis,1887-10-17,0,1910,1910,10,17,USA
Garland Routhard,1968-07-08,0,1991,1991,7,8,USA
Ernest Alexander,1918-02-06,0,1945,1945,2,6,USA
Charles Samuel,1876-12-13,1,1902,1903,12,13,USA
Bruce Eugene,1950-02-18,14,1971,1985,2,18,USA
William Francis,1871-08-15,2,1895,1897,8,15,USA
Christopher Anestos,1928-02-11,0,1954,1954,2,11,USA
Frank R.,1869-09-11,9,1898,1907,9,11,USA
Ronald Dale,1958-01-05,9,1982,1991,1,5,USA
Andrew Michael,1990-03-17,2,2017,2019,3,17,USA
Malachi Jeddidah,1869-10-12,16,1890,1906,10,12,USA
Patrick Anthony,1989-12-22,2,2016,2018,12,22,USA
Hugo Emil,1908-10-15,0,1934,1934,10,15,USA
Frederick Albert Antony,1943-10-31,1,1966,1967,10,31,USA
Daniel Victor,1975-09-22,5,1998,2003,9,22,CAN
William Joseph,1928-12-09,11,1952,1963,12,9,USA
Robert Francis,1937-12-27,1,1964,1965,12,27,USA
Albert Herman,1889-03-20,4,1909,1913,3,20,USA
Thomas Carl,1958-06-24,0,1985,1985,6,24,USA
Ollie Chester,1900-05-20,0,1925,1925,5,20,USA
Charles Herbert,1904-10-07,16,1928,1944,10,7,USA
Harold John,1923-06-08,1,1944,1945,6,8,USA
Louis Frank,1918-10-22,8,1943,1951,10,22,USA
Norbert George,1911-05-19,2,1935,1937,5,19,USA
Phil William,1989-04-30,2,2014,2016,4,30,USA
John Peter,1877-07-20,7,1904,1911,7,20,USA
Theodore Otto,1899-04-08,4,1934,1938,4,8,USA
William Joseph,1874-02-22,NA,NA,NA,2,22,USA
Edward Lloyd,1888-03-17,8,1911,1919,3,17,USA
Ryan Anthony,1971-06-12,15,1992,2007,6,12,USA
Jay Allen,1949-12-02,0,1976,1976,12,2,USA
Edward Frederick,1918-03-21,7,1943,1950,3,21,USA
Louis Stephen,1939-10-15,12,1958,1970,10,15,USA
Ronald Bernard,1944-03-01,3,1969,1972,3,1,USA
Robert George,1909-12-09,4,1930,1934,12,9,USA
John Robert,1929-01-27,0,1955,1955,1,27,USA
Branden Alexander,1991-09-29,0,2019,2019,9,29,USA
Ronald Lee,1932-03-09,18,1952,1970,3,9,USA
Steven Jack,1947-10-06,7,1970,1977,10,6,USA
Steven James,1972-08-22,10,1997,2007,8,22,USA
William,1867-01-14,4,1891,1895,1,14,USA
Robert Harold,1908-06-04,9,1938,1947,6,4,USA
John,1875-11-13,13,1900,1913,11,13,USA
Joseph John,1902-08-02,3,1927,1930,8,2,USA
Rudolph A.,1870-03-23,0,1902,1902,3,23,USA
Scott Edward,1971-02-03,4,1994,1998,2,3,USA
Joseph Charles,1962-02-03,9,1987,1996,2,3,USA
John Calvin,1927-10-17,17,1950,1967,10,17,USA
Frederick Augustus,1871-06-13,6,1896,1902,6,13,USA
Stanley Harold,1910-12-22,0,1944,1944,12,22,USA
John Clarence,1903-09-07,1,1931,1932,9,7,Poland
Corey Scott,1986-04-10,8,2011,2019,4,10,USA
Josie,1895-03-26,4,1921,1925,3,26,USA
Elmer Edward,1906-08-26,3,1934,1937,8,26,USA
William F.,1865-03-24,2,1888,1890,3,24,USA
Theodore Bernard,1924-09-10,14,1947,1961,9,10,USA
Clyde Franklin,1917-12-12,10,1942,1952,12,12,USA
Gene Ellis,1954-09-20,7,1976,1983,9,20,USA
Joseph Robert,1963-05-03,2,1993,1995,5,3,USA
Franz Otto,1884-06-12,11,1905,1916,6,12,USA
Brent Bradley,1969-08-01,6,1990,1996,8,1,USA
Andrew Michael,1991-11-09,2,2017,2019,11,9,USA
Robert Christian,1953-09-16,5,1975,1980,9,16,USA
Henry Antone,1889-08-13,1,1910,1911,8,13,USA
Corey Andrew,1991-11-26,4,2014,2018,11,26,USA
Rudolph Frank,1899-04-10,0,1926,1926,4,10,USA
Philip Louis,1865-03-12,7,1888,1895,3,12,USA
Robert Wesley,1954-05-25,14,1976,1990,5,25,USA
Charles,1871-02-18,0,1899,1899,2,18,USA
Wallace Luther,1921-08-21,2,1945,1947,8,21,USA
Elmer Ellsworth,1885-07-22,8,1909,1917,7,22,USA
Alan Lee,1955-05-19,7,1979,1986,5,19,USA
Austin Jay,1918-10-15,0,1947,1947,10,15,USA
William Hart,1911-12-29,9,1933,1942,12,29,USA
Brandon Michael,1975-10-01,7,2001,2008,10,1,USA
George Henry,1855-11-24,0,1875,1875,11,24,USA
Elmer Russell,1895-01-12,5,1922,1927,1,12,USA
Jonah William,1859-09-28,6,1884,1890,9,28,CAN
John Wesley,1885-10-06,8,1905,1913,10,6,USA
Alonzo P.,1853-06-16,10,1875,1885,6,16,USA
Charles Ray,1952-12-28,14,1974,1988,12,28,USA
Peter Cole,1884-08-11,3,1912,1915,8,11,USA
Andrew Robert,1995-02-03,0,2019,2019,2,3,USA
Edward Charles,1968-07-07,11,1991,2002,7,7,USA
Kenneth Thomson,1895-11-08,0,1920,1920,11,8,USA
Robert Troxell,1901-01-28,3,1923,1926,1,28,USA
Justin Joseph,1980-07-17,2,2004,2006,7,17,USA
Oscar Edward,1883-12-18,0,1906,1906,12,18,USA
Charles Elmer,1881-10-07,0,1905,1905,10,7,USA
Robert Frank,1938-10-18,8,1964,1972,10,18,USA
Randy Duane,1968-11-12,10,1991,2001,11,12,USA
Wilfred Edgar,1903-05-01,1,1932,1933,5,1,USA
George Bertram,1898-01-12,0,1932,1932,1,12,USA
Eric James,1974-09-23,2,2001,2003,9,23,USA
Gary Everett,1977-02-12,3,2001,2004,2,12,USA
John Henry,1907-03-02,13,1933,1946,3,2,USA
Joseph Steven,1884-03-03,0,1907,1907,3,3,USA
Jonathan David,1978-08-04,3,2004,2007,8,4,USA
Jacob Augustus,1852-07-26,4,1874,1878,7,26,USA
William Young,1898-08-18,0,1920,1920,8,18,USA
Darold Duane,1941-12-09,15,1965,1980,12,9,USA
James,1856-09-05,8,1884,1892,9,5,CAN
Thomas Herbert,1895-04-23,0,1915,1915,4,23,USA
Andrew Jackson,1864-01-06,0,1890,1890,1,6,USA
Clifford Hiram,1902-01-07,0,1924,1924,1,7,USA
John Clinton,1948-07-26,3,1972,1975,7,26,USA
Guido Joel,1989-08-05,0,2015,2015,8,5,USA
Kurt David,1967-02-20,2,1992,1994,2,20,USA
Mark Richard,1960-10-28,8,1985,1993,10,28,USA
Nicholas Nicholie,1935-07-19,2,1953,1955,7,19,USA
Masahide,1974-05-24,1,2008,2009,5,24,Japan
Kevin Richard,1953-10-02,7,1973,1980,10,2,USA
Jeffrey Gilbert,1988-06-30,1,2013,2014,6,30,USA
Alan Goodman,1938-03-25,1,1963,1964,3,25,USA
Barnett,1923-03-23,0,1944,1944,3,23,USA
William Christopher,1974-12-14,5,1999,2004,12,14,USA
Bradley Wilson,1888-01-16,4,1912,1916,1,16,USA
Matthew David,1990-11-02,3,2016,2019,11,2,USA
Richard Finlay,1926-03-30,2,1946,1948,3,30,USA
Peter John,1947-07-31,2,1970,1972,7,31,USA
Bernard James,1877-01-26,1,1905,1906,1,26,Germany
Horace Levering,1902-01-16,0,1925,1925,1,16,USA
Thomas R.,1986-06-29,5,2012,2017,6,29,USA
Brian Wayne,1969-06-11,0,1993,1993,6,11,USA
Leonard George,1904-01-18,3,1932,1935,1,18,USA
Mark Anthony,1904-07-19,11,1925,1936,7,19,USA
Willis Thomas,1896-02-27,0,1919,1919,2,27,USA
Elmer Joseph,1885-11-30,4,1910,1914,11,30,USA
Henry C.,1852-05-05,3,1871,1874,5,5,USA
Joseph James,1913-01-28,1,1937,1938,1,28,USA
Ryan Lyle,1977-06-25,1,2000,2001,6,25,USA
Michael Thomas,1986-06-26,5,2010,2015,6,26,USA
Richard Jerome,1928-02-28,6,1948,1954,2,28,USA
Adam John,1989-01-14,2,2017,2019,1,14,USA
Brandon Charles,1973-11-20,1,2000,2001,11,20,USA
Daniel Lee,1975-03-29,8,1999,2007,3,29,USA
Edward William,1880-07-20,0,1899,1899,7,20,USA
Gary Alan,1940-03-13,9,1960,1969,3,13,USA
Donald Martin,1918-08-04,13,1940,1953,8,4,USA
Raymond Carl,1894-10-01,13,1921,1934,10,1,USA
Karl Dickey,1892-12-25,0,1915,1915,12,25,USA
Harold Everette,1935-06-01,1,1962,1963,6,1,USA
Erik Jordan,1987-10-01,0,2012,2012,10,1,USA
Shane Kenji,1980-10-18,1,2006,2007,10,18,USA
Satoru,1965-09-15,0,2002,2002,9,15,Japan
Frederick Raymond,1886-03-31,1,1913,1914,3,31,USA
Brad Lynn,1961-04-04,8,1983,1991,4,4,USA
Paul Henry,1976-03-05,17,1997,2014,3,5,USA
Edward Joseph,1885-09-03,14,1907,1921,9,3,USA
Douglas James,1951-09-27,4,1973,1977,9,27,USA
Alexander James,1928-06-08,6,1948,1954,6,8,USA
Michael Aloysius,1889-01-13,1,1909,1910,1,13,USA
Bruno Bruce,1919-09-16,4,1942,1946,9,16,USA
Casimir James,1917-03-02,12,1944,1956,3,2,USA
George Nicholas,1985-06-12,7,2011,2018,6,12,USA
Dennis John,1971-02-04,0,1995,1995,2,4,USA
Ernest Gerald,1892-09-11,4,1915,1919,9,11,USA
Dae-Sung,1969-08-02,0,2005,2005,8,2,South Korea
Calvin Lee,1940-11-18,9,1962,1971,11,18,USA
Graham Clinton,1975-05-15,0,2003,2003,5,15,USA
Harry M.,1862-08-18,0,1884,1884,8,18,USA
Jerome Martin,1942-12-23,18,1967,1985,12,23,USA
George Felix,1941-02-26,4,1966,1970,2,26,USA
Michael Talbert,1996-04-30,0,2018,2018,4,30,USA
William Lorenz,1890-11-03,10,1913,1923,11,3,USA
Walter Henry,1899-07-10,0,1921,1921,7,10,USA
Howard Dean,1938-05-04,5,1961,1966,5,4,USA
Michael Paul,1976-08-30,6,2001,2007,8,30,USA
Joseph,1930-10-19,7,1958,1965,10,19,USA
Merlin Henry,1892-01-02,4,1915,1919,1,2,USA
George Karl,1896-07-27,0,1923,1923,7,27,USA
Stephen Joseph,1932-08-11,5,1954,1959,8,11,USA
Robert John,1979-09-16,6,2008,2014,9,16,USA
Arthur Emil,1886-07-22,0,1915,1915,7,22,USA
George Eugene,1946-01-10,1,1966,1967,1,10,CAN
John Vincent,1980-07-03,4,2005,2009,7,3,USA
James,1874-03-04,3,1894,1897,3,4,USA
Andrew John,1941-10-05,9,1965,1974,10,5,USA
Joseph Steven,1982-05-26,1,2007,2008,5,26,USA
Clement John,1925-06-20,1,1952,1953,6,20,USA
William John,1932-02-06,0,1951,1951,2,6,USA
Cordel Leonard,1973-06-28,8,1998,2006,6,28,CAN
George Bernard,1920-03-31,14,1941,1955,3,31,USA
Kevin Craig,1966-09-24,4,1992,1996,9,24,USA
Michael Thomas,1917-11-26,0,1944,1944,11,26,USA
Joseph William,1876-06-01,0,1896,1896,6,1,USA
Frederick Charles,1905-12-21,0,1931,1931,12,21,USA
Frank Jerry,1937-08-04,7,1962,1969,8,4,USA
Casey John,1983-02-22,9,2004,2013,2,22,USA
Mark Steven,1975-12-02,16,1997,2013,12,2,USA
George,1983-05-10,6,2008,2014,5,10,CAN
Sanford,1935-12-30,11,1955,1966,12,30,USA
Joseph,1880-03-03,0,1904,1904,3,3,Austria
Louis Laddie,1898-12-19,12,1925,1937,12,19,USA
Kevin,1981-07-25,8,2006,2014,7,25,USA
Fabian Lorenz,1908-04-22,4,1932,1936,4,22,USA
Brian Mark,1969-08-07,0,1995,1995,8,7,USA
Ernest Anyz,1909-09-17,4,1938,1942,9,17,USA
Albert Kenneth,1921-07-05,2,1948,1950,7,5,USA
Benjamin Anthony,1980-08-16,0,2002,2002,8,16,USA
Peter Michael,1988-04-11,7,2011,2018,4,11,USA
Joseph Peter,1913-11-04,0,1939,1939,11,4,USA
Joseph Wayne,1964-09-10,1,1989,1990,9,10,USA
Clarence Otto,1887-06-09,0,1914,1914,6,9,USA
Joseph Victor Lawrence,1915-03-28,9,1937,1946,3,28,CAN
John Francis,1935-06-01,8,1959,1967,6,1,USA
Steve Charles,1929-04-18,0,1953,1953,4,18,USA
John Henry,1918-01-05,12,1939,1951,1,5,USA
Kevin Lowell,1993-10-03,1,2018,2019,10,3,USA
Randall John,1960-09-20,4,1988,1992,9,20,USA
Thomas Joseph,1968-01-09,2,1991,1993,1,9,USA
Edward Emil,1944-11-08,17,1962,1979,11,8,USA
Eugene Hamlet,1887-05-12,4,1911,1915,5,12,USA
Erik Floyd,1980-06-15,9,2010,2019,6,15,USA
Charles Fredrick,1873-10-02,0,1901,1901,10,2,USA
Harry William,1888-07-12,4,1908,1912,7,12,USA
John William,1918-04-26,3,1943,1946,4,26,USA
Lewis Bernard,1912-06-08,1,1931,1932,6,8,USA
Lewis Bernard,1943-04-25,13,1961,1974,4,25,USA
Marc S.,1987-10-05,2,2013,2015,10,5,USA
Kenneth Peter,1951-07-29,7,1975,1982,7,29,USA
Daniel,1930-12-21,4,1956,1960,12,21,USA
Raymond Allen,1959-10-09,5,1984,1989,10,9,USA
Michael Andreas,1908-06-10,14,1931,1945,6,10,USA
Joseph Roland,1992-12-20,0,2018,2018,12,20,USA
Charles L.,1863-07-05,1,1884,1885,7,5,USA
Albert Joseph,1922-10-10,1,1943,1944,10,10,USA
Ralph Wesley,1885-11-13,0,1911,1911,11,13,USA
James Edward,1965-10-08,0,1990,1990,10,8,USA
Remy Peter,1893-03-23,9,1924,1933,3,23,USA
James Louis,1949-02-28,1,1973,1974,2,28,USA
Wayne Richard,1954-09-17,7,1979,1986,9,17,USA
Charles Steven,1921-12-09,7,1947,1954,12,9,USA
Ralph,1905-01-02,19,1927,1946,1,2,USA
Louis Henry,1921-06-27,10,1946,1956,6,27,USA
Richard Allen,1948-11-03,3,1975,1978,11,3,USA
Chadden Michael,1964-08-26,15,1988,2003,8,26,USA
Franklin James,1939-02-07,7,1962,1969,2,7,USA
Paul Bernard,1882-12-19,1,1911,1912,12,19,France
William Frederick,1859-01-29,3,1884,1887,1,29,USA
Kurt Ferdinand,1926-09-16,2,1949,1951,9,16,Austria
Howard Wilbur,1916-02-28,9,1937,1946,2,28,USA
Rick Michael,1970-01-19,3,1995,1998,1,19,USA
August H.,1866-05-09,2,1888,1890,5,9,USA
Joshua J.,1982-08-31,0,2004,2004,8,31,USA
Zachary B.,1984-04-21,1,2010,2011,4,21,USA
Floyd Myron,1886-08-25,6,1906,1912,8,25,USA
Ian A.,1991-05-09,5,2013,2018,5,9,USA
John Thomas,1936-07-05,NA,NA,NA,7,5,USA
Gary Melvin,1941-07-08,5,1964,1969,7,8,USA
John Harold,1908-11-13,3,1935,1938,11,13,USA
Marc Jason,1973-04-02,9,1995,2004,4,2,USA
Michael,1931-09-24,2,1960,1962,9,24,USA
Rocco Peter,1927-08-05,4,1949,1953,8,5,USA
William Culp,1958-04-24,12,1983,1995,4,24,USA
Ernest George,1890-12-27,12,1913,1925,12,27,USA
Arthur William,1876-09-17,6,1899,1905,9,17,USA
Everett Ben,1939-12-25,4,1965,1969,12,25,USA
Abraham,1885-02-14,0,1908,1908,2,14,USA
Arthur Theodore,1881-03-16,8,1907,1915,3,16,USA
Gary Eugene,1955-02-12,0,1981,1981,2,12,USA
Henry Charles,1876-12-04,0,1902,1902,12,4,USA
Martin John,1888-09-10,10,1912,1922,9,10,Germany
John Martin,1961-02-09,9,1986,1995,2,9,USA
Michael Edward,1952-01-21,13,1976,1989,1,21,USA
Albert,1865-01-13,0,1889,1889,1,13,USA
Richard David,1925-03-24,6,1949,1955,3,24,USA
David Benjamin,1981-11-07,1,2004,2005,11,7,USA
Anthony Christopher,1935-10-12,8,1957,1965,10,12,USA
Jason James,1982-05-25,10,2004,2014,5,25,USA
Jeffrey Scot,1974-08-24,1,1998,1999,8,24,USA
Theodore Rodger,1942-05-12,9,1967,1976,5,12,USA
Timothy Mark,1972-01-20,2,1997,1999,1,20,USA
John Henry,1936-12-19,1,1961,1962,12,19,USA
Kyle Andrew,1990-07-15,0,2015,2015,7,15,USA
Gilbert Thomas,1954-10-12,0,1980,1980,10,12,USA
John Albert,1919-12-17,2,1950,1952,12,17,USA
John Andrew Charles,1953-06-08,6,1974,1980,6,8,USA
John Charles,1932-07-27,5,1955,1960,7,27,USA
Stanislaw Leo,1924-12-28,0,1949,1949,12,28,USA
Bernard Carl,1920-01-08,0,1943,1943,1,8,USA
Karl Otto,1937-09-05,NA,NA,NA,9,5,USA
William J.,1858-10-24,9,1883,1892,10,24,Germany
Harvey Edward,1930-12-04,14,1952,1966,12,4,USA
Fred Mahele,1953-02-23,4,1977,1981,2,23,USA
Joseph Anthony,1906-06-25,17,1930,1947,6,25,USA
Chad Michael,1992-09-10,2,2016,2018,9,10,USA
Bowie Kent,1926-10-28,NA,NA,NA,10,28,USA
Bernard Daniel,1899-10-12,0,1924,1924,10,12,USA
Joel Kenneth,1995-02-19,0,2019,2019,2,19,USA
Kenneth Harold,1937-03-20,2,1955,1957,3,20,USA
Charles Benton,1876-10-27,2,1897,1899,10,27,USA
Charles Walter,1887-02-02,2,1912,1914,2,2,USA
Duane Eugene,1950-06-19,11,1974,1985,6,19,USA
John A.,1882-06-24,0,1909,1909,6,24,USA
John Michael,1926-05-19,0,1955,1955,5,19,USA
William Gustave James,1936-07-07,2,1961,1963,7,7,USA
Jeffrey William,1962-03-25,8,1984,1992,3,25,USA
Russell Jay,1955-02-04,6,1979,1985,2,4,USA
Earl Dewey,1898-12-25,0,1923,1923,12,25,USA
Edward Cory,1986-04-08,0,2008,2008,4,8,USA
Hung-Chih,1981-07-23,6,2005,2011,7,23,Taiwan
Hiroki,1975-02-10,6,2008,2014,2,10,Japan
Ryan Yoshitomo,1952-07-03,0,1975,1975,7,3,USA
George John,1918-04-19,8,1941,1949,4,19,USA
Harold James,1943-08-20,0,1968,1968,8,20,USA
Edward Daniel,1886-02-15,0,1909,1909,2,15,USA
Emil Benedict,1916-11-04,8,1941,1949,11,4,USA
Craig Robert,1948-09-30,6,1973,1979,9,30,USA
Arthur William,1945-12-19,8,1970,1978,12,19,USA
Joseph Julius,1882-09-05,0,1909,1909,9,5,USA
Randy Scott,1960-04-30,4,1986,1990,4,30,USA
Joseph Peter,1885-01-16,1,1911,1912,1,16,USA
Marion John,1932-11-14,3,1959,1962,11,14,USA
Jerry Scott,1965-03-25,0,1990,1990,3,25,USA
Masumi,1968-04-01,0,2007,2007,4,1,Japan
Robert Leroy,1923-05-28,11,1946,1957,5,28,USA
Alexander,1921-01-11,0,1942,1942,1,11,USA
Andrew Ewing,1889-10-29,0,1912,1912,10,29,CAN
Chester Peter,1912-04-30,10,1937,1947,4,30,USA
John Joshua,1979-02-25,0,2004,2004,2,25,USA
Clement Walter,1926-08-06,12,1950,1962,8,6,USA
Jairo Snaider,1994-03-07,0,2017,2017,3,7,D.R.
Jose Alberto,1940-07-03,4,1969,1973,7,3,P.R.
Robert Joseph,1953-08-25,7,1977,1984,8,25,USA
George Joseph,1870-02-14,12,1893,1905,2,14,USA
Marcel Ernest,1941-06-13,2,1969,1971,6,13,USA
Rene George,1945-05-04,3,1965,1968,5,4,USA
Allen Robert,1960-09-06,0,1983,1983,9,6,USA
William Doddridge,1870-12-08,0,1890,1890,12,8,USA
John Derran,1978-10-23,15,2002,2017,10,23,USA
Ralph Pierre,1952-01-17,8,1972,1980,1,17,USA
Frank Joseph,1951-10-13,9,1975,1984,10,13,USA
Michael James,1956-05-30,13,1978,1991,5,30,USA
Osceola Guy,1897-06-12,0,1926,1926,6,12,USA
Kerry Ardeen,1972-08-07,1,1996,1997,8,7,USA
Leondaus,1948-04-10,15,1972,1987,4,10,USA
Arthur Clifford,1870-02-09,0,1898,1898,2,9,USA
Peter Linwood,1956-07-17,7,1979,1986,7,17,USA
Doyle Marion,1921-02-17,4,1946,1950,2,17,USA
Tyler James,1988-03-07,1,2015,2016,3,7,USA
Joseph Joseph,1921-08-03,2,1947,1949,8,3,USA
Aaron Steven,1985-04-15,8,2007,2015,4,15,USA
Frank Bernard,1854-05-04,1,1876,1877,5,4,USA
Edward Francis,1886-04-07,6,1909,1915,4,7,USA
Pierre Luc,1978-01-27,4,2003,2007,1,27,CAN
Byron Joseph,1917-04-18,0,1945,1945,4,18,CAN
Roger Victor,1956-08-02,0,1982,1982,8,2,USA
Robert Joseph,1986-06-25,2,2013,2015,6,25,USA
Michael Russell,1960-06-14,8,1982,1990,6,14,USA
Juan Osvaldo,1989-03-17,6,2013,2019,3,17,D.R.
Edwin Joseph,1912-07-14,0,1934,1934,7,14,USA
Lerrin Harris,1948-07-08,10,1970,1980,7,8,USA
Bryan Allan,1982-11-05,4,2008,2012,11,5,USA
Joseph Michael,1947-04-14,10,1968,1978,4,14,USA
Jeffrey Allen,1956-10-08,4,1982,1986,10,8,USA
Brady Joe,1993-08-09,0,2019,2019,8,9,USA
Brandon J.,1987-09-11,2,2011,2013,9,11,USA
Gerald Lee,1979-11-13,12,2003,2015,11,13,USA
Richard Edward,1926-01-08,0,1946,1946,1,8,USA
Napoleon,1874-09-05,20,1896,1916,9,5,USA
Edward Erving,1916-03-18,11,1939,1950,3,18,USA
Frederick Lovett,1866-10-16,19,1891,1910,10,16,CAN
Joseph Henry,1881-01-06,5,1908,1913,1,6,USA
Junior Osvaldo,1990-03-27,3,2013,2016,3,27,D.R.
Albert Wesley,1918-12-31,12,1942,1954,12,31,USA
Timothy John,1969-11-27,14,1992,2006,11,27,USA
Steven Michael,1957-03-14,10,1983,1993,3,14,USA
Travis Clay,1994-06-29,0,2019,2019,6,29,USA
Blake Thomas,1983-05-12,4,2012,2016,5,12,USA
Daniel J.,1867-08-12,6,1891,1897,8,12,USA
John Alexander,1936-10-03,6,1962,1968,10,3,USA
Alfred Anthony,1921-07-22,3,1943,1946,7,22,USA
Frank James,1906-09-30,0,1935,1935,9,30,USA
Frank,1919-08-22,2,1940,1942,8,22,USA
Raymond Simond,1919-11-17,7,1941,1948,11,17,USA
William Harmong,1897-03-21,10,1917,1927,3,21,USA
Ryan M.,1988-11-21,4,2015,2019,11,21,USA
Noble Wayne,1907-02-13,1,1937,1938,2,13,USA
David Christian,1975-06-06,3,1999,2002,6,6,USA
Christopher Raymond,1983-03-08,1,2008,2009,3,8,USA
Clayton Patrick,1917-03-26,1,1946,1947,3,26,USA
Eugene Marion,1921-04-26,1,1941,1942,4,26,USA
Otis Samuel,1890-05-13,2,1916,1918,5,13,USA
Peter Joseph,1997-04-18,0,2019,2019,4,18,USA
Jacob Ryan,1990-10-09,5,2014,2019,10,9,USA
John Andrew,1946-07-20,3,1970,1973,7,20,USA
John Michael,1990-07-10,3,2015,2018,7,10,USA
Lyman Raymond,1895-03-17,1,1920,1921,3,17,USA
Michael Robert,1975-08-09,10,2000,2010,8,9,USA
Andrew Francis,1988-08-11,3,2013,2016,8,11,USA
Raymond Richard,1944-12-23,4,1969,1973,12,23,USA
Pierre,1873-12-27,5,1902,1907,12,27,USA
Dinelson,1992-07-18,2,2017,2019,7,18,D.R.
Frederick Arthur,1887-08-14,3,1912,1915,8,14,USA
Gene William,1946-12-25,5,1970,1975,12,25,USA
Robert Eugene,1898-02-15,6,1920,1926,2,15,USA
Christopher Keith,1945-12-20,1,1969,1970,12,20,United Kingdom
Dennis Patrick,1952-09-23,15,1977,1992,9,23,USA
Henry Joseph,1872-09-19,1,1894,1895,9,19,USA
Thomas Michael,1964-03-04,14,1988,2002,3,4,USA
Richard Anthony,1911-09-27,6,1935,1941,9,27,USA
Lester Wayne,1962-04-21,6,1987,1993,4,21,USA
Gary Dean,1948-09-21,0,1977,1977,9,21,USA
Richard Anthony,1956-07-05,8,1982,1990,7,5,USA
William Gilbert,1903-05-14,0,1929,1929,5,14,USA
Kenneth Henry,1928-07-29,0,1952,1952,7,29,USA
Rafael Silvaldo,1953-05-28,7,1977,1984,5,28,D.R.
Grover Cleveland,1884-09-22,7,1908,1915,9,22,USA
William Henry,1942-10-08,6,1963,1969,10,8,USA
Samuel H.,1854-08-16,0,1882,1882,8,16,USA
James Henry,1934-03-09,10,1957,1967,3,9,USA
Kenesaw Mountain,1866-11-20,NA,NA,NA,11,20,USA
Thomas William,1957-08-17,7,1986,1993,8,17,USA
Cedric Bernard,1963-09-03,2,1991,1993,9,3,USA
Donald Leroy,1936-02-16,9,1957,1966,2,16,USA
Hobart Neal,1930-03-16,13,1950,1963,3,16,USA
Jesse Glenn,1912-07-31,0,1938,1938,7,31,USA
Joseph Butler,1928-12-13,2,1950,1952,12,13,USA
Kenneth Francis,1954-12-22,10,1977,1987,12,22,USA
Larry Robert,1955-03-11,1,1976,1977,3,11,CAN
Terry Lee,1954-10-25,8,1980,1988,10,25,USA
Richard Harrison,1927-06-28,0,1949,1949,6,28,USA
James Hunter,1900-07-20,0,1924,1924,7,20,USA
Jason Dean,1976-12-22,12,2002,2014,12,22,USA
Jerald Hal,1926-02-07,2,1953,1955,2,7,USA
Marvin,1950-01-18,5,1971,1976,1,18,USA
Lewis Grover,1886-01-08,0,1907,1907,1,8,USA
Walter Oswald,1916-11-09,6,1941,1947,11,9,USA
Robert David,1952-08-21,1,1975,1976,8,21,USA
Donald Charles,1915-03-15,10,1938,1948,3,15,USA
William Alexander,1871-06-06,6,1893,1899,6,6,USA
Richard Otto,1948-09-01,3,1972,1975,9,1,USA
Erwin Henry,1887-08-12,0,1914,1914,8,12,USA
Frank Herman Carl,1883-10-28,3,1910,1913,10,28,USA
Ryan David,1980-02-20,11,2002,2013,2,20,USA
James Rick,1952-03-20,10,1976,1986,3,20,USA
Elton,1900-05-21,2,1926,1928,5,21,USA
Martin John,1905-09-27,0,1930,1930,9,27,USA
Robert William,1865-08-05,0,1899,1899,8,5,USA
Mark Edward,1960-08-20,15,1984,1999,8,20,USA
Matthew August,1986-05-06,0,2013,2013,5,6,USA
Harold Clifton,1942-07-04,9,1964,1973,7,4,USA
Hubert Max,1915-08-18,15,1938,1953,8,18,USA
Lorenzo,1948-10-19,0,1971,1971,10,19,USA
Frank Greenfield,1971-03-26,0,1998,1998,3,26,USA
Raymond Lewis,1967-06-05,14,1990,2004,6,5,USA
John Edward,1984-09-27,7,2007,2014,9,27,USA
John Young,1910-09-06,11,1936,1947,9,6,USA
Lester Alfred,1895-05-13,0,1916,1916,5,13,USA
Thomas Newton,1907-04-22,0,1938,1938,4,22,USA
Carney Ray,1957-02-07,14,1978,1992,2,7,USA
Joseph Dale,1961-01-15,1,1982,1983,1,15,USA
Eugene Hewitt,1898-01-11,0,1922,1922,1,11,USA
Michael Thomas,1968-04-03,8,1993,2001,4,3,USA
Paul Edmore,1923-12-14,6,1951,1957,12,14,USA
Peter Nelson,1891-06-25,1,1922,1923,6,25,USA
Andrew,1922-11-01,1,1942,1943,11,1,USA
David Jeffrey,1959-07-29,11,1980,1991,7,29,USA
Raoul Robert,1922-01-08,1,1947,1948,1,8,USA
Frank Breyfogle,1880-02-06,10,1905,1915,2,6,USA
Matthew Vincent,1985-01-08,3,2009,2012,1,8,USA
John Walker,1884-09-10,8,1908,1916,9,10,USA
Juan Manuel,1981-01-26,1,2006,2007,1,26,D.R.
Yovanny B.,1975-09-20,0,2000,2000,9,20,D.R.
Jeffrey David,1982-10-11,2,2008,2010,10,11,USA
Norman Howard John,1930-12-27,5,1958,1963,12,27,USA
Patrick C.,1860-02-14,0,1884,1884,2,14,USA
Andrew Dane,1974-06-27,4,1996,2000,6,27,USA
Barry Louis,1964-04-28,18,1986,2004,4,28,USA
Edward Francis,1885-07-01,0,1909,1909,7,1,USA
Eugene Thomas,1962-10-24,6,1987,1993,10,24,USA
Henry E.,1860-01-12,9,1884,1893,1,12,USA
Patrick Cliborn,1960-06-14,0,1983,1983,6,14,USA
Stephen Patrick,1910-12-09,0,1934,1934,12,9,USA
Stephen Karari,1973-07-24,0,1998,1998,7,24,USA
Robert McKahan,1896-12-06,0,1918,1918,12,6,USA
David Adam,1979-11-06,11,2004,2015,11,6,USA
Andrew Christian,1983-09-13,6,2007,2013,9,13,USA
David Eugene,1948-05-14,13,1970,1983,5,14,USA
Gregory Mark,1972-11-10,3,2000,2003,11,10,USA
Simeon Henry Jean,1863-02-26,3,1888,1891,2,26,CAN
Harry Raymond,1888-01-02,0,1914,1914,1,2,USA
Henry John,1951-10-25,0,1978,1978,10,25,USA
Victor Raymond,1944-12-23,0,1968,1968,12,23,USA
Don James,1929-08-07,14,1953,1967,8,7,USA
Erling Adell,1913-11-15,0,1936,1936,11,15,USA
Brandon John,1976-05-24,3,2001,2004,5,24,USA
Daniel James,1954-07-04,6,1976,1982,7,4,USA
Michael Jason,1974-03-19,11,1999,2010,3,19,USA
Anthony,1944-10-04,10,1963,1973,10,4,USA
Alfred Allen,1928-09-26,8,1954,1962,9,26,USA
Frank Strong,1930-04-10,11,1954,1965,4,10,USA
Lynford Hobart,1906-01-28,11,1929,1940,1,28,USA
Frederick Walter,1941-08-19,8,1963,1971,8,19,USA
William Alan,1957-12-20,6,1982,1988,12,20,USA
Willard Almond,1902-07-13,0,1924,1924,7,13,USA
Thomas Charles,1927-09-22,2,1954,1956,9,22,USA
Donald O'Neal,1933-03-27,0,1957,1957,3,27,USA
Thomas F.,1989-01-31,5,2014,2019,1,31,USA
Walter Arlington,1860-03-15,29,1880,1909,3,15,USA
William Carol,1960-08-29,1,1985,1986,8,29,USA
Christopher Joseph,1973-05-26,6,1997,2003,5,26,USA
George Warren,1852-09-06,9,1875,1884,9,6,USA
Charles Ten Eyck,1888-10-22,1,1910,1911,10,22,USA
William George,1891-08-12,1,1913,1914,8,12,USA
Clifford Wesley,1877-11-30,4,1898,1902,11,30,USA
Arnold Barry,1936-05-21,10,1957,1967,5,21,USA
Mathew Adam,1987-12-09,8,2009,2017,12,9,USA
William Hershel,1884-05-25,0,1908,1908,5,25,USA
Charles Richard,1933-04-12,11,1956,1967,4,12,USA
William,1874-02-23,5,1898,1903,2,23,USA
Timothy Jon,1958-06-07,8,1981,1989,6,7,USA
John Charles,1865-04-05,6,1884,1890,4,5,USA
Eric Lance,1995-06-03,1,2018,2019,6,3,USA
Ramon,1994-07-15,1,2018,2019,7,15,D.R.
William Bernard,1879-06-09,1,1904,1905,6,9,USA
George Albert,1947-07-22,3,1967,1970,7,22,Cuba
Harry Arthur,1912-12-01,13,1934,1947,12,1,USA
Michael Eugene,1960-08-18,11,1984,1995,8,18,USA
John Leonard,1890-10-28,11,1913,1924,10,28,USA
Ryan Cole,1987-08-07,8,2011,2019,8,7,USA
Gary Robert,1949-01-03,13,1974,1987,1,3,USA
James Sanford,1884-03-26,5,1912,1917,3,26,USA
Arthur David,1885-01-26,0,1914,1914,1,26,USA
Derek Robert,1990-09-14,3,2016,2019,9,14,USA
Garland Frederick,1918-08-29,0,1946,1946,8,29,USA
Thomas James,1956-12-19,8,1982,1990,12,19,USA
Michael H.,1854-03-11,4,1880,1884,3,11,USA
William Henry,1906-03-11,0,1932,1932,3,11,USA
Robert Andrew,1899-12-14,0,1924,1924,12,14,USA
Brooks Ulysses,1925-01-30,6,1954,1960,1,30,USA
Brian Michael,1976-05-14,6,2001,2007,5,14,USA
Casey Lee,1987-10-28,1,2017,2018,10,28,USA
James Ross,1939-02-12,0,1963,1963,2,12,CAN
Joseph Dudley,1977-02-13,0,2002,2002,2,13,USA
Sean Christopher,1970-09-02,0,1998,1998,9,2,USA
Brett Russell,1990-01-18,5,2011,2016,1,18,CAN
Ronald David,1946-03-14,0,1969,1969,3,14,CAN
Rudy Karl,1956-10-07,8,1978,1986,10,7,USA
Otis Carroll,1893-11-01,1,1916,1917,11,1,USA
Alfred William,1869-03-24,0,1890,1890,3,24,United Kingdom
Robert Baker,1875-08-23,1,1901,1902,8,23,USA
Alfred Voyle,1906-04-13,10,1930,1940,4,13,USA
Steven George,1950-12-28,0,1972,1972,12,28,USA
Marcus Dwayne,1965-08-18,0,1989,1989,8,18,USA
Matthew,1971-11-30,11,1995,2006,11,30,USA
Vance Aaron,1956-10-01,11,1980,1991,10,1,USA
Vernon Sanders,1930-03-12,17,1950,1967,3,12,USA
William Harry,1948-01-05,7,1970,1977,1,5,USA
Brett William,1973-10-05,1,1999,2000,10,5,USA
Timothy Joseph,1964-03-02,3,1990,1993,3,2,USA
Eugene Francis,1894-03-14,0,1915,1915,3,14,USA
Peter John,1919-12-30,0,1948,1948,12,30,USA
Herman,1901-02-13,0,1927,1927,2,13,USA
Ivoria Hillis,1918-02-23,4,1941,1945,2,23,USA
Thomas Kevin,1984-11-02,5,2012,2017,11,2,USA
Lester Lee,1921-11-18,0,1948,1948,11,18,USA
John Daniel,1943-11-14,1,1968,1969,11,14,USA
Raudel,1989-04-12,0,2015,2015,4,12,Cuba
Jack Thomas,1956-03-30,4,1984,1988,3,30,USA
John Paul,1912-09-09,3,1943,1946,9,9,USA
Anthony Michael,1903-12-06,13,1926,1939,12,6,USA
Charles William,1956-12-25,8,1980,1988,12,25,France
Brent Allen,1982-11-18,0,2009,2009,11,18,USA
Frederick,1897-11-23,9,1923,1932,11,23,USA
Jalal Donnell,1969-03-14,0,2001,2001,3,14,USA
Richard Max,1957-05-04,9,1981,1990,5,4,USA
Terry Hester,1954-03-13,12,1981,1993,3,13,USA
Thomas William,1877-11-04,20,1898,1918,11,4,USA
Robert H.,1858-11-11,NA,NA,NA,11,11,USA
Brandon Paul,1983-03-16,10,2004,2014,3,16,USA
Daniel C.,1870-08-08,0,1896,1896,8,8,USA
Thomas Joseph,1869-06-02,8,1897,1905,6,2,USA
Michael Raymond,1987-11-12,9,2010,2019,11,12,USA
Luis Enrique,1957-03-21,5,1980,1985,3,21,Venezuela
William Wallace,1885-10-14,0,1917,1917,10,14,USA
Frederick Francis,1894-04-07,5,1915,1920,4,7,USA
Charles Bernard,1891-01-23,1,1914,1915,1,23,USA
Francis Patrick,1881-02-26,0,1907,1907,2,26,USA
John Louis,1891-05-02,1,1914,1915,5,2,USA
Timothy James,1958-12-23,13,1981,1994,12,23,USA
Harold Langford,1898-12-02,0,1920,1920,12,2,USA
John Victor,1990-07-14,2,2015,2017,7,14,USA
Emil Bohmiel,1881-05-15,0,1905,1905,5,15,USA
Wade Matthew,1984-08-07,11,2008,2019,8,7,USA
DeWitt Wiley,1896-08-24,10,1919,1929,8,24,USA
George Lewis,1886-10-18,1,1914,1915,10,18,USA
Jose Ramon,1993-12-19,3,2016,2019,12,19,D.R.
Matthew Hanks,1975-12-13,7,2000,2007,12,13,USA
Samuel R.,1984-05-04,5,2010,2015,5,4,USA
Ralph Overton,1894-12-08,0,1915,1915,12,8,USA
Ricardo Alberto,1973-11-22,9,1998,2007,11,22,P.R.
Aaron David,1971-06-03,5,1995,2000,6,3,USA
Wilfredo Jose,1981-01-21,8,2003,2011,1,21,Venezuela
William Joseph,1894-01-09,1,1915,1916,1,9,USA
William Crutcher,1909-10-21,13,1934,1947,10,21,USA
William Francis,1946-12-28,13,1969,1982,12,28,USA
Robert Dean,1937-11-26,4,1964,1968,11,26,USA
Braxton Russell,1993-08-23,0,2018,2018,8,23,USA
Carlos,1976-06-20,13,1999,2012,6,20,Panama
Chen-Chang,1986-10-21,2,2013,2015,10,21,Taiwan
Clifford Walker,1896-08-04,7,1919,1926,8,4,USA
Clifton Phifer,1978-08-30,12,2002,2014,8,30,USA
Corey Wayne,1974-12-26,0,1999,1999,12,26,USA
David Emmer,1973-03-12,5,1999,2004,3,12,USA
Dae-ho,1982-06-21,0,2016,2016,6,21,South Korea
Derek Gerald,1966-07-28,0,1993,1993,7,28,USA
Derrek Leon,1975-09-06,14,1997,2011,9,6,USA
Donald Edward,1934-02-26,9,1957,1966,2,26,USA
Ernest Holford,1899-08-22,6,1920,1926,8,22,USA
Harold Burnham,1905-02-15,6,1930,1936,2,15,USA
Eugene Harold,1936-07-15,3,1959,1962,7,15,USA
Leonidas Pyrrhus,1860-12-13,0,1877,1877,12,13,USA
Leron,1948-03-04,7,1969,1976,3,4,USA
Mark Linden,1953-06-14,3,1978,1981,6,14,USA
Manuel Lora,1965-06-17,10,1985,1995,6,17,D.R.
Mark Owen,1964-07-20,7,1988,1995,7,20,USA
Michael Randall,1941-05-19,3,1960,1963,5,19,USA
David Dale,1959-10-30,1,1984,1985,10,30,USA
Roy Edwin,1917-09-28,0,1945,1945,9,28,USA
Sang-Hoon,1971-03-11,0,2000,2000,3,11,South Korea
George Edward,1895-02-02,0,1921,1921,2,2,USA
Charles James,1987-03-10,1,2013,2014,3,10,USA
Terry James,1962-03-13,1,1990,1991,3,13,USA
Thornton Starr,1906-09-13,15,1933,1948,9,13,USA
Thomas Frank,1862-06-08,0,1884,1884,6,8,USA
Travis Reynolds,1975-05-26,8,1998,2006,5,26,USA
Samuel,1871-12-23,12,1898,1910,12,23,USA
Wyatt Arnold,1879-08-12,3,1901,1904,8,12,USA
Zachary Stephen,1991-09-13,2,2015,2017,9,13,USA
Wilfred Henry,1915-11-11,6,1938,1944,11,11,USA
James Kenneth,1942-01-07,7,1965,1972,1,7,USA
Joseph Henry,1956-02-22,6,1980,1986,2,22,USA
Alfred Modesto,1898-09-16,0,1920,1920,9,16,USA
Craig Lindsay,1957-09-29,11,1983,1994,9,29,Germany
Wade Hampton,1896-06-05,0,1924,1924,6,5,USA
Ronald,1948-06-16,8,1974,1982,6,16,USA
Phillip Dale,1969-05-19,3,1993,1996,5,19,USA
Louis Alfred,1901-06-01,6,1929,1935,6,1,USA
Gregory Lynn,1960-04-21,1,1986,1987,4,21,USA
James Francis,1856-05-14,0,1884,1884,5,14,USA
Michael M.,1865-04-15,1,1890,1891,4,15,USA
Regis Francis,1908-01-05,0,1932,1932,1,5,USA
James Anthony,1937-08-19,1,1961,1962,8,19,USA
Kenneth Karl,1928-06-10,9,1952,1961,6,10,USA
Paul Eugene,1920-07-01,6,1946,1952,7,1,USA
Clarence Emanuel,1886-05-16,0,1911,1911,5,16,USA
Charles Larry,1977-08-03,5,2004,2009,8,3,USA
Norman Carl Michael,1901-05-28,0,1926,1926,5,28,USA
Henry Edward,1911-01-17,9,1933,1942,1,17,USA
Harry Loran,1892-02-17,12,1913,1925,2,17,USA
Charles Louis,1956-10-04,14,1979,1993,10,4,USA
Jonathan David,1979-02-07,3,2004,2007,2,7,USA
Elmer Edwin,1893-05-23,0,1921,1921,5,23,USA
Albert Peter,1883-09-05,15,1905,1920,9,5,USA
John Atkinson,1861-10-04,0,1890,1890,10,4,USA
William Charles,1893-11-04,0,1912,1912,11,4,USA
Edgar Ellsworth,1910-11-29,3,1939,1942,11,29,USA
David Paul,1962-06-18,12,1984,1996,6,18,USA
John Henry Thomas,1867-12-23,0,1891,1891,12,23,USA
John William,1961-01-03,3,1987,1990,1,3,USA
Alois Terry,1965-10-23,18,1987,2005,10,23,USA
Mark Edward,1963-04-13,11,1990,2001,4,13,USA
Mark Edward,1991-03-13,1,2017,2018,3,13,USA
William,1873-05-31,0,1899,1899,5,31,USA
George Aloysius,1865-09-14,0,1887,1887,9,14,USA
George Michael,1871-06-19,1,1901,1902,6,19,USA
Scott Thomas,1965-09-24,9,1990,1999,9,24,USA
Frank John,1936-02-07,8,1954,1962,2,7,USA
Sheldon Aldenburg,1885-07-22,4,1911,1915,7,22,USA
Donald Everett,1934-05-13,0,1965,1965,5,13,USA
William John,1884-10-21,1,1909,1910,10,21,Netherlands
John Frank,1885-11-14,5,1909,1914,11,14,Netherlands
David John,1988-07-13,8,2011,2019,7,13,USA
David Lawrence,1950-08-17,7,1973,1980,8,17,USA
Denver Clayton,1939-02-25,10,1962,1972,2,25,USA
Johnnie Lee,1954-06-19,12,1975,1987,6,19,USA
Richard Paul,1938-08-28,2,1961,1963,8,28,USA
Stephen Neal,1926-11-13,2,1950,1952,11,13,USA
Mark Alan,1965-08-13,10,1988,1998,8,13,USA
Robert Granville,1920-09-22,17,1941,1958,9,22,USA
Chester Earl,1955-02-12,15,1975,1990,2,12,USA
David Lee,1948-07-05,3,1969,1972,7,5,USA
James Robert,1928-03-23,13,1950,1963,3,23,USA
Mark,1955-07-21,3,1976,1979,7,21,USA
Donald Eugene,1922-10-04,4,1950,1954,10,4,USA
William H.,1845-01-03,2,1871,1873,1,3,USA
Robert Albert,1928-09-15,3,1954,1957,9,15,USA
James Edgar,1883-11-03,9,1906,1915,11,3,USA
Edward Francis,1897-08-17,0,1928,1928,8,17,USA
Patrick Orlando,1968-04-27,8,1991,1999,4,27,USA
James Matthew,1954-07-16,2,1978,1980,7,16,USA
Andrew Jackson,1846-06-01,9,1871,1880,6,1,Ireland
Walter Fenner,1907-09-08,NA,NA,NA,9,8,USA
Dennis Patrick,1951-05-18,12,1974,1986,5,18,USA
Hubert Benjamin,1892-04-16,12,1913,1925,4,16,USA
Emil John,1909-03-25,20,1933,1953,3,25,USA
Elmer Ellsworth,1888-11-12,0,1911,1911,11,12,USA
Jeffrey,1955-09-22,13,1977,1990,9,22,USA
Joseph Howard,1893-11-14,6,1914,1920,11,14,USA
Mark David,1964-08-14,5,1990,1995,8,14,USA
Alex Arnold,1988-09-06,1,2015,2016,9,6,Mexico
Arcenio,1986-09-22,0,2017,2017,9,22,Venezuela
Danilo Enrique,1967-04-03,0,1992,1992,4,3,Venezuela
Eduardo Antonio,1946-08-11,7,1968,1975,8,11,USA
Dominic Joseph,1991-10-26,5,2014,2019,10,26,USA
Justin Paul,1977-03-09,2,2004,2006,3,9,USA
David Paul,1941-01-22,5,1967,1972,1,22,USA
Isidoro,1911-01-04,0,1945,1945,1,4,Cuba
Jose Geraldo,1976-12-08,2,2002,2004,12,8,P.R.
Maximino,1950-02-04,5,1973,1978,2,4,Mexico
Sandy David,1989-03-13,7,2012,2019,3,13,Venezuela
Rudolph Matas,1905-07-27,0,1928,1928,7,27,USA
John Joseph,1918-05-05,0,1941,1941,5,5,USA
Thaddeus Stanley,1929-07-28,9,1952,1961,7,28,USA
Louis Joseph,1876-09-05,0,1902,1902,9,5,CAN
Don Eugene,1930-11-20,0,1955,1955,11,20,USA
Donald George,1931-10-19,3,1961,1964,10,19,USA
Bertram Roe,1889-04-04,0,1910,1910,4,4,USA
George Edward,1922-12-01,1,1952,1953,12,1,USA
Randy Louis,1954-10-09,11,1975,1986,10,9,USA
Anthony Allen,1982-10-28,5,2005,2010,10,28,USA
Walter Irvin,1903-02-10,1,1928,1929,2,10,USA
Christopher A.,1984-04-14,5,2009,2014,4,14,CAN
John Michael,1975-04-19,0,1997,1997,4,19,USA
Louis Paul,1879-02-18,5,1905,1910,2,18,USA
Barry Lee,1944-09-07,5,1969,1974,9,7,USA
Steven James,1984-10-13,1,2012,2013,10,13,USA
Brian Herbert,1971-03-05,6,1996,2002,3,5,Belgium
Donald Lee,1946-11-25,0,1972,1972,11,25,USA
Curtis John,1968-04-02,11,1993,2004,4,2,USA
Bradley Jay,1958-09-11,3,1982,1985,9,11,USA
Roy Reid,1894-08-23,5,1917,1922,8,23,USA
Samuel Andrew,1905-07-26,9,1929,1938,7,26,USA
Jonathan Tyler,1984-01-07,13,2006,2019,1,7,USA
Charlie,1915-10-03,7,1939,1946,10,3,USA
David,1851-01-01,0,1872,1872,1,1,Germany
Jesse Roy,1926-07-15,8,1947,1955,7,15,USA
Gorham Vance,1894-03-29,7,1922,1929,3,29,USA
Horace Wilbur,1889-02-04,0,1920,1920,2,4,USA
Walter Fred,1888-07-21,2,1913,1915,7,21,USA
James Julius,1906-09-13,3,1930,1933,9,13,USA
Alan Brian,1968-05-22,9,1996,2005,5,22,USA
Charles H.,1860-06-21,1,1884,1885,6,21,USA
Jesse,1968-04-14,9,1992,2001,4,14,USA
Allen Harry,1977-08-15,3,2000,2003,8,15,USA
Emil Henry,1898-04-29,5,1923,1928,4,29,USA
Edward Clarence,1916-10-28,4,1940,1944,10,28,USA
Dennis Dale,1953-08-11,7,1975,1982,8,11,USA
Daniel William,1928-01-06,0,1951,1951,1,6,USA
Arthur Michael,1992-04-08,1,2017,2018,4,8,USA
Allan Sydney,1941-12-12,6,1967,1973,12,12,Panama
William Burton,1895-10-03,0,1924,1924,10,3,USA
William Henry,1904-10-15,3,1933,1936,10,15,USA
John Kelly,1916-08-10,14,1935,1949,8,10,USA
Colby Preston,1979-08-02,14,2002,2016,8,2,USA
Darren Joel,1967-08-28,12,1990,2002,8,28,USA
George Edward,1888-04-18,11,1910,1921,4,18,USA
Frederick Miller,1858-10-13,5,1881,1886,10,13,USA
Frederick Deshaun,1980-12-09,6,2006,2012,12,9,USA
John David,1884-02-14,4,1911,1915,2,14,USA
Jensen Daniel,1984-05-16,3,2007,2010,5,16,USA
James Martin,1955-10-12,6,1979,1985,10,12,USA
James Steven,1964-07-20,0,1991,1991,7,20,USA
Johnny Joe,1939-08-10,3,1964,1967,8,10,USA
Kyle Alexander,1995-07-13,0,2019,2019,7,13,USA
Mark David,1969-11-30,10,1991,2001,11,30,USA
Philip,1883-10-07,3,1905,1908,10,7,USA
Richie Todd,1966-01-25,6,1992,1998,1,25,USA
Rommie Lee,1982-09-02,1,2010,2011,9,2,USA
Scott Allen,1965-12-05,4,1990,1994,12,5,USA
Scott Edwin,1983-09-26,1,2008,2009,9,26,USA
Edward Morgan,1872-12-25,5,1896,1901,12,25,United Kingdom
Domingo Junior,1995-09-11,0,2019,2019,9,11,D.R.
James Richard,1944-12-15,NA,NA,NA,12,15,USA
James Joseph,1963-12-27,10,1990,2000,12,27,USA
Terrance Richard,1947-02-21,0,1971,1971,2,21,USA
Nicholas Tomas,1953-08-16,NA,NA,NA,8,16,USA
Carlos Manuel,1955-09-30,1,1980,1981,9,30,P.R.
Sixto Joaquin,1953-11-28,11,1974,1985,11,28,P.R.
Stephen Augustus,1853-12-08,0,1879,1879,12,8,USA
Adam Joseph,1987-05-12,3,2015,2018,5,12,USA
Albert Walter,1918-09-12,1,1945,1946,9,12,USA
Francisco,1948-05-06,0,1969,1969,5,6,P.R.
John Wilbur,1960-04-04,0,1981,1981,4,4,USA
David Alexander,1966-06-15,0,1990,1990,6,15,USA
Alessandro,1988-08-14,2,2011,2013,8,14,Italy
Donald Eugene,1925-05-25,3,1953,1956,5,25,USA
Bradley Thomas,1976-12-23,10,2002,2012,12,23,USA
Cory Fulton,1972-03-22,9,1997,2006,3,22,USA
Charles Edwin,1910-02-01,1,1935,1936,2,1,USA
Jonathan Ray,1970-04-02,14,1994,2008,4,2,USA
Michael Scott,1972-01-18,13,1994,2007,1,18,USA
Glenn John,1883-03-10,3,1906,1909,3,10,USA
Glenn Ignatius,1910-07-31,8,1930,1938,7,31,USA
Jeffrey David,1974-08-17,6,1999,2005,8,17,USA
Frederick Richard,1885-10-07,0,1910,1910,10,7,USA
Patrick James,1991-03-29,0,2016,2016,3,29,USA
Kerry Dale,1971-05-11,8,1997,2005,5,11,USA
William Beverly,1918-01-10,1,1939,1940,1,10,USA
Robert Eugene,1913-11-12,4,1936,1940,11,12,USA
Robert Perry,1930-06-02,9,1958,1967,6,2,USA
Brent Stuart,1983-09-18,5,2008,2013,9,18,USA
Derek Jansen,1966-02-20,7,1989,1996,2,20,USA
James J.,1861-07-27,3,1883,1886,7,27,USA
Theodore Roosevelt,1976-01-04,14,1999,2013,1,4,USA
Jose Desiderio Rodriguez,1972-09-30,12,1994,2006,9,30,D.R.
Chang-Yong,1976-06-04,0,2013,2013,6,4,South Korea
Abraham Louis,1925-03-10,3,1951,1954,3,10,USA
Rufino de la Cruz,1951-02-28,4,1981,1985,2,28,D.R.
Timothy LeRoy,1984-06-15,9,2007,2016,6,15,USA
Che-Hsuan,1988-09-21,0,2012,2012,9,21,Taiwan
Brad Eric,1985-05-25,4,2010,2014,5,25,USA
Ezra Perry,1868-11-17,0,1890,1890,11,17,USA
Michael George,1975-04-10,11,1999,2010,4,10,USA
Adam Alan,1983-07-17,11,2006,2017,7,17,USA
Vivan Alexander,1877-10-28,3,1906,1909,10,28,USA
Emerit Desmond,1934-08-27,0,1960,1960,8,27,USA
Joshua William,1987-06-15,6,2011,2017,6,15,USA
Paul Aaron,1941-08-09,13,1965,1978,8,9,USA
Henry Carl,1903-09-19,3,1927,1930,9,19,USA
John Frederick Mann,1878-06-07,0,1901,1901,6,7,USA
Ernest Theodore,1883-06-10,0,1907,1907,6,10,USA
James William,1962-01-10,8,1986,1994,1,10,USA
John Harlan,1916-08-30,13,1941,1954,8,30,USA
Lyman Gilbert,1920-09-30,1,1947,1948,9,30,USA
Todd Anthony,1980-06-30,4,2003,2007,6,30,USA
Walter Charles,1924-03-27,0,1950,1950,3,27,USA
Jacob Stephen,1993-03-12,0,2015,2015,3,12,USA
Jackson Hugh,1946-06-08,1,1974,1975,6,8,USA
Jose,1964-05-01,8,1987,1995,5,1,P.R.
Francisco Miguel,1993-11-14,4,2015,2019,11,14,P.R.
Carl Emil,1919-05-09,1,1943,1944,5,9,USA
Olof Axel,1895-08-26,0,1916,1916,8,26,Sweden
William Gibbons,1881-02-24,0,1911,1911,2,24,USA
William Donald,1960-04-12,0,1987,1987,4,12,USA
Christian Haller,1878-07-24,1,1905,1906,7,24,USA
Charles William,1936-09-07,0,1958,1958,9,7,USA
Michael Douglas,1967-09-22,2,1991,1993,9,22,USA
Frederick Charles,1905-11-21,12,1924,1936,11,21,USA
James Kendrick,1899-01-24,15,1922,1937,1,24,USA
John William,1977-01-30,0,2010,2010,1,30,USA
Matthew Raymond,1980-02-11,7,2007,2014,2,11,USA
Rodney Lee,1976-01-28,0,2000,2000,1,28,USA
Shane Anthony,1985-01-25,0,2011,2011,1,25,Australia
Scott Cameron,1976-08-04,11,2000,2011,8,4,USA
Richard George,1938-08-17,1,1966,1967,8,17,CAN
Carl James,1929-12-14,0,1952,1952,12,14,Czech Republic
Cole Edward,1976-08-23,1,1999,2000,8,23,USA
Edward Karl,1911-11-09,5,1933,1938,11,9,USA
Frederick Theodore,1886-03-11,0,1910,1910,3,11,USA
Jon Paul,1984-03-23,0,2010,2010,3,23,USA
Claud Clarence,1902-04-18,0,1929,1929,4,18,USA
Douglas Warren,1965-02-09,11,1992,2003,2,9,USA
Royce James,1921-01-01,0,1954,1954,1,1,USA
Tzu-Wei,1994-02-15,2,2017,2019,2,15,Taiwan
Larry,1949-10-10,5,1973,1978,10,10,USA
Philip Francis,1939-06-04,6,1962,1968,6,4,USA
Frank Alfred,1940-09-15,11,1963,1974,9,15,USA
Michael Angelo,1929-07-06,2,1956,1958,7,6,USA
John Joseph,1922-11-10,12,1942,1954,11,10,USA
Thomas Charles,1870-06-04,0,1897,1897,6,4,USA
Gerard,1911-02-24,0,1937,1937,2,24,USA
Robert Peter,1938-07-07,0,1963,1963,7,7,USA
Antonio Felipe,1972-04-26,6,1995,2001,4,26,Venezuela
Francisco Casillas,1983-10-26,14,2005,2019,10,26,D.R.
Nelson Arturo,1964-06-03,11,1987,1998,6,3,D.R.
Pedro Antonio,1980-10-23,1,2004,2005,10,23,D.R.
Rymer Omar,1991-06-20,3,2014,2017,6,20,D.R.
Horace Milton,1898-09-23,18,1927,1945,9,23,USA
Ricardo Patrick Emilio,1956-03-17,0,1981,1981,3,17,CAN
Joseph Anthony,1946-08-15,7,1970,1977,8,15,USA
Adolph James,1906-07-10,4,1929,1933,7,10,USA
Patrick Alan,1967-09-12,5,1992,1997,9,12,USA
Morris Elmer,1881-07-21,0,1907,1907,7,21,USA
Jesse Allen,1985-03-09,4,2007,2011,3,9,USA
Mark Alan,1953-01-17,9,1973,1982,1,17,USA
Zack Stuart,1995-10-05,1,2018,2019,10,5,USA
Richard Bryan,1959-10-08,4,1982,1986,10,8,USA
Charles Carlisle,1901-10-06,1,1927,1928,10,6,USA
Dennis Gerald,1954-10-04,2,1978,1980,10,4,USA
Richard Bernard,1926-03-18,8,1950,1958,3,18,USA
William Grady,1950-03-03,NA,NA,NA,3,3,USA
Henry Alexander,1850-11-09,0,1877,1877,11,9,USA
William Arthur,1891-03-12,0,1912,1912,3,12,USA
Donald Jeffrey,1954-12-25,2,1980,1982,12,25,USA
John Andrew,1954-01-05,1,1980,1981,1,5,USA
Larry Marvin,1954-04-03,0,1981,1981,4,3,USA
Mark Travis,1972-07-11,6,1998,2004,7,11,USA
Dennis Scott,1963-01-19,0,1989,1989,1,19,USA
Wes Avi,1982-09-02,2,2006,2008,9,2,USA
Jon Gregory,1964-07-13,5,1989,1994,7,13,USA
Jack Napier,1929-01-22,5,1952,1957,1,22,USA
Daniel Webster,1916-08-31,11,1940,1951,8,31,USA
Edward Bennett,1992-03-05,2,2017,2019,3,5,USA
Everett Adrian,1925-02-14,2,1947,1949,2,14,USA
Henry Everett,1885-05-29,0,1911,1911,5,29,USA
Wesley Amos,1910-07-18,0,1939,1939,7,18,USA
Robert James,1982-09-03,1,2006,2007,9,3,USA
Jacob Mayer,1875-03-22,0,1901,1901,3,22,Russia
Thompson Orville,1914-11-15,13,1938,1951,11,15,USA
Patrick Joseph,1880-01-14,16,1901,1917,1,14,USA
Scott Louis,1965-07-15,7,1991,1998,7,15,USA
Abel,1870-04-13,0,1896,1896,4,13,USA
Radhames Corey,1983-10-06,8,2007,2015,10,6,D.R.
Winston Enriquillo,1943-09-23,7,1968,1975,9,23,D.R.
Clement Manly,1895-08-01,0,1922,1922,8,1,USA
Graeme John,1967-04-09,10,1993,2003,4,9,Australia
Kyle Christopher,1990-10-16,0,2017,2017,10,16,USA
John Henry,1884-04-25,NA,NA,NA,4,25,USA
Jonathan Stanley,1994-11-02,1,2018,2019,11,2,Nicaragua
Esteban Antonio,1971-12-31,13,1995,2008,12,31,Mexico
Robert Kenneth,1914-08-05,1,1939,1940,8,5,USA
William Joseph,1894-09-27,0,1912,1912,9,27,USA
Jose Manuel,1984-10-21,9,2009,2018,10,21,Venezuela
Frank John,1883-11-26,0,1914,1914,11,26,USA
John Bernard,1881-10-18,14,1903,1917,10,18,USA
Kyle Eric,1989-08-12,2,2014,2016,8,12,USA
Timothy Donald,1992-07-14,2,2017,2019,7,14,USA
Chia-Jen,1986-04-07,0,2013,2013,4,7,Taiwan
Robert Henry,1876-03-29,2,1899,1901,3,29,USA
Don Wilson,1936-07-27,7,1962,1969,7,27,USA
Andrew Walker,1994-05-03,1,2018,2019,5,3,USA
Lawrence Donald,1934-03-03,9,1959,1968,3,3,USA
Robert Awtry,1938-03-15,10,1965,1975,3,15,USA
Charles Edward,1932-05-05,0,1955,1955,5,5,USA
Jeffrey Alan,1987-11-20,6,2011,2017,11,20,USA
Marshall Pinkney Wilder,1857-03-12,0,1884,1884,3,12,USA
Ronald Thomas,1942-04-04,0,1964,1964,4,4,USA
Keith Virgil,1964-11-10,9,1994,2003,11,10,USA
Gene,1949-07-19,4,1973,1977,7,19,USA
Stuart Carlton,1928-07-22,1,1955,1956,7,22,USA
Carroll Walter,1926-07-25,15,1945,1960,7,25,USA
Milo Hathaway,1858-04-07,0,1884,1884,4,7,USA
Claude Edward,1946-08-17,15,1965,1980,8,17,USA
Dario Antonio,1916-06-06,8,1938,1946,6,6,USA
Paul Anthony,1972-04-12,10,1998,2008,4,12,USA
Kameron David,1981-09-10,9,2004,2013,9,10,USA
George Herbert,1901-09-11,2,1928,1930,9,11,USA
William,1929-12-13,11,1950,1961,12,13,USA
Adam Alexander,1984-04-09,10,2006,2016,4,9,CAN
Carlton Edward,1973-09-24,5,1998,2003,9,24,USA
James O'Neal,1974-03-06,0,2001,2001,3,6,USA
Kenneth,1967-05-31,16,1991,2007,5,31,USA
Richard Joseph,1901-03-07,1,1924,1925,3,7,USA
Francis Patrick,1898-03-10,0,1926,1926,3,10,USA
Thomas Joseph,1856-11-15,6,1877,1883,11,15,USA
Robert Dean,1910-02-10,10,1935,1945,2,10,USA
Boone,1984-08-13,12,2006,2018,8,13,USA
John,1926-03-23,12,1951,1963,3,23,USA
Exavier Prente,1979-11-28,3,2004,2007,11,28,USA
George Frederick,1864-10-21,0,1891,1891,10,21,USA
Howard Sylvester,1892-06-03,2,1914,1916,6,3,USA
Jack Wayne,1924-02-25,6,1947,1953,2,25,USA
William Leroy,1913-05-22,10,1934,1944,5,22,USA
Kyle Matthew,1978-10-04,15,2001,2016,10,4,USA
Alberto,1956-05-06,1,1978,1979,5,6,D.R.
Richard Frank,1972-01-12,5,1996,2001,1,12,USA
Michael Stephen,1940-09-12,16,1963,1979,9,12,USA
Ronald John,1946-09-19,2,1971,1973,9,19,USA
John Sherman,1924-08-23,17,1946,1963,8,23,USA
William Timothy,1956-03-17,6,1980,1986,3,17,USA
Ryan Matthew,1986-12-16,0,2015,2015,12,16,USA
Douglas Edward,1958-05-09,1,1984,1985,5,9,USA
Steven James,1977-08-29,0,1999,1999,8,29,USA
Ernesto Natali,1908-04-06,16,1931,1947,4,6,USA
George Paul,1975-09-14,8,1998,2006,9,14,USA
Louis,1928-11-18,0,1948,1948,11,18,USA
Phillip Arden,1963-02-20,3,1986,1989,2,20,USA
Stephen Paul,1960-04-26,5,1985,1990,4,26,USA
Stephen Anthony Paul,1988-09-20,6,2011,2017,9,20,USA
Victor Alvin,1922-09-20,5,1945,1950,9,20,USA
Kevin Dale,1971-11-20,1,1995,1996,11,20,USA
James Reynold,1942-04-16,14,1965,1979,4,16,USA
Walter Lawrence,1885-09-22,0,1911,1911,9,22,USA
James Anthony,1984-05-07,10,2006,2016,5,7,USA
William Douglas,1960-02-29,6,1985,1991,2,29,USA
Robert Earl,1954-11-11,4,1981,1985,11,11,USA
Daniel William,1867-08-27,0,1890,1890,8,27,USA
Richard Dale,1926-02-06,12,1951,1963,2,6,USA
Herman C.,1866-04-13,15,1889,1904,4,13,USA
Jeoffrey Keith,1941-10-09,1,1963,1964,10,9,USA
James M.,1862-11-15,2,1891,1893,11,15,USA
James Albert,1898-06-29,0,1922,1922,6,29,USA
Joey J.,1970-07-15,0,1997,1997,7,15,USA
Lester,1888-07-12,0,1911,1911,7,12,USA
Anthony Eugene,1968-08-12,2,1993,1995,8,12,USA
Evan Michael,1985-10-07,11,2008,2019,10,7,USA
Nelson,1876-09-28,0,1902,1902,9,28,CAN
Ryan Marcus,1973-02-03,0,1997,1997,2,3,USA
Shedric Bernard,1995-08-22,0,2019,2019,8,22,USA
Terrence Deon,1976-02-29,7,1999,2006,2,29,USA
Thomas Augustus,1890-06-01,6,1911,1917,6,1,USA
Thomas Francis,1898-04-22,0,1924,1924,4,22,USA
Joseph Paul,1927-02-07,3,1956,1959,2,7,USA
Bruce Michael,1943-06-09,0,1968,1968,6,9,USA
Dean Zachary,1937-07-23,0,1961,1961,7,23,USA
Brian James,1969-09-26,2,1993,1995,9,26,USA
Aaron Joseph,1976-09-07,0,2003,2003,9,7,USA
Braden LaVern,1974-10-28,11,1998,2009,10,28,USA
Ivan,1878-03-23,0,1901,1901,3,23,USA
Arthur Joseph,1919-05-28,1,1945,1946,5,28,USA
Edmund Walter,1918-06-21,11,1944,1955,6,21,USA
Stanley Edward,1925-09-12,12,1948,1960,9,12,USA
David Earl,1945-05-03,15,1972,1987,5,3,USA
Timothy A.,1994-06-24,0,2019,2019,6,24,USA
Alfonso Ramon,1908-08-20,19,1928,1947,8,20,USA
Albert Anthony,1971-08-18,10,1993,2003,8,18,USA
Aquilino,1975-04-21,5,2003,2008,4,21,D.R.
Arturo,1937-05-08,0,1965,1965,5,8,P.R.
Javier Arturo,1983-02-22,0,2009,2009,2,22,Mexico
Aurelio Alejandro,1948-09-21,13,1974,1987,9,21,Mexico
Carlos Antonio,1948-09-27,2,1976,1978,9,27,Mexico
Felipe,1980-05-12,10,2001,2011,5,12,P.R.
Hector Headley,1929-07-08,11,1955,1966,7,8,Panama
Javier,1970-11-05,14,1992,2006,11,5,P.R.
Javier Alfonso,1977-07-11,13,2003,2016,7,11,P.R.
Jose Celestino,1983-11-24,8,2004,2012,11,24,Venezuela
Jorge Yabiel,1993-02-10,4,2015,2019,2,10,P.R.
Luis Antonio,1964-09-01,1,1990,1991,9,1,USA
Luis Manuel,1970-09-04,12,1993,2005,9,4,P.R.
Luis,1973-10-05,3,2001,2004,10,5,USA
Marcelino Pons,1943-09-23,9,1963,1972,9,23,Cuba
Mendy,1973-10-15,6,1998,2004,10,15,D.R.
Raymond Michael,1973-11-17,0,2004,2004,11,17,USA
Nicholas,1995-03-13,0,2019,2019,3,13,USA
Pablo Jose,1996-03-07,1,2018,2019,3,7,Venezuela
Pedro Michel,1984-04-28,2,2005,2007,4,28,D.R.
Jose Ramon,1933-05-26,0,1966,1966,5,26,Cuba
Rafael Manuel,1987-10-02,4,2014,2018,10,2,USA
Reynaldo Starling,1994-01-04,3,2016,2019,1,4,D.R.
Rodrigo,1975-12-14,12,2000,2012,12,14,Mexico
Wilton,1983-07-19,5,2009,2014,7,19,Nicaragua
Yoan,1993-01-02,1,2018,2019,1,2,Cuba
Bristol Robotham,1883-09-21,8,1905,1913,9,21,USA
William Carlton,1900-01-07,0,1923,1923,1,7,USA
Harry Donald,1882-03-08,8,1907,1915,3,8,USA
Adolph Andreas,1893-01-12,0,1913,1913,1,12,USA
Michael Clifton,1992-01-04,4,2015,2019,1,4,USA
Mark David,1971-08-14,14,1995,2009,8,14,USA
Andrew Jason,1972-08-11,8,1994,2002,8,11,USA
Joseph Peter,1891-01-02,0,1916,1916,1,2,USA
Scott Gregory,1956-11-11,5,1980,1985,11,11,USA
Arthur,1882-04-10,0,1910,1910,4,10,USA
William P.,1883-08-27,9,1907,1916,8,27,USA
Charles Edward,1881-05-21,0,1904,1904,5,21,USA
David Dennis,1986-01-20,4,2012,2016,1,20,USA
Larry John,1941-08-16,0,1967,1967,8,16,USA
Donald Nelson,1940-11-09,0,1964,1964,11,9,USA
Aaron Christopher,1987-12-19,7,2012,2019,12,19,USA
Shane A.,1979-08-31,10,2002,2012,8,31,USA
Richard Tyler,1995-07-07,0,2019,2019,7,7,USA
Thomas Rivers,1897-10-19,0,1922,1922,10,19,USA
Vance Odell,1963-08-09,2,1988,1990,8,9,USA
Lynn Richard,1922-11-29,2,1955,1957,11,29,USA
Edward Haughton,1890-08-01,7,1913,1920,8,1,USA
John,1877-05-06,0,1903,1903,5,6,USA
Leonard Walker,1852-07-17,2,1873,1875,7,17,USA
Merritt Marwood,1912-06-15,0,1933,1933,6,15,USA
Thomas Joseph,1863-12-07,9,1885,1894,12,7,USA
John Paul,1956-05-30,3,1980,1983,5,30,USA
Joseph,1951-01-06,3,1972,1975,1,6,USA
Peter,1942-10-16,0,1963,1963,10,16,USA
Salvatore Anthony,1965-07-25,11,1988,1999,7,25,USA
Grover Cleveland,1885-01-15,11,1909,1920,1,15,USA
Louis Bailey,1887-02-23,1,1911,1912,2,23,USA
Robert Lincoln,1865-07-10,17,1890,1907,7,10,USA
Brandon Norman,1994-07-06,1,2018,2019,7,6,USA
Derek Christopher,1973-06-01,16,1997,2013,6,1,USA
Richard Alvern,1854-01-28,0,1884,1884,1,28,USA
George Wesley,1895-04-25,0,1920,1920,4,25,USA
Michael Averett,1974-02-24,12,1998,2010,2,24,P.R.
Mark Christopher,1983-06-07,10,2006,2016,6,7,USA
David Nathaniel,1995-07-07,0,2019,2019,7,7,USA
John Lee,1947-01-27,15,1970,1985,1,27,USA
Devon Eugene,1983-03-24,0,2008,2008,3,24,USA
Quenton Terrell,1970-10-25,3,1997,2000,10,25,USA
Jonathan Sean,1971-03-29,6,1997,2003,3,29,USA
Fletcher,1893-04-07,0,1915,1915,4,7,USA
Omar Joseph,1924-05-30,11,1951,1962,5,30,USA
Harry Lee,1917-08-27,13,1942,1955,8,27,USA
Jed Carlson,1984-04-17,11,2008,2019,4,17,USA
Dwight,1957-10-23,4,1984,1988,10,23,USA
Noah Ryan,1980-10-10,4,2003,2007,10,10,USA
Samuel Joseph,1920-03-25,1,1942,1943,3,25,USA
Michael Wallace,1964-03-26,1,1986,1987,3,26,USA
William,1959-05-12,0,1984,1984,5,12,USA
Steven George,1955-05-01,2,1981,1983,5,1,USA
Hugh Max,1913-06-13,8,1936,1944,6,13,USA
John,1919-02-22,9,1938,1947,2,22,USA
Edward Lee,1982-05-21,1,2013,2014,5,21,USA
Frederick Warrington,1903-01-19,0,1935,1935,1,19,USA
Gary Paul,1954-11-08,7,1980,1987,11,8,USA
John Charles,1903-02-10,1,1931,1932,2,10,USA
Joshua Timothy,1990-11-05,2,2017,2019,11,5,USA
Ray Wesley,1908-10-02,5,1929,1934,10,2,USA
Charles Fred,1902-04-28,15,1923,1938,4,28,USA
Frank Joseph,1926-04-24,NA,NA,NA,4,24,USA
Joseph George,1993-06-06,1,2018,2019,6,6,USA
Frank Edward,1896-12-06,0,1923,1923,12,6,USA
Joseph Earl,1897-03-27,5,1920,1925,3,27,USA
Elvis Enmanuel,2000-02-15,0,2019,2019,2,15,D.R.
Cornelius Cecil,1874-02-24,4,1893,1897,2,24,Ireland
Louis Joseph,1918-03-23,2,1943,1945,3,23,USA
Jonathan Charles,1986-06-13,9,2010,2019,6,13,USA
Donald Hassett,1982-08-08,4,2007,2011,8,8,USA
Frederick William,1885-09-12,11,1909,1920,9,12,USA
William Francis,1900-01-21,0,1924,1924,1,21,USA
William Lawrence,1882-05-27,0,1908,1908,5,27,USA
Eric David,1971-12-14,3,1996,1999,12,14,USA
Ryan Andrew,1978-07-13,12,2002,2014,7,13,USA
Larry Christopher,1969-10-11,7,1993,2000,10,11,USA
Roy John,1900-09-17,0,1925,1925,9,17,USA
Stephen Lee,1949-07-09,10,1971,1981,7,9,USA
Cory Robert,1985-03-04,6,2010,2016,3,4,USA
Richard Raymond,1935-04-08,0,1962,1962,4,8,USA
Richard Fred,1960-11-15,1,1989,1990,11,15,USA
Joshua William,1984-12-05,3,2011,2014,12,5,USA
Lucas Lester,1987-03-24,3,2012,2015,3,24,USA
Henry T.,1852-09-14,9,1875,1884,9,14,USA
Dawel Leoner,1994-12-31,1,2018,2019,12,31,D.R.
Julio Cesar,1975-11-16,11,2000,2011,11,16,D.R.
Ruddy Joraider,1980-05-22,1,2006,2007,5,22,D.R.
Jacob Seth,1989-11-17,3,2016,2019,11,17,USA
Rafael Urbano,1962-08-12,5,1985,1990,8,12,Venezuela
William Ferdinand,1884-04-14,0,1913,1913,4,14,USA
Robert James,1968-07-24,0,1996,1996,7,24,USA
Mark Francis,1973-03-08,1,2001,2002,3,8,USA
Matthew Clifford,1971-02-26,3,1996,1999,2,26,USA
Albert P.,1868-11-15,0,1894,1894,11,15,USA
Edward Paul,1920-08-05,6,1941,1947,8,5,USA
Raphael Anthony,1936-12-21,2,1957,1959,12,21,USA
Harry Garfield,1880-09-29,6,1904,1910,9,29,USA
Michael Ken-Wai,1945-10-27,14,1967,1981,10,27,USA
Jerry Dean,1933-06-02,11,1956,1967,6,2,USA
Hector R.,1980-02-01,8,2004,2012,2,1,D.R.
Guillermo Romero,1930-06-25,0,1954,1954,6,25,Mexico
Fernando Jose,1977-05-25,2,2000,2002,5,25,Venezuela
John Frederick,1877-03-10,0,1902,1902,3,10,USA
Donald Andrew,1923-05-18,9,1945,1954,5,18,USA
Carl Leonard,1880-02-16,7,1902,1909,2,16,USA
Ebin Delmer,1899-09-21,3,1924,1927,9,21,USA
Gordon Thomas,1941-02-23,2,1967,1969,2,23,USA
David Bruce,1973-06-04,3,1999,2002,6,4,USA
Thomas Robert,1949-04-10,2,1973,1975,4,10,USA
James Lewis,1979-05-25,1,2002,2003,5,25,USA
Harry August,1892-09-15,1,1919,1920,9,15,USA
Ulysses John,1917-04-23,8,1940,1948,4,23,USA
Alvin David,1939-03-13,6,1961,1967,3,13,USA
Jordan Thomas,1993-09-26,2,2017,2019,9,26,USA
Adolfo Domingo de Guzman,1890-08-04,21,1914,1935,8,4,Cuba
Scott Edward,1964-09-30,4,1987,1991,9,30,USA
William Lucas,1873-11-10,9,1895,1904,11,10,USA
Ernest Benjamin,1885-11-01,0,1910,1910,11,1,USA
John Charles,1885-10-08,6,1904,1910,10,8,USA
Charles Melton,1876-04-06,0,1901,1901,4,6,USA
Charles William,1864-10-04,0,1894,1894,10,4,USA
Lyle Kenneth,1930-02-22,1,1956,1957,2,22,USA
Donald Thomas,1989-02-06,1,2013,2014,2,6,USA
Rollin Joseph,1925-02-18,0,1951,1951,2,18,USA
Walter John,1897-11-17,4,1923,1927,11,17,USA
Louis William,1898-12-17,0,1922,1922,12,17,USA
Zachary Craig,1986-06-03,1,2012,2013,6,3,USA
Keith H. M.,1974-12-24,0,2000,2000,12,24,USA
Gavin Thomas,1997-11-23,0,2019,2019,11,23,USA
Jesus G.,1997-09-30,0,2019,2019,9,30,Peru
Gregory Michael,1950-11-22,14,1970,1984,11,22,USA
Mitchell Scott,1964-12-14,0,1993,1993,12,14,USA
Donald Scott,1968-10-26,0,1993,1993,10,26,USA
James Charles,1900-07-24,0,1925,1925,7,24,USA
Jordan Horton,1990-10-19,8,2011,2019,10,19,USA
Albert Walter,1944-07-22,15,1967,1982,7,22,USA
Adrian Ryan,1897-02-09,0,1920,1920,2,9,USA
Matthew Daniel,1926-02-07,0,1948,1948,2,7,USA
Edward Francis,1956-02-25,7,1980,1987,2,25,USA
Henry W.,1866-04-08,0,1893,1893,4,8,USA
John H.,1857-02-05,9,1881,1890,2,5,USA
Gerald Thomas,1930-07-17,12,1954,1966,7,17,USA
Michael Joseph,1875-09-10,0,1902,1902,9,10,USA
Michael Joseph,1880-06-28,3,1904,1907,6,28,USA
Thomas James,1860-04-03,1,1884,1885,4,3,USA
Walter Edward,1897-04-15,0,1922,1922,4,15,USA
Byrd,1889-03-13,4,1916,1920,3,13,USA
Fredric Michael,1952-02-03,16,1974,1990,2,3,USA
Jerome Edward,1916-04-14,0,1937,1937,4,14,USA
Michael Lance,1987-05-12,8,2011,2019,5,12,USA
Japhet Monroe,1913-12-27,5,1939,1944,12,27,USA
Brandon James,1979-08-10,12,2001,2013,8,10,USA
Russell Mayo,1913-06-26,0,1944,1944,6,26,USA
Albert Harold,1918-07-18,4,1944,1948,7,18,USA
Barry Stephen,1960-06-03,9,1986,1995,6,3,USA
William Allen,1958-04-26,1,1983,1984,4,26,USA
Curt Russell,1974-10-17,0,1996,1996,10,17,USA
Dennis Patrick Aloysius,1866-03-12,12,1885,1897,3,12,USA
Edward Hoyte,1923-05-12,0,1947,1947,5,12,USA
George Tony,1891-01-25,4,1920,1924,1,25,USA
Harry Pratt,1866-03-25,6,1887,1893,3,25,USA
Herschel Englebert,1915-07-23,0,1941,1941,7,23,USA
Stephen John,1960-06-03,8,1985,1993,6,3,USA
Theodore Amar,1900-12-28,23,1923,1946,12,28,USA
Terry Hilbert,1908-12-14,0,1929,1929,12,14,USA
Thomas Arthur,1869-03-27,0,1890,1890,3,27,USA
Tyler William,1988-02-21,6,2013,2019,2,21,USA
Richard Eugene,1953-02-21,5,1980,1985,2,21,USA
John Michael,1867-05-28,3,1891,1894,5,28,USA
Edward Benson,1862-03-10,0,1890,1890,3,10,USA
James Lawrence,1946-05-20,7,1969,1976,5,20,USA
Duane Frederick,1929-01-31,6,1955,1961,1,31,USA
Kevin Christian,1965-01-20,5,1990,1995,1,20,USA
Robert Lee,1929-10-08,2,1958,1960,10,8,USA
Christopher Eugene,1979-02-11,0,2006,2006,2,11,USA
John Steven,1970-10-17,13,1994,2007,10,17,USA
Malcolm M.,1862-01-19,0,1884,1884,1,19,United Kingdom
Frank Louis,1954-09-21,1,1976,1977,9,21,USA
William Paul,1929-03-28,3,1950,1953,3,28,USA
Robert Joseph,1965-04-27,6,1990,1996,4,27,USA
Harvey Forsyth,1898-05-18,0,1928,1928,5,18,USA
Robert Meiklejohn,1977-03-05,11,2001,2012,3,5,USA
Daniel Knowles,1905-06-10,17,1926,1943,6,10,USA
Michael Andrew,1964-04-12,12,1987,1999,4,12,USA
Edward M.,1878-01-10,0,1905,1905,1,10,USA
Alejandro Jose,1982-04-26,0,2005,2005,4,26,Venezuela
Anderson Javier,1981-01-25,2,2003,2005,1,25,Venezuela
Andres Eduardo,1993-04-22,0,2017,2017,4,22,Venezuela
Dixon Javier,1992-02-22,3,2015,2018,2,22,Venezuela
Julio Segundo,1965-12-01,2,1989,1991,12,1,Venezuela
Kenneth Edward,1950-09-29,7,1974,1981,9,29,USA
Manuel Arturo,1992-07-06,7,2012,2019,7,6,USA
Michael William,1954-02-17,1,1979,1980,2,17,USA
Robert Alexis,1973-06-03,8,1996,2004,6,3,Venezuela
Charles Walter,1946-04-20,0,1971,1971,4,20,USA
David Ritchie,1951-05-24,1,1978,1979,5,24,USA
Jean Manuel,1982-02-01,5,2012,2017,2,1,Venezuela
Andres Apolonio,1983-03-07,2,2007,2009,3,7,USA
Jose Prado,1972-01-25,6,1999,2005,1,25,Panama
Peter,1951-08-01,8,1973,1981,8,1,USA
William Francis,1885-02-12,0,1908,1908,2,12,USA
Cornelius Alexander,1862-12-22,10,1886,1896,12,22,USA
Dennis Joseph,1850-03-14,12,1871,1883,3,14,USA
Earle Thaddeus,1890-02-01,4,1910,1914,2,1,USA
James Raleigh,1897-07-27,NA,NA,NA,7,27,USA
Eric Hugh,1932-08-29,0,1955,1955,8,29,CAN
Henry Gordon,1937-07-09,0,1961,1961,7,9,USA
Kenneth Purvis,1934-03-10,5,1960,1965,3,10,CAN
Frank George,1900-02-02,3,1922,1925,2,2,USA
Felix Thaddeus,1917-11-20,6,1941,1947,11,20,USA
John Joseph,1923-10-29,2,1953,1955,10,29,USA
Joseph John,1912-01-04,0,1945,1945,1,4,USA
Robert William,1976-06-20,7,2001,2008,6,20,USA
Steven Joseph,1954-09-06,1,1979,1980,9,6,USA
Quinn David,1965-09-11,0,1994,1994,9,11,USA
Raymond James,1916-08-31,9,1938,1947,8,31,USA
Joseph,1866-05-02,5,1885,1890,5,2,Ireland
Shane Lee,1963-12-07,11,1987,1998,12,7,USA
Tony Lynn,1961-04-30,0,1985,1985,4,30,USA
Evan Alan,1982-11-04,0,2010,2010,11,4,USA
William Daniel,1942-05-13,0,1962,1962,5,13,USA
Lonnie Lee,1967-02-17,0,1993,1993,2,17,USA
Max Cullen,1915-10-14,9,1938,1947,10,14,USA
Harry William,1926-07-10,0,1944,1944,7,10,USA
Leland Stanford,1890-02-03,NA,NA,NA,2,3,USA
Leland Stanford,1917-10-25,NA,NA,NA,10,25,USA
Walter Scott,1899-12-23,0,1922,1922,12,23,USA
Scott Patrick,1974-08-13,0,2001,2001,8,13,USA
Matthew Michael,1982-05-29,0,2008,2008,5,29,USA
James F.,1855-01-16,7,1879,1886,1,16,USA
Keith,1955-12-30,0,1980,1980,12,30,USA
Thomas Francis,1882-09-14,2,1909,1911,9,14,USA
Clarence James,1921-09-26,5,1946,1951,9,26,USA
Francis A.,1892-10-17,0,1914,1914,10,17,USA
Eugene,1890-06-05,0,1916,1916,6,5,USA
Michael Joseph,1867-10-02,4,1887,1891,10,2,USA
Leonard Joseph,1890-07-02,0,1912,1912,7,2,USA
Michael Anthony,1957-01-13,3,1983,1986,1,13,USA
Morris DeWayne,1960-08-31,2,1987,1989,8,31,USA
Thomas Joseph,1883-07-31,4,1906,1910,7,31,USA
Austin D.,1991-05-13,0,2017,2017,5,13,USA
Elliott,1947-12-21,10,1970,1980,12,21,USA
Garry Lee,1949-09-01,14,1972,1986,9,1,USA
Jerry Glenn,1953-07-28,0,1978,1978,7,28,USA
Joseph John,1954-02-08,NA,NA,NA,2,8,USA
Nicholas,1886-11-09,3,1907,1910,11,9,USA
Gregory Alan,1966-04-14,22,1986,2008,4,14,USA
Michael Ausley,1961-08-27,14,1986,2000,8,27,USA
William J.,1868-07-18,0,1886,1886,7,18,USA
Arthur M.,1871-01-14,4,1895,1899,1,14,USA
David Pledger,1921-02-01,3,1950,1953,2,1,USA
Charles Scott,1959-09-12,4,1985,1989,9,12,USA
Edward William,1908-07-20,5,1932,1937,7,20,USA
Bill,1951-01-12,14,1973,1987,1,12,USA
Alexander,1963-04-18,2,1987,1989,4,18,USA
Robert Allen,1976-02-28,1,2004,2005,2,28,USA
Salvador,1920-06-09,0,1947,1947,6,9,USA
Warner Antonio,1984-03-21,1,2008,2009,3,21,D.R.
Ryan Michael,1980-08-28,15,2003,2018,8,28,USA
Calvin Gregory,1974-09-05,6,1996,2002,9,5,Aruba
Kenta,1988-04-11,3,2016,2019,4,11,Japan
Hector Anibal,1935-04-19,1,1960,1961,4,19,Cuba
David Joseph,1962-09-30,15,1986,2001,9,30,USA
Everardo,1965-11-06,0,1991,1991,11,6,Mexico
William J.,1875-07-06,5,1897,1902,7,6,CAN
Leo Christopher,1889-06-04,8,1911,1919,6,4,USA
Sherwood Robert,1884-08-06,15,1904,1919,8,6,USA
Wendell Errol,1972-08-03,6,1996,2002,8,3,USA
Harl Vestin,1883-02-13,5,1907,1912,2,13,USA
Harl Warren,1914-05-04,0,1938,1938,5,4,USA
Matthew W.,1989-11-10,6,2013,2019,11,10,USA
Salvatore Anthony,1917-04-26,13,1945,1958,4,26,USA
Michael Anthony,1965-06-17,11,1991,2002,6,17,USA
Edmund Burke,1888-02-10,0,1911,1911,2,10,USA
Damien Jack,1991-05-24,1,2016,2017,5,24,USA
James Robert,1946-08-18,3,1970,1973,8,18,USA
Trystan Stewart Gwyn,1985-06-06,0,2011,2011,6,6,CAN
George Henry,1875-03-27,5,1898,1903,3,27,USA
Joseph David,1964-07-02,9,1987,1996,7,2,USA
Thomas Joseph,1963-12-09,0,1989,1989,12,9,USA
Peter Alexander,1942-06-08,0,1966,1966,6,8,USA
Christopher James,1977-04-26,4,2001,2005,4,26,USA
Frederick Edward,1899-05-10,9,1922,1931,5,10,USA
Jack,1925-02-05,1,1950,1951,2,5,USA
James Bernard,1901-04-22,0,1921,1921,4,22,USA
Arthur,1938-06-04,6,1960,1966,6,4,USA
Louis Wood,1874-01-03,0,1898,1898,1,3,USA
Lee Roy,1904-02-09,10,1926,1936,2,9,USA
Arthur Leo,1913-06-08,0,1940,1940,6,8,USA
William Joseph,1881-03-19,4,1912,1916,3,19,USA
Frank Edward,1878-12-04,0,1902,1902,12,4,USA
Kevin Eric,1981-06-08,0,2007,2007,6,8,USA
Ronald Matthew,1971-06-28,15,1995,2010,6,28,USA
Thomas Francis,1875-10-03,0,1902,1902,10,3,USA
Gregory John,1952-08-08,1,1978,1979,8,8,USA
Gregory Norman,1993-04-17,0,2016,2016,4,17,USA
Michael James,1952-07-30,9,1977,1986,7,30,USA
Richard Keith,1953-08-05,12,1979,1991,8,5,USA
Tyler Fermin,1994-09-29,2,2017,2019,9,29,USA
Paul Gurner,1982-06-25,9,2005,2014,6,25,USA
Patrick Lavon,1970-08-09,11,1992,2003,8,9,USA
Alfred Gwinn,1909-09-23,0,1930,1930,9,23,USA
Robert Paul,1928-06-20,1,1951,1952,6,20,USA
Christopher John,1885-06-11,0,1910,1910,6,11,USA
Daniel J.,1864-03-20,3,1892,1895,3,20,USA
Daniel Joseph,1888-09-06,0,1911,1911,9,6,USA
James Thomas,1934-05-26,6,1959,1965,5,26,USA
Joseph Edward,1987-02-01,1,2012,2013,2,1,USA
George W.,1873-12-05,1,1897,1898,12,5,USA
Michael John,1972-12-05,5,2000,2005,12,5,USA
Michael Anthony,1989-11-30,4,2015,2019,11,30,USA
Robert Phillip,1915-09-05,0,1945,1945,9,5,USA
Mitchell William,1982-06-30,6,2006,2012,6,30,USA
Luke Richard,1991-02-06,4,2015,2019,2,6,USA
Emil Pierre,1908-12-16,0,1936,1936,12,16,USA
John Walter,1894-10-01,11,1915,1926,10,1,USA
Miles Grant,1884-05-13,4,1914,1918,5,13,USA
John Kevin,1981-05-08,9,2004,2013,5,8,USA
Scott,1985-02-02,2,2010,2012,2,2,USA
James Royal,1922-06-12,0,1943,1943,6,12,USA
Willard Eben,1868-07-07,8,1888,1896,7,7,USA
Forrest Harry,1922-02-12,5,1948,1953,2,12,USA
Oswaldo Antonio,1975-07-30,2,2000,2002,7,30,Nicaragua
Charles Louis,1894-04-21,0,1915,1915,4,21,USA
Frederick Charles,1889-12-23,5,1913,1918,12,23,USA
George John,1892-03-12,9,1913,1922,3,12,USA
Henry,1916-12-13,16,1939,1955,12,13,USA
Gary Wayne,1980-02-26,6,2004,2010,2,26,USA
Walter Val,1981-06-19,0,2004,2004,6,19,USA
Kazuhisa,1984-11-10,0,2018,2018,11,10,Japan
Frank,1910-01-20,0,1937,1937,1,20,USA
Thomas Anthony,1950-12-22,0,1975,1975,12,22,USA
Michael Bryant,1966-05-28,2,1992,1994,5,28,USA
William John,1878-11-26,0,1908,1908,11,26,USA
John S.,1872-05-04,9,1894,1903,5,4,USA
Dennis Mark,1978-01-17,1,2003,2004,1,17,USA
Jose Francisco,1971-05-31,1,1996,1997,5,31,Venezuela
Charles Francis,1879-06-13,0,1905,1905,6,13,USA
Joseph Charles,1905-10-25,2,1933,1935,10,25,USA
Candido,1960-09-05,14,1981,1995,9,5,P.R.
Carlos Cesar,1966-10-18,3,1990,1993,10,18,Panama
Carlos Luis,1979-01-03,6,2006,2012,1,3,Venezuela
Martin Benjamin,1986-08-16,8,2011,2019,8,16,P.R.
James Michael,1958-08-16,2,1981,1983,8,16,USA
Anthony Francis,1909-10-07,0,1937,1937,10,7,USA
Cyrus Sol,1907-02-26,0,1934,1934,2,26,USA
Robert Edward,1931-07-04,5,1957,1962,7,4,USA
Brian Drew,1975-01-19,0,2002,2002,1,19,USA
Gerald Gordon,1935-09-18,0,1959,1959,9,18,USA
Malcolm Francis,1922-01-30,0,1950,1950,1,30,USA
Robbin Dale,1964-11-16,5,1987,1992,11,16,USA
Archibald Alexander,1886-10-31,0,1910,1910,10,31,USA
Howard Bennett,1894-03-31,0,1921,1921,3,31,USA
Robert Paul,1918-05-28,6,1943,1949,5,28,USA
Robert William,1964-11-24,3,1987,1990,11,24,USA
John Herman,1885-06-01,1,1907,1908,6,1,USA
James Baugh,1918-09-01,5,1940,1945,9,1,USA
Julius Norris,1900-04-04,0,1925,1925,4,4,USA
Leslie Clyde,1905-11-21,4,1931,1935,11,21,USA
Marty Thomas,1972-04-06,4,1998,2002,4,6,USA
Sheldon,1953-07-16,0,1977,1977,7,16,USA
Harry William,1925-07-31,0,1955,1955,7,31,USA
William Alphonse,1878-06-05,7,1901,1908,6,5,USA
Charles Michael,1886-05-22,0,1908,1908,5,22,USA
Charles Ray,1965-07-08,0,1990,1990,7,8,USA
Edward Russell,1920-06-16,1,1949,1950,6,16,USA
James William,1940-06-02,11,1960,1971,6,2,USA
Lewis Aloysius,1897-03-13,4,1915,1919,3,13,USA
Matthew Michael,1984-01-16,3,2009,2012,1,16,USA
Patrick William,1888-01-19,0,1912,1912,1,19,USA
Perce Leigh,1902-09-25,9,1928,1937,9,25,USA
Sean Patrick,1971-05-25,1,1997,1998,5,25,USA
Paul Augustus,1892-06-04,0,1913,1913,6,4,USA
Gordon Ralph,1912-09-04,4,1943,1947,9,4,USA
Frank James,1930-02-28,11,1955,1966,2,28,USA
Albert Leon,1894-05-30,11,1913,1924,5,30,USA
Sean Anthony,1992-02-01,3,2016,2019,2,1,USA
Joseph Anthony,1992-03-18,3,2016,2019,3,18,USA
Frank Octavius,1918-05-23,3,1944,1947,5,23,USA
August Rodney,1905-12-05,17,1928,1945,12,5,USA
Carl Alan,1886-11-16,0,1914,1914,11,16,USA
Harold Carl,1917-06-14,5,1941,1946,6,14,USA
Michael Seth,1988-10-14,4,2013,2017,10,14,USA
James Daniel,1929-09-24,4,1952,1956,9,24,USA
Matthew Steven,1985-12-21,0,2010,2010,12,21,USA
Angel Luis,1947-03-19,7,1969,1976,3,19,P.R.
George Graham,1890-05-22,0,1912,1912,5,22,USA
Leo Allan,1896-05-24,11,1924,1935,5,24,USA
Jose Manuel,1952-05-23,5,1972,1977,5,23,P.R.
Clyde Jennings,1896-10-30,14,1920,1934,10,30,USA
Philip Anthony,1953-01-09,6,1976,1982,1,9,USA
Effa,1897-03-27,NA,NA,NA,3,27,USA
Charles Henry Weeks,1862-10-08,0,1884,1884,10,8,USA
Brandon Michael,1984-05-16,0,2018,2018,5,16,USA
Fred J.,1858-04-01,5,1882,1887,4,1,USA
Ben Garth,1915-11-16,0,1944,1944,11,16,USA
Charles Nelson,1979-03-31,0,2008,2008,3,31,USA
David Anthony,1972-08-14,0,2003,2003,8,14,USA
Ernest Devon,1890-10-09,0,1914,1914,10,9,USA
John E.,1853-12-20,13,1873,1886,12,20,USA
James H.,1862-01-31,5,1884,1889,1,31,USA
James Benjamin,1943-07-21,0,1962,1962,7,21,USA
Richard Eugene,1954-09-02,12,1975,1987,9,2,USA
Walter Sanderson,1883-04-29,3,1907,1910,4,29,USA
Timothy Edward,1853-12-03,3,1882,1885,12,3,United Kingdom
James Joseph,1974-11-17,3,2000,2003,11,17,USA
John Leo,1898-02-04,0,1928,1928,2,4,USA
Kelly John,1967-08-17,1,1989,1990,8,17,USA
Leslie,1892-11-18,15,1913,1928,11,18,USA
Donald D.,1915-05-04,1,1940,1941,5,4,USA
Julio Alberto,1973-06-10,3,2003,2006,6,10,D.R.
Ramon,1968-01-20,0,1990,1990,1,20,D.R.
Fred Eloy,1961-11-05,10,1981,1991,11,5,Venezuela
Michael R.,1858-01-15,5,1879,1884,1,15,USA
Thomas Edward,1855-01-01,5,1879,1884,1,1,USA
Jeffrey Michael,1985-01-16,7,2009,2016,1,16,USA
Louis Hugo,1884-07-04,0,1906,1906,7,4,USA
Matthew Bruce,1973-07-07,10,1995,2005,7,7,USA
Felix,1934-07-29,10,1956,1966,7,29,P.R.
Joseph Newman,1991-03-01,3,2016,2019,3,1,USA
Mickey Charles,1931-10-20,17,1951,1968,10,20,USA
Jeffrey Paul,1964-08-23,10,1990,2000,8,23,USA
Barry Paul,1965-08-12,7,1991,1998,8,12,USA
Charles Fuqua,1944-01-04,6,1969,1975,1,4,USA
Jerry,1953-12-23,7,1975,1982,12,23,USA
Mark Garfield,1881-10-16,3,1905,1908,10,16,USA
Robert Mehmet,1983-07-09,1,2009,2010,7,9,USA
Frank Henry Benjamin,1883-09-18,0,1908,1908,9,18,USA
Henry Emmett,1901-07-20,16,1923,1939,7,20,USA
Richard Wesley,1926-12-25,2,1950,1952,12,25,USA
Kirt Dean,1965-07-15,12,1987,1999,7,15,USA
Josias,1967-10-16,13,1991,2004,10,16,D.R.
Ravelo,1963-10-17,7,1988,1995,10,17,D.R.
Thomas Samuel,1983-04-16,1,2009,2010,4,16,USA
Rolla Hamilton,1890-03-09,0,1919,1919,3,9,USA
Clifford Franklin,1922-03-13,4,1948,1952,3,13,USA
Dillon Sean,1992-05-09,2,2017,2019,5,9,USA
Howard Albert,1903-07-20,0,1932,1932,7,20,USA
George Richard,1865-12-25,1,1885,1886,12,25,USA
Paul Patrick,1965-08-02,0,1990,1990,8,2,United Kingdom
Georges Henri,1932-01-15,2,1960,1962,1,15,CAN
Walter James Vincent,1891-11-11,23,1912,1935,11,11,USA
Frederick,1898-11-30,13,1923,1936,11,30,USA
Walter William,1890-09-13,0,1913,1913,9,13,USA
Philip Joseph,1913-10-25,10,1940,1950,10,25,CAN
John Alfred,1909-09-09,6,1933,1939,9,9,USA
Shaun Michal,1981-12-14,10,2005,2015,12,14,USA
Leo John,1941-02-18,4,1965,1969,2,18,USA
Nicholas,1996-06-18,0,2019,2019,6,18,USA
Joseph Emanuel,1930-01-13,1,1956,1957,1,13,USA
Manuel,1994-09-28,3,2016,2019,9,28,D.R.
Juan Antonio,1937-10-20,15,1960,1975,10,20,D.R.
Sugar Ray,1988-09-30,0,2015,2015,9,30,Colombia
Jhan Carlos,1988-08-12,8,2010,2018,8,12,D.R.
Donald George,1889-07-31,1,1914,1915,7,31,USA
Martin Whiteford,1916-12-01,13,1940,1953,12,1,USA
Michael Ryan,1988-10-20,2,2014,2016,10,20,USA
John Wyeth,1914-03-14,8,1935,1943,3,14,USA
Jacob Shawn,1991-03-30,6,2013,2019,3,30,USA
Roger Eugene,1934-09-10,11,1957,1968,9,10,USA
Michael Gregory,1989-07-20,1,2017,2018,7,20,USA
Nicholas William,1983-11-17,13,2006,2019,11,17,USA
Harry Duquesne,1923-08-17,0,1951,1951,8,17,France
Parker Michael,1990-09-15,0,2019,2019,9,15,USA
Clifford Monroe,1894-05-03,9,1915,1924,5,3,USA
Cleneth Eugene,1919-12-26,0,1950,1950,12,26,USA
Justin Michael,1988-01-12,3,2014,2017,1,12,USA
Matthew Gates,1990-08-25,1,2015,2016,8,25,USA
Richard Burton,1929-06-27,5,1951,1956,6,27,USA
Carlos Agustin,1982-10-14,8,2006,2014,10,14,D.R.
Harry Sylvester,1918-07-06,2,1940,1942,7,6,USA
Fred Daniel,1928-10-06,0,1953,1953,10,6,USA
Louis Stephen,1945-12-03,1,1969,1970,12,3,USA
John Nicholas,1989-09-05,2,2012,2014,9,5,USA
Michael Warren,1977-08-17,5,2002,2007,8,17,USA
Robert Rudolph,1924-12-23,0,1953,1953,12,23,USA
German Andres,1995-02-22,3,2016,2019,2,22,Venezuela
Gonzalo Enrique,1940-03-31,2,1972,1974,3,31,Venezuela
Isidro,1965-05-14,0,1995,1995,5,14,Mexico
Jason Scott,1978-08-21,15,2000,2015,8,21,USA
Jeffrey Joseph,1984-08-10,1,2010,2011,8,10,USA
James Milburn,1900-11-18,0,1925,1925,11,18,USA
Luis Angel,1925-10-28,3,1951,1954,10,28,P.R.
Albert Ludwig,1902-09-22,0,1931,1931,9,22,USA
Roger Julian,1937-04-05,0,1955,1955,4,5,USA
Richard William,1886-10-09,17,1908,1925,10,9,USA
Christopher,1988-07-02,6,2011,2017,7,2,USA
Conrado Eugenio,1911-04-25,4,1950,1954,4,25,Cuba
Deven Sommer,1990-08-25,4,2015,2019,8,25,USA
Elieser,1973-11-17,9,1997,2006,11,17,Cuba
Oreste Vilato,1969-10-31,3,1993,1996,10,31,P.R.
William Earl,1893-08-18,10,1917,1927,8,18,USA
Charles W.,1862-09-19,5,1886,1891,9,19,USA
Charles Kennon,1909-08-29,6,1932,1938,8,29,USA
Armando,1887-10-03,7,1911,1918,10,3,Cuba
Edward M.,1867-12-04,0,1890,1890,12,4,USA
William Henry,1911-02-14,3,1931,1934,2,14,USA
Brett Edward,1990-03-22,0,2013,2013,3,22,USA
Charles Anthony,1919-08-28,0,1941,1941,8,28,USA
Clarence Westly,1925-04-28,4,1946,1950,4,28,USA
David Lewis,1943-01-14,6,1967,1973,1,14,USA
William Riddle,1875-09-22,5,1904,1909,9,22,USA
Edward Harbert,1906-06-04,3,1929,1932,6,4,USA
Evan Patrick,1990-04-18,5,2014,2019,4,18,USA
Fred Francis,1924-01-05,7,1949,1956,1,5,USA
Jay William,1983-02-25,2,2007,2009,2,25,USA
Rufus James,1931-05-25,4,1958,1962,5,25,USA
Joseph Hanley,1876-02-19,3,1903,1906,2,19,USA
Keith Alan,1951-07-02,0,1973,1973,7,2,USA
Milo May,1913-09-18,2,1942,1944,9,18,USA
Michael Grant,1943-01-15,14,1967,1981,1,15,USA
Michael Allen,1960-01-12,10,1981,1991,1,12,USA
Roy DeVerne,1890-07-19,3,1912,1915,7,19,USA
Sean Christopher,1982-08-30,8,2006,2014,8,30,USA
Thomas Owen,1965-12-27,3,1992,1995,12,27,USA
Willard Warren,1921-02-08,13,1942,1955,2,8,USA
Louis Glenn,1986-06-26,5,2008,2013,6,26,USA
Samuel R.,1978-07-10,0,2004,2004,7,10,USA
Alfredo,1989-03-31,2,2013,2015,3,31,D.R.
Andy Manuel,1983-10-21,9,2005,2014,10,21,D.R.
Damaso,1975-02-14,11,1999,2010,2,14,D.R.
Leon Alphonsus,1883-06-29,1,1909,1910,6,29,USA
Francis Euclides,1995-11-24,0,2017,2017,11,24,D.R.
Jefry Leonal,1991-06-21,3,2015,2018,6,21,D.R.
Ketel Ricardo,1993-10-12,4,2015,2019,10,12,D.R.
Kelvin,1987-11-24,0,2016,2016,11,24,D.R.
Luis Alfredo,1986-08-26,1,2011,2012,8,26,D.R.
Starling Javier,1988-10-09,7,2012,2019,10,9,D.R.
Victor Manuel,1980-11-08,4,2009,2013,11,8,D.R.
Alfred Dean,1847-09-26,3,1872,1875,9,26,USA
Alfredo,1957-03-15,1,1980,1981,3,15,USA
Albert Lee,1967-11-24,11,1992,2003,11,24,USA
Anastacio Euclides,1978-11-03,0,2004,2004,11,3,D.R.
Boris Michael,1920-03-28,9,1944,1953,3,28,USA
Barnes Robertson,1923-03-03,0,1953,1953,3,3,USA
William Gloyd,1894-02-13,0,1914,1914,2,13,USA
Alfred Manuel,1928-05-16,11,1950,1961,5,16,USA
Brett Ryan,1995-04-28,0,2019,2019,4,28,USA
John Albert,1948-11-07,17,1969,1986,11,7,USA
Carmelo,1960-07-28,8,1983,1991,7,28,P.R.
Carlos Alberto Escobar,1965-08-11,7,1988,1995,8,11,Venezuela
Carlos M.,1982-05-26,3,2006,2009,5,26,D.R.
Carlos Ernesto,1991-09-21,6,2013,2019,9,21,D.R.
Reyenaldo Ignacio,1965-12-19,2,1991,1993,12,19,Belize
Christopher Riley,1986-06-02,5,2014,2019,6,2,USA
Cody Matthew,1989-09-04,2,2015,2017,9,4,USA
Corbin Montgomery,1995-12-28,0,2019,2019,12,28,USA
Cristhian A.,1982-03-06,4,2009,2013,3,6,D.R.
David,1964-09-26,15,1986,2001,9,26,USA
David Jose,1987-08-04,1,2013,2014,8,4,Venezuela
Jose Dennis,1954-05-14,22,1976,1998,5,14,Nicaragua
Harold Winthrop,1887-09-23,4,1908,1912,9,23,USA
Domingo Emilio,1965-08-04,1,1992,1993,8,4,D.R.
Edgar,1963-01-02,17,1987,2004,1,2,USA
Ethan Cash,1989-06-06,1,2013,2014,6,6,USA
Felix,1974-05-18,4,1997,2001,5,18,D.R.
Jesus Fernando,1988-10-10,4,2009,2013,10,10,D.R.
Frank Joseph,1878-07-29,2,1897,1899,7,29,USA
Fred Turner,1915-06-27,4,1946,1950,6,27,USA
Thomas Eugene,1947-01-12,0,1968,1968,1,12,USA
Gregory Alfred,1972-01-27,0,1998,1998,1,27,USA
Hershel Ray,1909-09-19,8,1937,1945,9,19,USA
Rodolfo Hector,1939-05-11,1,1962,1963,5,11,Cuba
John Christopher,1887-04-19,2,1912,1914,4,19,USA
Javier Antonio,1977-02-05,0,1998,1998,2,5,P.R.
Jason,1995-09-05,0,2019,2019,9,5,USA
Joseph Clifton,1936-12-13,13,1959,1972,12,13,USA
John Dale,1983-01-02,1,2009,2010,1,2,USA
Julio Daniel,1987-08-21,8,2011,2019,8,21,USA
Jerry Lindsey,1949-05-11,10,1974,1984,5,11,USA
Joseph Samuel,1876-01-01,0,1903,1903,1,1,USA
John Joseph,1889-07-08,0,1924,1924,7,8,USA
William Joseph,1911-07-28,2,1936,1938,7,28,USA
Jose,1942-07-26,1,1969,1970,7,26,Cuba
John Robert,1956-04-11,3,1980,1983,4,11,USA
Jose Miguel,1971-04-01,0,1994,1994,4,1,D.R.
Joseph A.,1983-02-26,4,2009,2013,2,26,USA
Jose Alberto,1988-07-25,3,2016,2019,7,25,Venezuela
Kyle Jared,1991-01-18,0,2017,2017,1,18,USA
Leonys,1988-03-06,8,2011,2019,3,6,Cuba
Luis,1980-01-20,0,2003,2003,1,20,D.R.
Luis M.,1985-04-03,1,2011,2012,4,3,USA
Orlando,1941-08-23,10,1962,1972,8,23,Cuba
Manuel,1970-10-03,3,1996,1999,10,3,D.R.
Joseph Michael,1958-12-03,0,1986,1986,12,3,USA
Michael Gabriel,1982-09-16,6,2011,2017,9,16,D.R.
Morris Webster,1922-09-03,10,1949,1959,9,3,USA
Nicholas Andres,1990-08-05,3,2014,2017,8,5,USA
Nicholas Scott,1990-06-27,1,2018,2019,6,27,USA
Norberto Enrique,1966-12-10,6,1993,1999,12,10,D.R.
Osvaldo,1988-05-07,1,2010,2011,5,7,P.R.
Patrick Francis,1894-04-13,1,1919,1920,4,13,USA
Paul Charles,1932-03-09,0,1955,1955,3,9,USA
Pablo Made,1969-06-29,0,1996,1996,6,29,D.R.
Johnny Leonard Roosevelt,1904-02-29,16,1928,1944,2,29,USA
Pedro Jaime,1971-10-25,17,1992,2009,10,25,D.R.
Pedro,1968-11-29,4,1993,1997,11,29,D.R.
Alphonse Case,1845-08-04,1,1872,1873,8,4,USA
Raymond Joseph,1925-03-13,5,1943,1948,3,13,USA
Ramon Jaime,1968-03-22,13,1988,2001,3,22,D.R.
Ramon E.,1972-10-10,11,1998,2009,10,10,USA
Rafael,1984-05-16,1,2015,2016,5,16,USA
Donald Renie,1955-08-30,5,1979,1984,8,30,USA
Richard Allen,1994-12-22,0,2019,2019,12,22,USA
Rogelio Bautista,1918-11-05,0,1950,1950,11,5,Cuba
Russell Nathan Coltrane,1983-02-15,13,2006,2019,2,15,CAN
Angel Sandy,1970-10-08,9,1995,2004,10,8,D.R.
Shairon Martis,1987-03-30,5,2008,2013,3,30,Curacao
Silvio Ramon,1955-08-19,4,1977,1981,8,19,D.R.
Elwood Good,1893-09-15,5,1917,1922,9,15,USA
Stuart McGuire,1912-11-19,7,1936,1943,11,19,USA
Teodoro Noel,1947-12-10,9,1970,1979,12,10,D.R.
Felix Anthony,1950-05-31,14,1974,1988,5,31,USA
Constantino,1967-12-07,15,1990,2005,12,7,USA
Gabriel Antonio,1940-03-18,3,1963,1966,3,18,Cuba
Thomas Edgar,1970-05-21,10,1997,2007,5,21,USA
Victor Jesus,1978-12-23,16,2002,2018,12,23,Venezuela
Guido Joe,1913-07-01,0,1935,1935,7,1,USA
William Jose,1978-01-04,0,2000,2000,1,4,Venezuela
Robert Gordon,1930-08-15,2,1957,1959,8,15,USA
Joseph Anton,1913-09-01,4,1937,1941,9,1,USA
Gary Arthur,1951-01-10,0,1975,1975,1,10,USA
Randy Carl,1956-05-28,3,1980,1983,5,28,USA
James Michael,1993-09-17,0,2019,2019,9,17,USA
John Robert,1963-02-14,11,1987,1998,2,14,USA
Onan Kainoa Satoshi,1977-10-27,1,1999,2000,10,27,USA
Clyde Wayne,1945-05-29,4,1969,1973,5,29,USA
Damon Wayne,1969-10-31,2,1996,1998,10,31,P.R.
Philip Samuel,1916-01-06,13,1939,1952,1,6,USA
Harry H.,1861-12-21,0,1882,1882,12,21,USA
Samuel Leech,1854-02-11,4,1882,1886,2,11,USA
Charles E.,1853-06-25,8,1875,1883,6,25,USA
Adelbert William,1883-10-29,3,1904,1907,10,29,USA
Donald Stetson,1944-12-20,7,1966,1973,12,20,USA
Henry,1931-06-19,2,1958,1960,6,19,USA
James Percy,1950-08-14,8,1971,1979,8,14,USA
Michael Paul,1958-11-21,6,1982,1988,11,21,USA
Roger Leroy,1957-09-18,10,1984,1994,9,18,USA
Gordon Richard,1935-09-02,1,1957,1958,9,2,USA
William Henry,1870-09-23,0,1894,1894,9,23,USA
William Herbert,1893-09-28,0,1917,1917,9,28,USA
Nicholas Allen,1982-05-17,9,2006,2015,5,17,USA
Roy Hardee,1890-10-09,0,1918,1918,10,9,USA
Dan Patrick,1968-03-17,0,1995,1995,3,17,USA
Justin Daniel,1985-03-22,7,2008,2015,3,22,Jamaica
Paul Nicholas,1915-10-16,2,1940,1942,10,16,USA
Walter Thomas,1907-03-28,8,1931,1939,3,28,USA
Walter Edward,1920-06-22,17,1939,1956,6,22,USA
Thomas Raymond,1981-02-04,2,2006,2008,2,4,Indonesia
Darin Paul,1985-08-26,5,2011,2016,8,26,USA
Frank Jesus,1984-03-11,0,2010,2010,3,11,Venezuela
Leonard,1928-09-12,0,1952,1952,9,12,USA
Victor Jose,1961-06-17,1,1984,1985,6,17,D.R.
John Thomas,1943-09-07,5,1967,1972,9,7,USA
Henry Antonio,1976-10-14,5,2001,2006,10,14,D.R.
Julio Cesar,1977-08-02,5,2002,2007,8,2,D.R.
Juan Manuel,1982-12-17,0,2006,2006,12,17,D.R.
Marcos Aurelio,1984-04-18,5,2010,2015,4,18,D.R.
Ruben Amaury,1978-02-10,5,1999,2004,2,10,D.R.
Robert T.,1851-11-21,16,1871,1887,11,21,USA
Christopher,1880-08-12,16,1900,1916,8,12,USA
Edwin Lee,1931-10-13,16,1952,1968,10,13,USA
Gregory Inman,1962-05-17,6,1986,1992,5,17,USA
Henry,1886-12-24,1,1906,1907,12,24,USA
Joseph John,1891-07-28,4,1912,1916,7,28,USA
Joseph Paul,1982-07-23,4,2008,2012,7,23,USA
Michael Scott,1970-09-22,12,1994,2006,9,22,USA
Nelson Elmer,1941-07-21,5,1960,1965,7,21,USA
Terry Alan,1964-10-05,8,1991,1999,10,5,USA
Timothy Jay,1970-01-09,7,1995,2002,1,9,USA
Carl Lynwood,1936-06-13,1,1960,1961,6,13,USA
Douglas Alan,1983-06-07,2,2008,2010,6,7,USA
Jeffrey Stephen,1983-03-31,14,2005,2019,3,31,USA
James Michael Ignatius,1878-11-11,0,1902,1902,11,11,USA
Ronald Vance,1958-09-25,2,1985,1987,9,25,USA
Scott William,1984-02-27,5,2006,2011,2,27,CAN
John Roy,1944-08-15,0,1970,1970,8,15,USA
Jonathan Trumpbour,1950-01-19,12,1971,1983,1,19,USA
Phillip Louis,1993-03-25,2,2017,2019,3,25,USA
Francisco Aguirre,1969-07-23,0,1994,1994,7,23,D.R.
Julius,1974-12-12,1,2002,2003,12,12,USA
Luis David,1978-10-30,6,2000,2006,10,30,P.R.
Osiris G.,1984-08-06,1,2008,2009,8,6,D.R.
Pascual,1974-12-23,0,1999,1999,12,23,D.R.
David Michael,1977-01-08,2,2003,2005,1,8,USA
Daisuke,1980-09-13,7,2007,2014,9,13,Japan
Hideki,1974-06-12,9,2003,2012,6,12,Japan
Kazuo,1975-10-23,6,2004,2010,10,23,Japan
Alonzo Albert,1883-06-16,4,1908,1912,6,16,USA
Clifford Virgil,1861-11-24,0,1884,1884,11,24,USA
Henry Edson,1884-09-07,4,1914,1918,9,7,USA
Troy Walter,1975-08-26,0,2001,2001,8,26,USA
Charles Frederick,1863-03-11,0,1891,1891,3,11,USA
Dale Wesley,1923-05-15,1,1943,1944,5,15,USA
Gary Nathaniel,1950-07-05,15,1972,1987,7,5,USA
Gary Nathaniel,1974-08-25,11,1999,2010,8,25,USA
John Joseph,1898-09-29,0,1922,1922,9,29,USA
Michael Scott,1973-10-24,5,2000,2005,10,24,USA
Ryan Arthur,1983-11-10,4,2011,2015,11,10,USA
William Calvin,1877-01-05,0,1909,1909,1,5,USA
Wid Curry,1896-10-20,2,1923,1925,10,20,USA
Robert James,1915-12-05,4,1938,1942,12,5,USA
Donald Arthur,1961-04-20,13,1982,1995,4,20,USA
Laurence Earl,1904-11-04,0,1931,1931,11,4,USA
Kevin Robert,1985-09-20,0,2012,2012,9,20,USA
Ralph,1890-08-24,0,1914,1914,8,24,USA
Walter Joseph,1887-03-12,6,1912,1918,3,12,USA
Cloy Mitchell,1902-11-24,0,1929,1929,11,24,USA
James Powell,1896-12-17,1,1922,1923,12,17,USA
Richard Carlton,1953-11-22,2,1979,1981,11,22,USA
Brian Robert,1987-02-11,7,2009,2016,2,11,USA
Leonard James,1954-09-27,6,1981,1987,9,27,USA
Harry George,1910-01-27,2,1934,1936,1,27,USA
Tyler Alexander,1990-10-19,1,2014,2015,10,19,USA
Steven Jakob,1991-05-29,4,2015,2019,5,29,USA
Gene William,1925-11-18,13,1944,1957,11,18,USA
Alfred Maris,1869-03-06,0,1893,1893,3,6,USA
Joseph Patrick,1983-04-19,14,2004,2018,4,19,USA
Albert Joseph,1865-10-09,17,1884,1901,10,9,USA
Marshall Reese,1914-11-05,0,1934,1934,11,5,USA
Richard,1920-01-26,2,1945,1947,1,26,USA
Ernest Gerald,1901-02-03,2,1924,1926,2,3,USA
Harry Carr,1872-07-11,1,1898,1899,7,11,USA
Brandon Eugene,1990-07-03,5,2013,2018,7,3,USA
David Charles,1975-02-23,4,2000,2004,2,23,USA
Robert John,1967-01-07,1,1991,1992,1,7,USA
Ralph,1934-08-25,0,1958,1958,8,25,USA
Carmen Louis,1926-11-10,5,1948,1953,11,10,USA
Timothy Edward,1966-10-04,4,1991,1995,10,4,USA
Robert Henry,1918-04-08,0,1949,1949,4,8,USA
David Brian,1971-05-04,1,1995,1996,5,4,USA
Larry Hans,1940-10-10,0,1969,1969,10,10,USA
Charles Dallan,1939-02-18,13,1962,1975,2,18,USA
James Albert,1886-10-17,8,1906,1914,10,17,USA
Bruce Tyrone,1990-12-20,2,2016,2018,12,20,Germany
Charles Richard,1927-04-08,14,1950,1964,4,8,USA
Jason Ramond,1972-03-26,3,1998,2001,3,26,USA
Justin Adam,1983-11-06,8,2007,2015,11,6,USA
Yunesky,1981-08-28,3,2010,2013,8,28,Cuba
John Claiborn,1949-02-18,14,1968,1982,2,18,USA
John Claiborn,1983-12-21,6,2009,2015,12,21,USA
Cameron Keith,1987-04-04,12,2007,2019,4,4,USA
William Herbert,1899-12-13,0,1924,1924,12,13,USA
Carlos,1948-05-17,9,1968,1977,5,17,USA
David LaFrance,1943-12-23,11,1967,1978,12,23,USA
Darrell Kevin,1972-06-13,10,1995,2005,6,13,USA
Derrick Brant,1968-07-14,9,1990,1999,7,14,USA
Dustin Jake,1997-09-06,0,2019,2019,9,6,USA
Arthur Lee,1934-12-11,12,1959,1971,12,11,USA
Edward H.,1865-08-16,1,1890,1891,8,16,USA
Edwin David,1931-11-30,1,1957,1958,11,30,USA
Jacob Erskine,1890-01-16,7,1912,1919,1,16,USA
Michael Christopher,1991-12-06,3,2016,2019,12,6,USA
Samuel Frankel,1893-02-28,0,1915,1915,2,28,USA
Walter A.,1890-07-08,8,1911,1919,7,8,USA
Adair Bushyhead,1885-03-17,0,1911,1911,3,17,USA
David Jack,1990-09-30,0,2019,2019,9,30,USA
Frank Spruiell,1895-11-25,15,1917,1932,11,25,USA
Jacob Alexander,1992-01-23,0,2017,2017,1,23,USA
Jerry Lee,1943-12-14,9,1964,1973,12,14,USA
Lee Andrew,1943-03-23,17,1965,1982,3,23,USA
Lucas James,1984-10-24,0,2010,2010,10,24,USA
Milton Scott,1950-08-01,14,1970,1984,8,1,USA
James Walter,1913-03-25,6,1940,1946,3,25,USA
Leroy Evans,1896-11-02,0,1922,1922,11,2,USA
Brent Danem,1968-04-19,14,1990,2004,4,19,USA
Edward Joseph,1910-04-15,12,1936,1948,4,15,USA
John Lewis,1925-07-26,5,1948,1953,7,26,USA
Merrill Glend,1911-01-18,4,1939,1943,1,18,USA
Rudolph,1944-07-18,18,1965,1983,7,18,USA
Albert C.,1865-05-17,5,1885,1890,5,17,USA
Scott Francis,1961-11-11,3,1988,1991,11,11,USA
Carl William,1891-11-12,14,1915,1929,11,12,USA
Matthew Samuel,1967-01-08,1,1992,1993,1,8,CAN
Joseph Emerson,1975-12-10,7,1999,2006,12,10,USA
Edwin,1981-10-17,4,2008,2012,10,17,P.R.
Willie Howard,1931-05-06,22,1951,1973,5,6,USA
Trevor J.,1989-09-23,5,2014,2019,9,23,USA
Timothy Gerard,1992-01-15,2,2017,2019,1,15,USA
Luis Alberto,1980-06-22,0,2008,2008,6,22,Venezuela
Nomar Shamir,1995-04-26,3,2016,2019,4,26,D.R.
William Stanley,1936-09-05,16,1956,1972,9,5,USA
Chris James,1989-10-17,0,2019,2019,10,17,USA
Vincent Michael,1986-09-27,7,2009,2016,9,27,USA
Melvin Leonard,1914-01-31,5,1935,1940,1,31,USA
Lee Louis,1955-03-25,13,1976,1989,3,25,USA
Cory Mitchell,1989-10-19,3,2015,2018,10,19,USA
George Decalve,1886-12-17,0,1911,1911,12,17,USA
William Fort,1907-09-07,4,1930,1934,9,7,USA
John James,1878-08-22,8,1901,1909,8,22,USA
James Robert,1864-07-10,18,1889,1907,7,10,USA
William Lusk,1888-12-29,0,1913,1913,12,29,USA
Lewis William,1874-07-23,7,1896,1903,7,23,USA
Zachary Taylor,1987-12-08,7,2011,2018,12,8,USA
Ernest Lee,1946-08-15,3,1971,1974,8,15,USA
James,1936-09-04,4,1958,1962,9,4,USA
James Brian,1967-09-02,2,1995,1997,9,2,USA
James Clement,1944-01-11,6,1968,1974,1,11,USA
Paul Michael,1981-02-24,5,2005,2010,2,24,USA
Oland Alexander,1892-02-01,0,1914,1914,2,1,USA
Richard John,1939-11-29,15,1960,1975,11,29,USA
Eugene Leo,1872-02-28,0,1904,1904,2,28,USA
James Earl,1891-08-19,11,1914,1925,8,19,USA
George Robert,1884-03-12,0,1914,1914,3,12,USA
Thomas John,1936-08-12,0,1959,1959,8,12,USA
James Eugene,1894-10-20,6,1913,1919,10,20,USA
Alvin O'Neal,1938-05-15,9,1961,1970,5,15,V.I.
Pryor Edward,1901-06-20,0,1926,1926,6,20,USA
Marcus Andre,1980-08-23,0,2007,2007,8,23,USA
Algernon Griggs,1869-05-23,5,1896,1901,5,23,USA
Arnold Ray,1949-02-03,10,1973,1983,2,3,USA
John Dickson,1847-06-14,5,1871,1876,6,14,USA
George Florian,1880-11-20,19,1901,1920,11,20,USA
Kenneth Faye,1935-08-12,6,1959,1965,8,12,USA
Joseph Macay,1982-10-24,2,2005,2007,10,24,USA
Matthew Hagerty,1985-05-23,4,2012,2016,5,23,USA
Peter William,1875-07-09,1,1898,1899,7,9,USA
Thomas Raymond,1914-11-02,5,1943,1948,11,2,USA
Ryan P.,1992-04-09,0,2019,2019,4,9,USA
William Francis,1892-10-28,2,1918,1920,10,28,USA
Richard James,1896-02-21,4,1918,1922,2,21,USA
Joseph Robert,1938-08-27,1,1964,1965,8,27,USA
Ralph Herbert,1918-10-21,0,1946,1946,10,21,CAN
James Arthur,1881-11-20,1,1909,1910,11,20,USA
Timothy J.,1894-10-19,3,1915,1918,10,19,USA
William T.,1862-04-01,0,1885,1885,4,1,USA
Harry Charles,1858-11-25,1,1882,1883,11,25,USA
William Glenn,1921-06-07,3,1946,1949,6,7,USA
Brian Allen,1943-01-25,1,1962,1963,1,25,USA
Robert Leonard,1920-12-27,0,1948,1948,12,27,USA
John,1879-01-19,NA,NA,NA,1,19,USA
Larry Stephen,1952-09-08,2,1977,1979,9,8,USA
John William,1925-07-18,9,1948,1957,7,18,USA
Larry Randall,1962-07-29,1,1989,1990,7,29,USA
Brian Michael,1984-02-20,14,2005,2019,2,20,USA
Emmet,1902-03-04,6,1920,1926,3,4,USA
Henry Eugene,1875-06-13,1,1901,1902,6,13,USA
Scott Cook,1891-05-05,1,1914,1915,5,5,USA
James Thomas,1990-06-13,5,2014,2019,6,13,USA
Alexander George,1889-05-12,7,1910,1917,5,12,USA
Archibald Joseph,1881-01-21,0,1902,1902,1,21,USA
William John,1886-02-14,2,1905,1907,2,14,USA
William Thomas,1882-04-11,0,1906,1906,4,11,USA
William Joseph,1895-11-04,0,1923,1923,11,4,USA
Brandon Patrick,1983-07-07,13,2005,2018,7,7,USA
David Andrew,1969-11-23,12,1993,2005,11,23,USA
Francis,1854-10-06,0,1872,1872,10,6,USA
Gregory O'Neil,1968-10-30,2,1996,1998,10,30,USA
John Arthur,1869-03-26,14,1893,1907,3,26,USA
Jerome Francis,1923-05-23,0,1948,1948,5,23,USA
John Andrew,1867-02-09,0,1889,1889,2,9,USA
Joseph Nicodemus,1881-12-25,1,1905,1906,12,25,USA
John Joseph,1910-01-07,14,1934,1948,1,7,USA
Joseph Vincent,1887-04-21,NA,NA,NA,4,21,USA
Kevin Edward,1992-02-22,3,2016,2019,2,22,USA
George Lewis,1888-11-17,8,1913,1921,11,17,USA
Roger Morton,1932-08-29,0,1959,1959,8,29,USA
James Timothy,1941-10-16,21,1959,1980,10,16,USA
Thomas Francis Michael,1863-07-24,12,1884,1896,7,24,USA
Thomas Patrick,1884-05-22,1,1908,1909,5,22,USA
Thomas Michael,1961-06-18,4,1985,1989,6,18,Germany
Kirk Edward,1961-04-09,11,1985,1996,4,9,CAN
Steven Earl,1954-03-20,8,1977,1985,3,20,USA
Allen A.,1863-03-04,7,1884,1891,3,4,USA
William Henry,1869-12-20,0,1895,1895,12,20,USA
James Adelbert,1863-03-24,2,1884,1886,3,24,USA
Patrick F.,1870-06-10,10,1893,1903,6,10,USA
Harry Vincent,1880-06-01,0,1904,1904,6,1,USA
Joseph Fred,1933-05-05,1,1961,1962,5,5,USA
Robert Hugh,1906-10-24,0,1931,1931,10,24,USA
Reginald Kristen,1992-11-16,0,2019,2019,11,16,USA
Scott Michael,1972-05-19,10,1998,2008,5,19,USA
William Henry,1856-03-22,10,1878,1888,3,22,USA
Hervey McDowell,1894-12-22,5,1919,1924,12,22,USA
Jefferson Lamar,1891-11-06,0,1913,1913,11,6,USA
Kyle William,1984-06-12,5,2008,2013,6,12,USA
Lloyd Glenn,1959-01-11,7,1987,1994,1,11,USA
Michael Melton,1985-04-03,2,2010,2012,4,3,USA
Paul William,1966-02-03,1,1990,1991,2,3,USA
Zachary Daniel,1978-11-25,0,2007,2007,11,25,USA
James Ellwood,1910-05-26,0,1936,1936,5,26,USA
James John,1882-08-25,1,1906,1907,8,25,USA
John James,1862-04-04,NA,NA,NA,4,4,USA
Robert Craig,1952-04-29,18,1975,1993,4,29,USA
Harold Murray,1859-08-08,0,1882,1882,8,8,USA
Harry Robert,1892-03-29,0,1915,1915,3,29,USA
Lawrence Ledwith,1884-10-08,0,1910,1910,10,8,USA
Michael Seth,1981-02-07,6,2003,2009,2,7,USA
Alexander Boyd,1894-03-29,1,1933,1934,3,29,USA
Ambrose Moses,1883-04-29,3,1908,1911,4,29,USA
George Neely,1877-09-16,7,1909,1916,9,16,USA
Ralph Jennison,1889-08-05,0,1914,1914,8,5,USA
Samuel Faulkner,1895-06-08,0,1915,1915,6,8,USA
John Samuel,1975-12-31,0,2004,2004,12,31,USA
William John,1944-07-14,6,1964,1970,7,14,USA
William Joseph,1874-12-25,9,1895,1904,12,25,USA
William Charles,1887-07-09,0,1909,1909,7,9,USA
Donald Ross,1955-09-18,1,1980,1981,9,18,USA
Frank Andrew,1911-06-09,14,1934,1948,6,9,USA
Patrick Henry,1855-10-25,4,1879,1883,10,25,USA
James J.,1861-12-31,1,1883,1884,12,31,USA
James,1856-11-03,9,1878,1887,11,3,United Kingdom
James Ambrose,1868-11-02,0,1892,1892,11,2,USA
Michael Joseph,1882-10-22,0,1904,1904,10,22,USA
Myron Winthrop,1917-05-06,11,1940,1951,5,6,USA
Michael Francis,1938-09-29,15,1956,1971,9,29,USA
Harry Elwood,1881-02-28,9,1904,1913,2,28,USA
William Barney,1917-04-11,14,1939,1953,4,11,USA
Willie Lee,1938-01-10,21,1959,1980,1,10,USA
Arthur Gray,1864-07-15,0,1889,1889,7,15,USA
Benjamin Jenison,1915-11-09,3,1938,1941,11,9,USA
Michael Howard,1981-04-02,3,2009,2012,4,2,USA
Patrick James,1988-08-03,0,2014,2014,8,3,USA
Lester William,1914-11-04,11,1939,1950,11,4,USA
Quinton Antoine,1970-08-16,11,1995,2006,8,16,USA
Rodney Duncan,1963-09-13,2,1990,1992,9,13,USA
Tommy Lee,1940-11-21,12,1963,1975,11,21,USA
Adam Glenn,1992-12-31,0,2018,2018,12,31,USA
Esley Porterfield,1889-12-24,0,1914,1914,12,24,USA
Francis William,1896-09-06,0,1925,1925,9,6,USA
Thomas Livingston,1874-10-19,8,1895,1903,10,19,USA
Walter Henry,1876-11-09,0,1903,1903,11,9,USA
Robert Glenn,1982-05-03,1,2008,2009,5,3,USA
Frank Aloysius,1898-10-04,0,1922,1922,10,4,USA
Clyde Edward,1917-03-04,16,1940,1956,3,4,USA
Lance Graye,1964-03-08,7,1985,1992,3,8,USA
Lance Graye,1993-10-02,3,2015,2018,10,2,USA
Paul Willard,1898-07-28,0,1929,1929,7,28,USA
Pinson Lamar,1917-07-22,0,1942,1942,7,22,USA
Harry Henry,1899-09-15,12,1922,1934,9,15,USA
Jeffrey Dee,1970-01-21,4,1995,1999,1,21,Japan
Andrew Stefan,1986-10-10,10,2009,2019,10,10,USA
Daniel Thomas,1982-09-26,5,2009,2014,9,26,USA
Lyndall Dale,1935-12-13,20,1955,1975,12,13,USA
Terrence Keith,1966-12-06,0,1991,1991,12,6,USA
Max Von,1939-04-18,1,1957,1958,4,18,USA
Ray Darnell,1971-07-20,1,1994,1995,7,20,USA
Michael H.,1864-05-06,0,1889,1889,5,6,USA
Michael Joseph,1874-09-07,2,1895,1897,9,7,USA
Maurice Joseph,1929-04-29,13,1948,1961,4,29,USA
Frank Aloyious,1888-11-12,0,1912,1912,11,12,USA
Thomas Nathaniel,1856-03-15,0,1885,1885,3,15,USA
Terrance Michael,1951-03-20,0,1972,1972,3,20,USA
Daniel Eugene,1932-11-18,5,1957,1962,11,18,USA
Allen Gabriel,1971-08-23,4,1997,2001,8,23,USA
Larry Benard,1967-11-24,8,1989,1997,11,24,USA
David Bruce,1943-05-20,2,1969,1971,5,20,USA
Darnell Tyrone,1978-11-17,9,2004,2013,11,17,USA
Donzell,1975-02-20,1,2001,2002,2,20,USA
Edward Sebastian,1886-09-11,1,1909,1910,9,11,USA
Edward Cyril,1886-10-28,2,1911,1913,10,28,USA
Henry Monroe,1911-01-16,2,1931,1933,1,16,USA
Jason Adam,1972-03-20,3,1997,2000,3,20,USA
James Zell,1984-10-19,5,2008,2013,10,19,USA
James Augustus,1860-08-06,1,1884,1885,8,6,USA
Malcolm,1872-01-01,0,1902,1902,1,1,USA
James William,1922-08-15,2,1943,1945,8,15,USA
Jimmie LeRoy,1927-05-17,8,1950,1958,5,17,USA
John Joseph,1883-01-27,0,1907,1907,1,27,USA
Malcolm Joseph,1888-04-09,0,1910,1910,4,9,USA
John Joseph,1974-09-24,15,1999,2014,9,24,USA
William Keith,1973-02-08,1,2000,2001,2,8,Japan
Charles C.,1891-01-31,3,1912,1915,1,31,USA
James H.,1871-09-19,1,1895,1896,9,19,USA
Gilbert James,1928-05-19,9,1951,1960,5,19,USA
Marshall James,1978-12-19,0,2005,2005,12,19,USA
John Auchanbolt,1874-05-21,10,1895,1905,5,21,USA
Jack Burns,1966-01-16,12,1987,1999,1,16,USA
Oddibe,1962-08-25,9,1985,1994,8,25,USA
Roger Alan,1960-12-21,11,1985,1996,12,21,USA
Samuel Edward,1942-09-21,14,1961,1975,9,21,USA
Charles Dwayne,1967-10-01,12,1989,2001,10,1,USA
James D.,1862-11-05,0,1884,1884,11,5,USA
Pryor Mynatt,1881-11-05,2,1909,1911,11,5,USA
Leland Stanford,1894-05-23,0,1916,1916,5,23,USA
Frank,1918-08-04,0,1942,1942,8,4,USA
William Henry,1952-02-14,5,1974,1979,2,14,USA
Louis Anthony,1902-05-30,1,1930,1931,5,30,USA
Joseph Earl,1972-10-19,8,1998,2006,10,19,USA
Bernard Joseph,1875-03-29,1,1901,1902,3,29,USA
Guy G.,1872-09-03,0,1895,1895,9,3,USA
Leon,1944-04-26,2,1968,1970,4,26,USA
Alexander Shepard,1869-10-11,0,1892,1892,10,11,USA
Christopher A.,1861-08-17,0,1884,1884,8,17,USA
Charles Amos,1875-03-13,4,1902,1906,3,13,USA
Anderson Daniel,1874-11-26,4,1895,1899,11,26,USA
Edward William,1873-08-03,15,1893,1908,8,3,USA
Hermas Walter,1870-03-11,7,1896,1903,3,11,USA
Howard Alexander,1910-03-07,0,1945,1945,3,7,USA
Lamont Amos,1872-11-07,1,1895,1896,11,7,USA
Orlando de Jesus,1938-06-28,6,1962,1968,6,28,Cuba
Timothy John,1989-06-08,6,2013,2019,6,8,USA
John Reed,1869-08-25,13,1890,1903,8,25,USA
Andrew Joseph,1956-10-25,10,1981,1991,10,25,USA
Mark Andrew,1888-09-12,1,1917,1918,9,12,USA
Edward Joseph,1921-09-30,1,1946,1947,9,30,USA
Fred Melvin,1926-09-26,NA,NA,NA,9,26,USA
Dennis Lawrence,1871-07-15,12,1896,1908,7,15,USA
James B.,1863-05-10,12,1884,1896,5,10,USA
Daniel John,1887-12-02,0,1912,1912,12,2,USA
James Vincent,1888-11-09,0,1912,1912,11,9,USA
John Charles,1864-05-13,5,1886,1891,5,13,USA
Michael Henry,1850-11-16,11,1871,1882,11,16,USA
William Henry,1909-11-16,7,1935,1942,11,16,USA
Cornelius Bernard,1882-08-25,0,1903,1903,8,25,USA
Daniel DeSales,1885-06-07,0,1911,1911,6,7,USA
Daniel Aloysius,1911-09-29,0,1934,1934,9,29,USA
Francis D.,1899-04-29,0,1925,1925,4,29,USA
Jacob Daniel,1986-08-06,9,2010,2019,8,6,USA
Willie Dean,1958-11-02,17,1982,1999,11,2,USA
Casey Michael,1982-10-12,8,2008,2016,10,12,USA
George Kevin,1969-01-18,0,1993,1993,1,18,USA
Patrick Henry,1888-07-02,0,1912,1912,7,2,USA
William Mac,1908-09-05,1,1944,1945,9,5,USA
Warren Edward,1924-09-29,5,1950,1955,9,29,USA
William Jacob,1880-06-29,0,1907,1907,6,29,USA
William Alexander,1883-04-29,0,1908,1908,4,29,USA
John Joseph,1917-08-06,0,1944,1944,8,6,USA
Randall Kent,1953-10-29,1,1977,1978,10,29,USA
William Vaness,1873-11-10,6,1890,1896,11,10,USA
Daniel Michael,1943-11-29,4,1968,1972,11,29,USA
Augustus,1869-09-16,0,1893,1893,9,16,USA
James William,1878-10-02,1,1904,1905,10,2,USA
Joseph Jerome,1871-03-20,9,1899,1908,3,20,USA
George Washington,1854-02-22,5,1882,1887,2,22,USA
Russell Brent,1963-06-18,3,1992,1995,6,18,USA
Kevin Michael,1977-06-28,1,1999,2000,6,28,USA
James Milton,1943-10-06,8,1965,1973,10,6,USA
John T.,1861-01-05,2,1886,1888,1,5,USA
Lynn Everett,1950-03-27,10,1972,1982,3,27,USA
Ezra Malachi,1920-10-20,1,1949,1950,10,20,USA
Ulysses Simpson Grant,1872-05-26,2,1906,1908,5,26,USA
Scott Thomas,1989-10-31,0,2015,2015,10,31,USA
Arthur John,1882-02-27,0,1905,1905,2,27,CAN
Frank Bernard,1901-11-08,15,1922,1937,11,8,USA
William Aloysius,1896-01-18,NA,NA,NA,1,18,USA
Dustin Michael,1982-03-24,12,2005,2017,3,24,USA
Kevin Michael,1991-10-18,0,2017,2017,10,18,USA
Kyle Keston,1991-11-27,1,2018,2019,11,27,USA
Tullis Earl,1921-11-26,0,1948,1948,11,26,USA
Robert Emmett,1895-04-10,12,1917,1929,4,10,USA
Howard,1889-09-11,0,1912,1912,9,11,USA
John Joseph,1873-04-07,16,1891,1907,4,7,USA
John,1890-12-08,0,1914,1914,12,8,USA
Kyle Daniel,1992-07-31,1,2017,2018,7,31,USA
Thomas Virgil,1967-12-08,0,1997,1997,12,8,USA
Frank Edwin,1944-08-30,19,1965,1984,8,30,USA
Scott Houston,1954-01-18,12,1976,1988,1,18,USA
Walter Howard,1899-08-05,2,1922,1924,8,5,USA
Frederick Stanley,1963-10-31,18,1986,2004,10,31,USA
Mark Anthony,1872-10-22,0,1892,1892,10,22,USA
Terence Roy,1963-09-23,7,1987,1994,9,23,USA
Joseph W.,1862-03-13,0,1890,1890,3,13,USA
William Patrick,1964-02-14,1,1988,1989,2,14,USA
Christopher Ryan,1988-04-11,0,2013,2013,4,11,USA
James Thomas,1863-11-18,28,1884,1912,11,18,USA
William Deck,1989-06-23,1,2017,2018,6,23,USA
James A.,1875-02-04,0,1901,1901,2,4,USA
Mickey C.,1941-01-18,5,1962,1967,1,18,USA
Reese Jackson,1995-03-02,1,2018,2019,3,2,USA
Ryan Byron,1971-11-23,5,1997,2002,11,23,USA
Thomas Patrick,1892-02-01,5,1914,1919,2,1,USA
William Henry,1855-01-01,3,1879,1882,1,1,USA
Mark David,1963-10-01,15,1986,2001,10,1,USA
Robert Emmet,1870-02-07,0,1898,1898,2,7,USA
James Bernard,1875-12-17,0,1908,1908,12,17,USA
John Joseph,1921-09-21,5,1943,1948,9,21,USA
Martin Joseph,1886-10-30,6,1910,1916,10,30,USA
Austin Bush,1895-09-22,4,1918,1922,9,22,USA
Vance Loren,1956-07-10,1,1981,1982,7,10,USA
Collin Alexander,1987-06-19,7,2012,2019,6,19,USA
Vance Elmer,1897-10-14,0,1921,1921,10,14,USA
Henry Cooke,1880-07-27,3,1906,1909,7,27,United Kingdom
Stover William,1939-09-22,1,1957,1958,9,22,USA
John Phalen,1890-09-19,18,1909,1927,9,19,USA
Frank W.,1859-07-12,0,1883,1883,7,12,USA
John Reid,1879-01-11,8,1905,1913,1,11,USA
Joseph Anthony,1951-08-04,1,1974,1975,8,4,USA
Matthew Martin,1880-06-12,11,1901,1912,6,12,USA
Timothy Allen,1965-03-21,6,1990,1996,3,21,USA
Edward Otto,1884-07-26,0,1911,1911,7,26,USA
James McCutchen,1874-08-27,6,1895,1901,8,27,USA
Archie Richard,1911-05-12,6,1937,1943,5,12,USA
Harold Leroy,1906-07-10,5,1927,1932,7,10,USA
Brendan Joel,1995-12-18,0,2019,2019,12,18,USA
Cody Dean,1974-01-11,2,2002,2004,1,11,CAN
David Lawrence,1950-03-14,7,1975,1982,3,14,CAN
David,1995-03-31,0,2019,2019,3,31,USA
Reeve Stewart,1881-11-16,0,1915,1915,11,16,USA
Edwin John,1864-06-06,12,1887,1899,6,6,USA
William Boyd,1886-08-07,13,1907,1920,8,7,USA
James,1861-04-19,0,1884,1884,4,19,CAN
James Marion,1947-02-01,1,1972,1973,2,1,USA
Raymond Ellis,1890-07-20,3,1913,1916,7,20,USA
Roger Hornsby,1926-09-16,1,1943,1944,9,16,USA
Walter Thomas,1972-01-17,6,1996,2002,1,17,USA
Emmett James,1906-11-02,2,1932,1934,11,2,USA
John Wellington,1847-08-27,0,1875,1875,8,27,USA
Russell Errett,1854-09-08,4,1878,1882,9,8,USA
James William,1873-02-10,1,1898,1899,2,10,USA
Frank Gordon,1888-08-13,1,1915,1916,8,13,USA
Michael Charles,1985-03-04,6,2010,2016,3,4,USA
Patrick J.,1854-12-27,NA,NA,NA,12,27,USA
David John,1863-12-01,1,1890,1891,12,1,USA
John Aloysius,1930-11-23,NA,NA,NA,11,23,USA
Joel Jacob,1963-02-25,1,1986,1987,2,25,USA
Lawrence G.,1866-03-25,2,1884,1886,3,25,USA
Alexander J.,1856-08-14,3,1884,1887,8,14,USA
William Landis,1994-08-23,1,2018,2019,8,23,USA
Robert Francis,1875-10-04,0,1901,1901,10,4,USA
Charles Richard,1946-11-22,7,1970,1977,11,22,USA
Andrew David,1990-02-08,0,2015,2015,2,8,USA
Harmar Denny,1848-04-29,NA,NA,NA,4,29,USA
Jefferson Alan,1963-02-18,5,1989,1994,2,18,USA
James Arthur,1936-06-01,2,1960,1962,6,1,USA
Tony Mark,1977-06-29,1,2000,2001,6,29,USA
Dennis Dale,1944-03-29,9,1963,1972,3,29,USA
Edward Cameron,1881-08-20,0,1907,1907,8,20,USA
Arthur James,1908-12-20,0,1932,1932,12,20,USA
John Lowell,1951-09-29,NA,NA,NA,9,29,USA
Howard Zell,1891-03-25,3,1912,1915,3,25,USA
Michael Duane,1953-10-23,6,1976,1982,10,23,USA
Byron Scott,1955-09-29,6,1977,1983,9,29,USA
William,1861-07-03,0,1884,1884,7,3,USA
James Thomas,1860-11-18,0,1884,1884,11,18,USA
James Robert,1902-01-03,0,1932,1932,1,3,USA
Joey Richard,1956-07-11,7,1977,1984,7,11,USA
Justin Theodore,1912-03-24,2,1931,1933,3,24,USA
James Anson,1888-04-12,0,1914,1914,4,12,USA
Patrick Elmer,1910-08-17,8,1937,1945,8,17,USA
Ralph Edgar,1885-05-23,0,1908,1908,5,23,USA
Thomas,1860-03-28,8,1883,1891,3,28,USA
Warren A.,1876-01-22,3,1900,1903,1,22,USA
Albert Eldon,1912-09-20,0,1935,1935,9,20,USA
John Bannerman,1881-07-18,14,1901,1915,7,18,CAN
Marty Lee,1974-10-26,3,2004,2007,10,26,USA
Wayne Gaffney,1924-08-29,1,1951,1952,8,29,USA
Mark Tremell,1964-10-04,18,1986,2004,10,4,USA
Mark Steven,1980-10-09,0,2007,2007,10,9,USA
Soule James,1908-09-12,3,1930,1933,9,12,USA
Ralph Alton,1916-10-19,0,1938,1938,10,19,USA
Calvin Coolidge Julius Caesar Tuskahoma,1925-12-01,20,1944,1964,12,1,USA
Nathan Richard,1981-10-28,9,2005,2014,10,28,USA
Samuel,1872-11-24,0,1902,1902,11,24,USA
Henry John,1886-12-19,0,1908,1908,12,19,USA
Donald John,1930-01-04,17,1957,1974,1,4,USA
John Henry,1869-10-15,1,1892,1893,10,15,USA
Jack Wally,1932-07-25,0,1956,1956,7,25,USA
Ryan Patrick,1994-12-14,2,2017,2019,12,14,USA
John Joseph,1867-09-19,8,1889,1897,9,19,USA
John Weaver,1878-03-06,0,1902,1902,3,6,USA
Francis E.,1875-09-21,5,1899,1904,9,21,USA
George,1846-06-28,NA,NA,NA,6,28,Ireland
James Michael,1936-07-20,0,1960,1960,7,20,USA
Joab Logan,1887-09-07,0,1913,1913,9,7,USA
Martin Joseph,1900-03-14,14,1920,1934,3,14,USA
Patrick A.,1859-10-18,0,1879,1879,10,18,Ireland
Jimmy Lee,1949-08-10,0,1968,1968,8,10,USA
Gregory Winston,1966-12-01,7,1993,2000,12,1,USA
William Edward,1971-11-17,8,1996,2004,11,17,USA
George A.,1863-09-01,0,1890,1890,9,1,CAN
Norman Alexis,1895-10-05,7,1922,1929,10,5,USA
Roy David,1929-07-17,15,1951,1966,7,17,USA
Thomas Law,1888-04-18,4,1908,1912,4,18,USA
Thomas Erwin,1951-09-13,0,1977,1977,9,13,USA
Fred Drury,1891-10-13,6,1914,1920,10,13,USA
Hugh Raphael,1901-12-16,4,1925,1929,12,16,USA
John F.,1849-04-01,4,1871,1875,4,1,USA
Kenneth Lee,1942-06-01,15,1962,1977,6,1,USA
Joe Craig,1959-11-05,12,1983,1995,11,5,USA
Carl Mack,1917-01-25,0,1945,1945,1,25,USA
Edgar J.,1865-10-24,0,1893,1893,10,24,USA
Donald Eric,1909-04-12,13,1929,1942,4,12,USA
David Arthur,1942-10-31,13,1962,1975,10,31,USA
Michael Joseph,1893-09-13,10,1915,1925,9,13,USA
Robert Maxey,1916-09-19,0,1939,1939,9,19,USA
John Raymond,1905-09-16,1,1927,1928,9,16,USA
George Francis,1901-01-11,0,1922,1922,1,11,USA
James Patrick,1965-06-10,1,1992,1993,6,10,USA
John Francis,1932-06-04,NA,NA,NA,6,4,USA
Timothy Augustine,1898-11-20,4,1922,1926,11,20,USA
Thomas Henry,1895-11-05,0,1922,1922,11,5,USA
Gordon Joseph,1910-07-31,0,1932,1932,7,31,USA
John Harley,1877-08-11,0,1901,1901,8,11,USA
Robert Lee,1958-08-12,0,1983,1983,8,12,USA
George Earl,1898-05-12,7,1924,1931,5,12,USA
Jeffrey Lavern,1969-10-18,0,1993,1993,10,18,USA
Jeff,1992-04-08,1,2018,2019,4,8,USA
Norman Francis,1892-10-22,0,1919,1919,10,22,USA
Gerald Edward,1936-08-07,9,1964,1973,8,7,USA
Brian David,1974-05-20,0,1999,1999,5,20,USA
Edwin Briggs,1879-01-10,0,1904,1904,1,10,USA
William Francis,1946-08-29,3,1969,1972,8,29,USA
Patrick Howard,1899-02-27,5,1922,1927,2,27,USA
Frank,1872-02-16,0,1899,1899,2,16,USA
John Alexander,1859-11-01,17,1882,1899,11,1,USA
Dallas Lyle,1980-07-23,7,2004,2011,7,23,USA
John Jacob,1869-03-09,3,1901,1904,3,9,USA
Kyle Landon,1987-11-11,0,2012,2012,11,11,USA
Herbert George,1899-03-29,3,1923,1926,3,29,USA
Gerald Joseph,1912-01-31,0,1934,1934,1,31,USA
Mortimer Martin,1861-06-28,7,1891,1898,6,28,USA
Michael Robert,1950-08-30,5,1969,1974,8,30,USA
William Thomas,1861-06-28,7,1884,1891,6,28,USA
George Watt,1885-05-01,11,1907,1918,5,1,USA
George Hartley,1910-05-29,12,1936,1948,5,29,USA
Glenn Richard,1915-04-19,9,1938,1947,4,19,USA
Alvin Hugh,1895-09-15,9,1918,1927,9,15,USA
Alex James,1993-04-06,1,2018,2019,4,6,USA
Brian Wesley,1967-08-27,9,1990,1999,8,27,USA
Harold Abraham,1945-07-10,19,1968,1987,7,10,USA
Norman,1947-09-26,1,1969,1970,9,26,USA
Walter Kevin,1959-10-16,11,1983,1994,10,16,USA
Peter Robert,1864-03-20,0,1888,1888,3,20,USA
John Bernard,1852-12-16,11,1875,1886,12,16,USA
Paul Alphonsus,1867-04-03,0,1891,1891,4,3,USA
James Edward,1863-07-04,6,1885,1891,7,4,USA
William Patrick,1891-06-03,5,1911,1916,6,3,USA
Calvin Alexander,1849-08-30,8,1871,1879,8,30,USA
George William,1865-09-16,0,1885,1885,9,16,USA
Douglas Lawrence,1896-08-17,9,1921,1930,8,17,USA
William Henry,1910-11-28,0,1931,1931,11,28,USA
Larry Dean,1954-02-10,12,1978,1990,2,10,USA
Robert Andrew,1960-08-25,5,1983,1988,8,25,USA
Russell Loren,1968-01-27,10,1991,2001,1,27,USA
Charles Richard,1921-04-09,2,1943,1945,4,9,CAN
Austin Wade,1995-05-03,1,2018,2019,5,3,USA
Matthew Brian,1975-11-21,8,1998,2006,11,21,USA
John Davis,1892-12-04,0,1920,1920,12,4,USA
Henry Lee,1894-07-12,14,1915,1929,7,12,USA
Michael Ray,1961-04-29,4,1986,1990,4,29,USA
Rufus Rivers,1907-08-25,0,1926,1926,8,25,USA
David Donald,1964-01-07,1,1987,1988,1,7,USA
George Clinton,1865-07-11,5,1890,1895,7,11,USA
Stephen Vincent,1886-10-14,0,1912,1912,10,14,USA
John Alan,1993-04-24,1,2018,2019,4,24,USA
Charles Edward,1891-04-16,0,1914,1914,4,16,USA
Patrick James,1968-09-06,8,1993,2001,9,6,USA
Christopher Peter,1978-01-20,0,2003,2003,1,20,CAN
Gilbert Allen,1978-09-08,11,1999,2010,9,8,USA
James Jason,1970-05-16,10,1995,2005,5,16,USA
Brandon Edward,1980-01-26,5,2005,2010,1,26,USA
Ray Antone,1926-05-09,0,1945,1945,5,9,USA
George Francis,1948-12-09,10,1972,1982,12,9,USA
Thomas Anthony,1988-04-09,1,2013,2014,4,9,USA
Luis Main,1963-03-26,3,1988,1991,3,26,USA
Rafael Eduardo,1975-02-15,1,1998,1999,2,15,Panama
Yoervis Jose,1988-07-27,2,2013,2015,7,27,Venezuela
Kristopher Allen,1985-10-07,9,2009,2018,10,7,USA
Irving John,1927-06-18,2,1949,1951,6,18,USA
Scott Howard,1961-09-16,2,1988,1990,9,16,USA
Joseph Michael,1911-11-24,16,1932,1948,11,24,USA
Peter James,1862-11-13,1,1884,1885,11,13,USA
William Thomas,1889-09-04,0,1915,1915,9,4,USA
Frank J.,1867-03-14,1,1889,1890,3,14,Czech Republic
Charles Roy,1900-09-15,3,1923,1926,9,15,USA
Evan David,1983-05-12,6,2008,2014,5,12,USA
George Jouett,1867-02-21,9,1891,1900,2,21,USA
Samuel Mack,1923-04-23,3,1948,1951,4,23,USA
Charles Philip,1948-07-03,0,1972,1972,7,3,USA
Russell Harlan,1918-11-28,6,1941,1947,11,28,USA
Thomas William,1890-03-18,0,1910,1910,3,18,USA
David Keith,1959-08-08,4,1984,1988,8,8,USA
Arthur Ernst,1879-03-30,0,1906,1906,3,30,USA
Henry William,1896-05-01,12,1922,1934,5,1,USA
Walter Henry,1890-12-11,0,1913,1913,12,11,USA
Robert Bernard,1887-06-25,0,1910,1910,6,25,USA
Frank Louis,1863-10-18,1,1884,1885,10,18,USA
Ryan Thomas,1994-05-04,0,2018,2018,5,4,USA
George F.,1853-01-29,0,1884,1884,1,29,USA
John F.,1863-05-10,1,1886,1887,5,10,USA
Karl Daniel,1891-05-15,0,1913,1913,5,15,USA
Merton Merrill,1887-10-18,0,1912,1912,10,18,USA
Adalberto,1993-06-20,3,2016,2019,6,20,D.R.
Alejandro DeJesus,1991-01-18,0,2017,2017,1,18,USA
Erick Augusto,1994-11-09,0,2019,2019,11,9,D.R.
Francisco Jose,1995-10-27,2,2017,2019,10,27,D.R.
Jenrry Manuel,1989-10-11,5,2010,2015,10,11,D.R.
Miguel,1975-03-25,0,1996,1996,3,25,D.R.
Roman,1930-08-09,9,1955,1964,8,9,Cuba
Roberto Antonio,1972-04-14,4,1993,1997,4,14,D.R.
Samuel Elias,1952-05-09,5,1976,1981,5,9,D.R.
Seth Wayne,1991-04-05,0,2019,2019,4,5,USA
Mark D.,1985-03-28,10,2009,2019,3,28,USA
Albert Ernest,1915-01-11,0,1937,1937,1,11,USA
Francisco Javier,1964-01-25,5,1984,1989,1,25,P.R.
Jose Luis,1965-09-02,4,1990,1994,9,2,P.R.
Luis Antonio,1949-08-11,7,1970,1977,8,11,P.R.
Sabath Anthony,1922-01-21,9,1947,1956,1,21,USA
Adam Michael,1972-03-27,8,2000,2008,3,27,USA
Kevin Michael,1982-05-14,0,2007,2007,5,14,USA
Oscar Donald,1899-08-04,11,1926,1937,8,4,USA
Joseph Peter,1905-03-11,0,1927,1927,3,11,USA
Keury,1993-08-02,2,2017,2019,8,2,D.R.
William Harpin,1874-06-06,0,1902,1902,6,6,USA
Jonathan Michael,1984-07-11,2,2007,2009,7,11,USA
Paul B.,1888-08-23,1,1910,1911,8,23,USA
Juan Esteban,1976-11-11,0,2000,2000,11,11,D.R.
Stephen Blasius,1886-01-02,0,1909,1909,1,2,USA
William Edwin,1945-07-07,9,1968,1977,7,7,USA
Clifford George,1912-01-03,7,1937,1944,1,3,USA
David Olin,1928-10-03,2,1956,1958,10,3,USA
Reuben Franklin,1917-02-27,6,1941,1947,2,27,USA
Mitchell Wade,1973-09-18,5,1998,2003,9,18,USA
Robert Paul,1961-10-28,9,1985,1994,10,28,USA
Timothy Macgill,1989-10-09,3,2016,2019,10,9,USA
Kevin Ford,1978-01-07,8,2002,2010,1,7,USA
Adalberto,1982-02-22,0,2010,2010,2,22,D.R.
Carlos Alberto,1974-06-18,0,2003,2003,6,18,Venezuela
Donaldo Alfonso,1978-06-07,2,2001,2003,6,7,Venezuela
Jose de la Caridad,1885-01-02,NA,NA,NA,1,2,Cuba
Roman Junior,1990-07-25,1,2014,2015,7,25,D.R.
Yohander Manuel,1995-01-17,3,2016,2019,1,17,Venezuela
Daniel,1993-09-28,0,2019,2019,9,28,USA
Carlos Ramon,1974-11-04,3,1997,2000,11,4,Venezuela
Luis Alonso,1983-10-31,6,2007,2013,10,31,Mexico
Mario,1950-12-26,8,1974,1982,12,26,Mexico
Cristobal Rigoberto,1933-11-16,0,1970,1970,11,16,Cuba
Michael Joseph,1955-11-26,0,1979,1979,11,26,USA
Ramiro,1972-06-15,9,1996,2005,6,15,Panama
Frank,1971-01-07,6,1999,2005,1,7,USA
John,1868-01-15,11,1892,1903,1,15,USA
Antonio Gustavo,1965-02-20,2,1992,1994,2,20,Cuba
Conner Scott,1995-05-29,0,2019,2019,5,29,USA
Daniel Joseph,1993-02-19,3,2016,2019,2,19,USA
Paul Gerard,1969-03-25,2,1995,1997,3,25,USA
Denis John,1940-07-21,12,1962,1974,7,21,USA
Michael William,1894-10-16,9,1914,1923,10,16,USA
Edward,1885-11-07,2,1912,1914,11,7,USA
Theodore Charles,1897-11-04,0,1918,1918,11,4,USA
Emile Michael,1905-10-19,3,1933,1936,10,19,USA
Rudolph Bartholomew,1951-05-01,8,1971,1979,5,1,USA
Hector Luis,1974-04-29,3,2000,2003,4,29,P.R.
Orlando,1961-11-07,8,1982,1990,11,7,P.R.
Oscar M.,1994-12-16,0,2019,2019,12,16,Colombia
Henry Felipe,1969-07-23,5,1992,1997,7,23,D.R.
Harry Vernon,1889-03-10,0,1910,1910,3,10,USA
John Locke,1892-01-22,0,1912,1912,1,22,USA
Jose Miguel,1971-03-05,9,1994,2003,3,5,D.R.
Jordy Joe,1986-08-27,7,2012,2019,8,27,USA
Luis Roberto,1968-02-15,2,1991,1993,2,15,D.R.
Mark Kenneth,1954-05-22,0,1981,1981,5,22,USA
Melvin,1990-11-02,0,2014,2014,11,2,D.R.
Orlando Luis,1966-11-02,13,1990,2003,11,2,P.R.
George Barclay,1874-06-20,8,1894,1902,6,20,USA
James Anderson,1950-08-30,1,1975,1976,8,30,USA
Kent Franklin,1968-02-01,19,1989,2008,2,1,USA
Olise Cla,1983-06-04,5,2005,2010,6,4,USA
John Joseph,1909-11-18,0,1934,1934,11,18,USA
Arthur Francis,1902-07-07,0,1922,1922,7,7,USA
Ronald Knox,1956-11-26,3,1984,1987,11,26,USA
Carl Frederick Rudolf,1888-12-20,19,1907,1926,12,20,USA
Louis William,1971-04-06,8,1998,2006,4,6,USA
William Henry,1870-07-30,8,1891,1899,7,30,USA
Brett Alan,1966-07-15,1,1993,1994,7,15,USA
Edward Mason,1860-05-22,2,1882,1884,5,22,USA
George Washington,1880-04-14,2,1901,1903,4,14,USA
Herman G.,1900-11-12,0,1921,1921,11,12,USA
James Joseph,1943-12-09,10,1965,1975,12,9,USA
John Howard,1894-10-12,0,1913,1913,10,12,USA
Lloyd Archer,1924-08-02,6,1949,1955,8,2,USA
Lloyd Wesley,1933-04-08,0,1957,1957,4,8,USA
Ryan Adam,1992-02-21,1,2016,2017,2,21,USA
Carl Harrison,1944-02-25,NA,NA,NA,2,25,USA
Whitley David,1989-01-24,3,2016,2019,1,24,USA
John Warren,1922-01-17,2,1951,1953,1,17,USA
Samuel Blair,1872-08-06,10,1896,1906,8,6,USA
James Verlin,1916-08-10,0,1943,1943,8,10,USA
Leonard Richard,1917-05-05,6,1941,1947,5,5,USA
Matthew Bates,1965-08-04,6,1989,1995,8,4,USA
Jose Ramon Nova,1966-05-22,20,1987,2007,5,22,D.R.
Melquisedec,1987-01-31,1,2012,2013,1,31,D.R.
Stephen Mathias,1918-01-13,7,1938,1945,1,13,USA
Devin Douglas,1988-06-19,7,2011,2018,6,19,USA
John Alexander,1945-08-06,11,1968,1979,8,6,USA
Charles Walter,1884-03-19,5,1909,1914,3,19,USA
Andrew Warren,1898-02-01,0,1924,1924,2,1,USA
Randall Jerome,1981-08-13,4,2005,2009,8,13,USA
Thomas John,1874-07-27,0,1899,1899,7,27,USA
Alfred Tristram,1852-12-31,0,1875,1875,12,31,USA
Michael Henry,1973-01-02,2,1998,2000,1,2,USA
Thomas John,1940-07-16,0,1963,1963,7,16,USA
Travis Anthony,1982-08-17,1,2007,2008,8,17,USA
Frank Joseph,1913-12-13,0,1940,1940,12,13,USA
Arthur Beauregard,1915-06-01,3,1943,1946,6,1,USA
George Dewey,1898-05-06,2,1922,1924,5,6,USA
George Michael,1920-10-08,11,1943,1954,10,8,USA
Charles,1918-04-28,2,1943,1945,4,28,USA
Clarence Edward,1952-05-23,4,1974,1978,5,23,USA
Roger Henry,1947-10-10,10,1970,1980,10,10,USA
William Andrew,1918-12-04,0,1944,1944,12,4,USA
Alexander,1903-01-04,5,1925,1930,1,4,USA
Leonard Ray,1899-07-06,2,1923,1925,7,6,USA
Hensley Filemon Acasio,1967-06-23,9,1989,1998,6,23,Curacao
Robert William,1896-07-19,10,1920,1930,7,19,USA
Emil Frederick,1893-06-09,13,1914,1927,6,9,USA
Alex John,1990-01-03,2,2015,2017,1,3,USA
Bernhard,1885-01-21,12,1913,1925,1,21,USA
Benjamin K.,1993-01-30,0,2018,2018,1,30,USA
William Adam,1893-01-14,4,1913,1917,1,14,USA
Robert Bernard,1939-08-04,6,1964,1970,8,4,USA
Brian Scott,1963-01-29,2,1988,1990,1,29,USA
John Tortes,1880-07-29,8,1909,1917,7,29,USA
Chad William,1975-08-08,4,1999,2003,8,8,USA
Daniel Thomas,1952-08-03,11,1974,1985,8,3,USA
Daniel Livingston,1981-07-03,6,2004,2010,7,3,USA
Drew Edward,1981-08-29,0,2006,2006,8,29,USA
Lambert Daniel,1915-10-06,9,1937,1946,10,6,USA
George Francis,1909-08-03,0,1938,1938,8,3,USA
John George,1865-02-14,0,1890,1890,2,14,USA
John Robert,1932-03-23,6,1955,1961,3,23,USA
Tanner Joe,1962-05-10,1,1988,1989,5,10,USA
Lee,1888-03-29,0,1909,1909,3,29,USA
Lewis Henry,1859-12-09,0,1884,1884,12,9,USA
Russell Charles,1923-10-25,13,1946,1959,10,25,USA
Scott William,1957-08-19,0,1978,1978,8,19,USA
John Barton,1976-02-03,2,2001,2003,2,3,USA
Daniel,1970-09-09,13,1993,2006,9,9,USA
Robert Peter,1928-10-20,1,1954,1955,10,20,USA
Casimir Eugene,1926-03-04,11,1943,1954,3,4,USA
Christian Matthew,1971-01-04,8,1998,2006,1,4,USA
Eugene Richard,1938-06-02,9,1966,1975,6,2,USA
Jason Drew,1976-05-04,10,2001,2011,5,4,USA
John August,1893-08-12,0,1921,1921,8,12,Finland
John Joseph,1907-07-10,0,1932,1932,7,10,USA
Ralph Joseph,1902-05-03,2,1924,1926,5,3,USA
Edward Allen,1926-09-09,7,1950,1957,9,9,USA
Glenn Roger,1930-07-26,0,1953,1953,7,26,USA
Kameron Kraig,1984-05-10,3,2008,2011,5,10,USA
Jason Douglas,1975-06-26,2,2001,2003,6,26,USA
James Blaine,1889-05-28,4,1917,1921,5,28,USA
John Wayne,1900-04-11,0,1922,1922,4,11,USA
Keynan Anthony,1993-09-12,2,2017,2019,9,12,USA
William Scott,1988-09-09,5,2012,2017,9,9,USA
Richard James,1914-09-28,0,1938,1938,9,28,USA
Ezra Millington,1882-11-13,4,1909,1913,11,13,USA
Gary Roger,1963-01-28,3,1987,1990,1,28,USA
Douglas Andrew,1974-06-19,11,1998,2009,6,19,USA
Edward Frank,1924-03-06,5,1945,1950,3,6,USA
Matthew Todd,1968-02-13,7,1993,2000,2,13,USA
Lawrence Edward,1925-08-20,4,1948,1952,8,20,USA
John Michael,1911-11-13,2,1935,1937,11,13,USA
Jose Manuel,1984-10-29,5,2008,2013,10,29,Venezuela
Peter James,1939-10-25,8,1964,1972,10,25,USA
John Joseph,1910-11-27,0,1944,1944,11,27,USA
Miles Tice,1988-08-23,7,2012,2019,8,23,USA
Edward Thomas,1926-09-11,14,1944,1958,9,11,USA
Robert,1964-07-28,8,1988,1996,7,28,USA
Jesse Clyde,1887-03-25,15,1907,1922,3,25,USA
Horace Robert,1894-04-07,2,1915,1917,4,7,USA
Lawrence William,1951-02-14,10,1974,1984,2,14,USA
Michael Wayne,1968-02-28,0,1996,1996,2,28,USA
Aaron Wade,1976-12-15,8,2003,2011,12,15,USA
Carl Thomas,1918-03-22,0,1940,1940,3,22,USA
Wilson Daniel,1909-02-15,8,1935,1943,2,15,USA
Donald Ray,1936-03-13,0,1958,1958,3,13,USA
James Charlie,1943-08-08,1,1968,1969,8,8,USA
David Allen,1962-04-03,NA,NA,NA,4,3,USA
Michael Wilfred,1953-03-30,1,1975,1976,3,30,USA
Wade Allen,1986-11-13,8,2011,2019,11,13,USA
Sam Salvatore,1969-11-26,1,1992,1993,11,26,USA
John Kenneth,1895-06-30,14,1915,1929,6,30,USA
Felix Bernardo,1943-08-21,11,1966,1977,8,21,P.R.
Frank E.,1865-07-04,0,1890,1890,7,4,USA
Kevin Charles,1971-09-24,11,1998,2009,9,24,USA
Andrew Mark,1985-05-21,13,2006,2019,5,21,USA
Herbert Alexander,1875-10-28,0,1897,1897,10,28,USA
William Alexander,1879-05-23,0,1902,1902,5,23,Germany
Edmund John,1894-08-30,15,1921,1936,8,30,USA
William Francis,1910-04-12,0,1937,1937,4,12,USA
William Paul,1927-07-26,3,1952,1955,7,26,USA
Robert John,1926-06-16,9,1949,1958,6,16,USA
Robert Gerald,1935-07-15,9,1953,1962,7,15,USA
Robert Lane,1939-02-18,17,1957,1974,2,18,USA
Charles Bruce,1947-03-04,3,1973,1976,3,4,USA
Bradley Austin,1989-10-18,6,2013,2019,10,18,USA
Charles Elmer,1892-01-04,0,1912,1912,1,4,USA
Charles Marion,1889-09-18,1,1913,1914,9,18,USA
Charles Hess,1877-12-30,0,1915,1915,12,30,USA
Corky Abraham Philip,1976-03-18,12,2001,2013,3,18,USA
Joseph,1859-09-24,2,1884,1886,9,24,USA
Darrell Keith,1958-02-26,4,1984,1988,2,26,USA
Damian Donald,1969-10-13,10,1997,2007,10,13,USA
George Frederick,1864-08-15,12,1884,1896,8,15,USA
John Barney,1886-09-09,12,1909,1921,9,9,USA
Roy Oscar,1883-02-04,4,1910,1914,2,4,CAN
Charles Bradley,1868-09-10,10,1889,1899,9,10,USA
Dakin Evans,1876-09-03,0,1902,1902,9,3,USA
Dyar K.,1946-05-29,6,1975,1981,5,29,USA
Edwin Collins,1888-11-24,6,1912,1918,11,24,USA
Edward Robert,1916-11-26,14,1936,1950,11,26,USA
Edward Lee,1957-06-29,7,1977,1984,6,29,USA
Elmer,1890-07-28,10,1912,1922,7,28,USA
Elmer Joseph,1903-04-17,0,1929,1929,4,17,USA
Frederick Holman,1886-06-28,0,1910,1910,6,28,USA
Frank Lee,1886-05-13,10,1913,1923,5,13,USA
George C.,1853-02-19,7,1877,1884,2,19,USA
Laurence H.,1894-01-01,9,1916,1925,1,1,USA
James Eldridge,1913-02-13,1,1944,1945,2,13,USA
Hugh Stanley,1886-12-22,4,1911,1915,12,22,USA
Ian Andrew,1992-02-21,0,2019,2019,2,21,USA
Jacob George,1895-12-01,0,1922,1922,12,1,USA
Walter,1898-02-28,9,1924,1933,2,28,USA
Jason Douglas,1982-07-20,0,2007,2007,7,20,USA
Randall Jai,1985-01-17,3,2008,2011,1,17,USA
James McCurdy,1880-10-02,0,1901,1901,10,2,USA
James Matthew,1982-04-28,6,2008,2014,4,28,USA
Joseph Wick,1850-07-24,3,1872,1875,7,24,Germany
Joseph A.,1861-02-17,1,1884,1885,2,17,USA
John Ernest,1941-05-30,5,1962,1967,5,30,USA
John Allen,1944-03-14,3,1966,1969,3,14,USA
Joseph Anthony,1965-08-12,1,1992,1993,8,12,USA
Justin Mark,1977-08-27,8,2002,2010,8,27,USA
Justin Ryan,1987-06-13,5,2014,2019,6,13,USA
Keith Alan,1963-06-12,8,1987,1995,6,12,USA
Neal Keith,1963-03-07,1,1988,1989,3,7,USA
Frank Aloyvisous,1873-01-17,5,1892,1897,1,17,USA
Kurt Everett,1972-08-24,5,1994,1999,8,24,USA
Larry Don,1937-06-19,2,1964,1966,6,19,USA
Lastings Darnell,1985-04-05,5,2006,2011,4,5,USA
Lemmie Earl,1960-06-02,0,1984,1984,6,2,USA
Matthew Lincoln,1974-08-02,1,2001,2002,8,2,USA
Matt Jacob,1971-11-23,4,2003,2007,11,23,USA
Michael Ryan,1989-09-27,0,2016,2016,9,27,USA
Norman Calvin,1946-02-05,9,1965,1974,2,5,USA
Orlando,1969-01-13,3,1994,1997,1,13,Panama
Lowell Otto,1889-06-01,12,1910,1922,6,1,USA
Otis Louis,1901-02-02,5,1927,1932,2,2,USA
John Anthony,1915-05-04,4,1943,1947,5,4,USA
Paul Robert,1965-04-27,2,1991,1993,4,27,USA
Ralph Darwin,1873-03-15,1,1898,1899,3,15,USA
Raymond Peter,1888-02-12,0,1917,1917,2,12,USA
Ralph Joseph,1896-02-29,4,1920,1924,2,29,USA
Ralph Henry,1899-01-14,0,1921,1921,1,14,USA
Randall Scott,1953-03-18,1,1977,1978,3,18,USA
Raymond Roger,1945-04-30,NA,NA,NA,4,30,USA
Leo Alphonso,1897-02-11,0,1923,1923,2,11,USA
Richard Alan,1948-04-19,14,1971,1985,4,19,USA
Roscoe Clyde,1876-12-02,3,1901,1904,12,2,USA
Roland Arthur,1918-08-28,0,1941,1941,8,28,USA
Rodney Carter,1940-01-16,0,1957,1957,1,16,USA
Roger Wesley,1954-08-01,0,1974,1974,8,1,USA
Russell Lewis,1900-03-25,1,1927,1928,3,25,USA
Rudel Charles,1900-07-12,0,1929,1929,7,12,USA
Shelby Charles,1990-10-10,7,2012,2019,10,10,USA
Stuart Leonard,1927-12-26,16,1952,1968,12,26,USA
Thomas Royall,1897-07-05,1,1918,1919,7,5,USA
Travis Eugene,1972-11-02,6,1996,2002,11,2,USA
Trever Douglas,1973-05-29,15,1996,2011,5,29,USA
Warren Lemuel,1885-07-14,2,1909,1911,7,14,USA
Ward Taylor,1884-07-05,8,1909,1917,7,5,USA
Walter W.,1883-10-19,0,1911,1911,10,19,USA
Wade Thomas,1976-09-13,8,1999,2007,9,13,USA
Kenneth Albert,1915-05-02,0,1944,1944,5,2,USA
William Joseph,1878-08-19,3,1901,1904,8,19,USA
Robert Fogle,1926-08-25,1,1953,1954,8,25,USA
John,1861-08-08,9,1884,1893,8,8,USA
John Alexander,1904-01-22,6,1928,1934,1,22,USA
Randy Andre,1961-11-27,7,1987,1994,11,27,USA
Ralph Gregory,1973-12-30,2,1996,1998,12,30,Curacao
Walter Louis,1906-10-18,7,1934,1941,10,18,USA
Alan Bernard,1966-10-18,11,1990,2001,10,18,USA
Alec Thomas,1991-11-30,3,2016,2019,11,30,USA
Arthur Grant,1903-03-02,1,1927,1928,3,2,USA
William Henry,1919-11-02,0,1944,1944,11,2,USA
James Bradley,1957-01-19,3,1980,1983,1,19,USA
Bradley Aaron,1985-03-05,6,2009,2015,3,5,USA
Colonel Buster,1908-09-16,12,1934,1946,9,16,USA
Richard Allan,1945-01-29,0,1970,1970,1,29,USA
Everett,1845-01-20,5,1871,1876,1,20,USA
Frank LeMoyne,1895-05-13,0,1914,1914,5,13,USA
Abbott Paige,1889-10-23,0,1911,1911,10,23,USA
Howard Robinson,1910-05-12,6,1934,1940,5,12,USA
Rupert Frank,1892-10-12,0,1915,1915,10,12,USA
William Grant,1877-08-15,0,1901,1901,8,15,USA
Kevin Austin,1974-12-24,15,1997,2012,12,24,USA
Albert Joseph,1913-12-26,10,1936,1946,12,26,USA
Brian Tate,1959-11-17,0,1978,1978,11,17,USA
Eddie James,1955-05-21,8,1980,1988,5,21,USA
Hoby Trey,1991-01-13,2,2017,2019,1,13,USA
John David,1949-12-28,11,1971,1982,12,28,USA
William James,1925-04-10,2,1948,1950,4,10,USA
Tomaso Anthony,1987-02-16,8,2011,2019,2,16,USA
Michael,1915-01-13,1,1944,1945,1,13,USA
George Earl,1903-06-26,2,1924,1926,6,26,USA
Eric Robert,1975-08-04,11,1998,2009,8,4,USA
Samuel Lawrence,1879-05-04,0,1903,1903,5,4,USA
Michael Randall,1969-02-13,2,1995,1997,2,13,USA
Edmund Joseph,1882-12-10,0,1907,1907,12,10,USA
Rudolph Anthony,1930-03-25,2,1955,1957,3,25,USA
Juan Gustavo,1990-09-18,3,2016,2019,9,18,D.R.
Donald Ray,1938-06-24,12,1960,1972,6,24,USA
Edward M.,1851-06-17,1,1871,1872,6,17,USA
Nathan Derek,1969-08-31,4,1993,1997,8,31,USA
Raymond Theodore,1897-04-04,0,1921,1921,4,4,USA
Zachary Charles,1982-03-12,7,2006,2013,3,12,USA
Craig Stephen,1954-04-25,3,1978,1981,4,25,USA
Stephen Bernard,1944-02-29,9,1970,1979,2,29,USA
Daniel Joseph,1865-11-28,0,1895,1895,11,28,USA
Paul Edison,1923-07-30,10,1946,1956,7,30,USA
Donald Athey,1931-04-14,0,1957,1957,4,14,USA
Blas,1966-03-20,5,1992,1997,3,20,USA
Damon Reed,1974-01-05,4,2000,2004,1,5,USA
Michael David,1987-12-26,9,2010,2019,12,26,USA
Ryan Dale,1974-01-05,3,1998,2001,1,5,USA
Saturnino Orestes Armas,1925-11-29,31,1949,1980,11,29,Cuba
James Edward,1947-07-04,1,1974,1975,7,4,USA
Alex Jordan,1993-09-02,2,2017,2019,9,2,USA
Gregory Brian,1951-07-29,15,1975,1990,7,29,USA
Stephen Wayne,1968-11-24,4,1995,1999,11,24,USA
Gino Michael,1964-05-23,3,1990,1993,5,23,USA
Douglas Anthony,1970-10-18,11,1996,2007,10,18,USA
Paul Thomas,1954-03-20,12,1978,1990,3,20,USA
Angel Luis,1969-11-09,4,1993,1997,11,9,P.R.
Ariel,1989-01-10,2,2016,2018,1,10,Cuba
Juan Miguel,1983-04-25,3,2008,2011,4,25,Cuba
Guillermo,1926-05-24,8,1951,1959,5,24,Cuba
Patrick Theodore Joseph,1981-08-18,5,2006,2011,8,18,USA
John Beverly,1885-05-30,0,1914,1914,5,30,USA
Michael William,1968-08-21,0,1997,1997,8,21,USA
Robert McKasha,1856-02-06,5,1877,1882,2,6,USA
Robert Vance,1943-10-22,5,1970,1975,10,22,USA
Robert Van,1955-04-07,3,1980,1983,4,7,USA
Bryan Bedford,1991-04-19,4,2014,2018,4,19,USA
Charles Ross,1962-06-24,1,1984,1985,6,24,USA
Clarence Elmer,1891-02-22,21,1911,1932,2,22,USA
Craig Seton,1954-04-14,2,1975,1977,4,14,USA
Loren Dale,1921-08-23,10,1946,1956,8,23,USA
William Douglas,1987-05-13,0,2012,2012,5,13,USA
Frederick Francis,1878-06-05,12,1901,1913,6,5,USA
John Franklin,1894-08-09,4,1921,1925,8,9,USA
John Kyle,1965-08-11,4,1986,1990,8,11,USA
Kevin Darnell,1962-01-13,14,1984,1998,1,13,USA
Keith Alexander,1969-08-06,7,1991,1998,8,6,USA
Larry Paul,1971-10-16,0,1996,1996,10,16,USA
Michael Francis,1879-12-09,7,1907,1914,12,9,USA
Monroe Barr,1901-09-11,0,1923,1923,9,11,USA
Paul Michael,1949-08-19,5,1975,1980,8,19,USA
Albert Roy,1885-04-19,9,1910,1919,4,19,USA
Russell Lance,1985-02-15,1,2010,2011,2,15,USA
William,1889-12-01,10,1909,1919,12,1,USA
Sergio Armando,1981-02-16,8,2003,2011,2,16,USA
George Eugene,1945-06-07,11,1966,1977,6,7,USA
Ralph,1890-04-19,0,1916,1916,4,19,USA
John Robert,1913-01-07,17,1936,1953,1,7,USA
Wilmer David,1930-08-13,10,1952,1962,8,13,USA
John Joseph,1960-12-08,6,1983,1989,12,8,USA
William Francis,1897-06-22,1,1923,1924,6,22,USA
David John,1968-06-08,10,1992,2002,6,8,USA
Kevin Paul,1964-11-09,0,1989,1989,11,9,USA
David Allen,1948-01-30,2,1974,1976,1,30,USA
Garrett Lee,1983-04-25,2,2008,2010,4,25,USA
Michael,1922-05-18,0,1945,1945,5,18,USA
Brian Merritt,1971-12-31,14,1996,2010,12,31,USA
Chad Edward,1975-02-18,10,2000,2010,2,18,USA
Daniel Edward,1885-03-23,9,1907,1916,3,23,USA
Dennis Michael,1967-09-15,1,1992,1993,9,15,USA
Joseph Douglas,1943-02-15,9,1962,1971,2,15,USA
Ronald Ralph,1938-10-13,7,1956,1963,10,13,USA
Joseph William,1859-06-27,0,1884,1884,6,27,USA
Samuel R.,1857-03-09,4,1884,1888,3,9,USA
Randall James,1948-10-13,11,1972,1983,10,13,USA
Herbert,1928-08-06,7,1955,1962,8,6,USA
George Anthony,1889-02-18,16,1911,1927,2,18,USA
George Benjamin,1892-03-06,1,1920,1921,3,6,USA
John Henry,1898-01-21,0,1922,1922,1,21,USA
Ernest Follette,1870-12-13,0,1894,1894,12,13,USA
Michael Ross,1968-07-26,8,1993,2001,7,26,USA
Dale Robert,1956-01-25,4,1986,1990,1,25,USA
Dustan Kyle,1976-06-19,6,2001,2007,6,19,USA
William Joseph,1925-07-30,0,1953,1953,7,30,USA
John Leo,1895-09-23,6,1921,1927,9,23,USA
Fenton Leroy,1925-06-14,0,1949,1949,6,14,USA
Carlton,1876-02-15,0,1895,1895,2,15,USA
Benjamin Jose,1974-07-20,12,1998,2010,7,20,P.R.
Robert Joseph,1950-05-21,8,1975,1983,5,21,USA
Cruz Gabriel,1975-05-03,4,1999,2003,5,3,USA
Gustavo Eduardo,1982-02-24,4,2007,2011,2,24,Venezuela
Islay,1971-06-03,6,1996,2002,6,3,USA
Jose Benjamin,1975-06-03,15,1999,2014,6,3,P.R.
Yadier Benjamin,1982-07-13,15,2004,2019,7,13,P.R.
Paul Leo,1956-08-22,20,1978,1998,8,22,USA
Dustin Douglas,1984-08-21,0,2016,2016,8,21,CAN
Frederick Henry,1890-03-15,0,1914,1914,3,15,USA
Samuel John,1992-01-03,0,2017,2017,1,3,USA
Frederick August,1890-06-16,6,1913,1919,6,16,Germany
Richard Henry,1950-06-07,0,1970,1970,6,7,USA
Vincent Leo,1888-08-17,1,1917,1918,8,17,USA
Blas,1915-11-16,9,1937,1946,11,16,USA
Edward Francis,1928-04-28,0,1953,1953,4,28,USA
Shane Hartland,1974-08-12,1,1998,1999,8,12,USA
Carlos,1986-03-21,0,2010,2010,3,21,Venezuela
William Charles,1936-08-11,10,1958,1968,8,11,USA
Yoan Manuel,1995-05-27,3,2016,2019,5,27,Cuba
Frederick Alfred,1903-09-01,0,1928,1928,9,1,USA
Alex,1917-03-05,0,1940,1940,3,5,USA
Carlos Antwan,1988-11-03,0,2017,2017,11,3,USA
Robert James,1945-11-20,18,1966,1984,11,20,USA
Raul Ramon,1971-03-12,12,1993,2005,3,12,D.R.
Raul Adalberto,1995-07-27,3,2016,2019,7,27,USA
Johnny,1986-03-27,2,2013,2015,3,27,USA
Donald Wayne,1947-06-07,15,1968,1983,6,7,USA
Isidro Pedroza,1951-04-11,9,1975,1984,4,11,Mexico
Craig Keystone,1977-02-27,8,2001,2009,2,27,USA
Edward Oliver,1895-02-22,1,1917,1918,2,22,USA
John Allen,1897-08-24,0,1921,1921,8,24,USA
Lawrence James,1956-06-20,0,1976,1976,6,20,USA
Zachary Charles,1931-07-08,1,1958,1959,7,8,USA
Edward Francis,1905-07-24,4,1928,1932,7,24,USA
Francelis,1993-03-21,4,2015,2019,3,21,D.R.
John Evans,1947-09-12,7,1973,1980,9,12,USA
Luis Anibal,1981-12-15,3,2008,2011,12,15,P.R.
Rafael Edgardo,1964-03-31,0,1986,1986,3,31,P.R.
Guillermo,1948-04-01,16,1966,1982,4,1,P.R.
Agustin Alcantara,1977-08-26,0,2006,2006,8,26,D.R.
Aurelio Faustino,1943-11-19,10,1963,1973,11,19,Cuba
Felipe Angel,1928-02-07,2,1953,1955,2,7,Mexico
Jesus Alejandro,1989-11-28,4,2011,2015,11,28,Venezuela
John Joseph,1950-05-25,12,1974,1986,5,25,USA
Manuel,1935-10-16,0,1961,1961,10,16,Cuba
Miguel Angel,1983-07-09,12,2006,2018,7,9,Venezuela
Rafael,1990-10-17,5,2014,2019,10,17,D.R.
Rene,1916-03-12,7,1938,1945,3,12,Cuba
Richard,1963-03-22,9,1987,1996,3,22,USA
Alvin Atlas,1920-07-03,0,1941,1941,7,3,USA
Robert Edward,1944-04-16,9,1970,1979,4,16,USA
Jeffrey Thomas,1962-01-07,12,1987,1999,1,7,USA
Jordan Blackmon,1992-12-27,2,2017,2019,12,27,USA
Michael Paul,1989-07-01,4,2015,2019,7,1,USA
Monty Bryson,1946-09-01,1,1971,1972,9,1,USA
Raymond James,1969-08-08,2,1996,1998,8,8,USA
Steven Lewis,1970-12-25,4,1996,2000,12,25,USA
Jose Carlos,1965-10-17,0,1993,1993,10,17,P.R.
Allan Arthur,1943-08-23,0,1972,1972,8,23,USA
Luke,1983-07-07,5,2008,2013,7,7,USA
Ramon Segundo,1933-01-04,6,1954,1960,1,4,Venezuela
Daniel Francisco,1946-05-17,1,1972,1973,5,17,USA
Joseph Geoffrey,1944-03-12,0,1967,1967,3,12,USA
Eric Lane,1971-01-06,0,1997,1997,1,6,USA
George Henry,1867-03-12,0,1886,1886,3,12,USA
William Craig,1960-08-16,0,1986,1986,8,16,USA
James Irving,1906-09-04,3,1931,1934,9,4,USA
Leo,1899-06-22,0,1932,1932,6,22,USA
Wallace Wade,1930-04-03,11,1954,1965,4,3,USA
Adam Ross,1984-05-08,9,2009,2018,5,8,USA
Albert James,1902-08-04,1,1925,1926,8,4,USA
Anselm Winn,1917-09-22,0,1946,1946,9,22,USA
Andrew George,1994-06-02,2,2017,2019,6,2,USA
Archie Francis,1941-08-30,1,1964,1965,8,30,USA
Robert Barry,1943-04-03,5,1965,1970,4,3,USA
Balor Lilbon,1951-01-25,10,1970,1980,1,25,USA
William Christopher,1902-09-03,0,1925,1925,9,3,USA
William Henry,1901-12-12,1,1926,1927,12,12,USA
William Ross,1960-10-10,0,1986,1986,10,10,USA
Robert Devell,1958-11-08,0,1985,1985,11,8,USA
Robert Vincent,1965-10-27,0,1991,1991,10,27,USA
Bradley Alan,1964-06-21,2,1988,1990,6,21,USA
Carlos Whitman,1906-08-13,0,1930,1930,8,13,USA
Charles Wesley,1884-12-01,0,1912,1912,12,1,USA
Charles William,1953-06-21,14,1973,1987,6,21,USA
William Austin,1905-02-07,5,1929,1934,2,7,USA
D C,1914-04-06,10,1936,1946,4,6,USA
Donnie Ray,1954-02-13,13,1975,1988,2,13,USA
Dylan,1992-08-02,0,2019,2019,8,2,USA
Alonzo Earl,1877-07-29,13,1901,1914,7,29,USA
Graham Edward,1899-01-18,11,1923,1934,1,18,USA
Euel Walton,1908-05-27,2,1934,1936,5,27,USA
Ferdinand De Paige,1896-02-22,0,1914,1914,2,22,USA
Gary Douglas,1945-02-24,0,1970,1970,2,24,USA
Frank Jonah,1876-09-11,0,1905,1905,9,11,USA
Eugene,1885-11-09,3,1909,1912,11,9,USA
Eugene,1909-08-26,14,1931,1945,8,26,USA
Jackie Spencer,1939-02-19,0,1965,1965,2,19,USA
Jerome Jeremy,1987-06-29,0,2011,2011,6,29,USA
James Stanford,1903-12-14,4,1928,1932,12,14,USA
James William,1903-04-24,1,1930,1931,4,24,USA
John Francis,1902-03-23,17,1928,1945,3,23,USA
Joe Gregg,1908-12-25,11,1930,1941,12,25,USA
Alvin Earl,1953-01-25,4,1976,1980,1,25,USA
Kelvin Orlando,1957-09-26,2,1981,1983,9,26,USA
Kerwin Lamar,1970-10-29,0,1996,1996,10,29,USA
Marcus Braymont,1970-11-02,3,1993,1996,11,2,USA
Matthew Cody,1989-06-18,8,2011,2019,6,18,USA
Michael Wayne,1959-11-26,13,1982,1995,11,26,USA
Randolph Edward,1906-06-21,10,1927,1937,6,21,USA
Raymond Leroy,1926-06-01,11,1952,1963,6,1,USA
Roy Daniel,1898-10-26,3,1920,1923,10,26,USA
William Allen,1892-12-16,0,1917,1917,12,16,USA
Scott Alanboyd,1983-11-17,6,2006,2012,11,17,USA
Terry Bluford,1912-05-27,13,1935,1948,5,27,USA
Tommy Joe,1948-07-07,5,1972,1977,7,7,USA
Warren Neal,1972-10-02,3,1998,2001,10,2,USA
Tyler Michael,1987-01-30,5,2012,2017,1,30,USA
Lloyd Albert,1912-06-10,6,1936,1942,6,10,USA
William Wilcy,1897-05-20,6,1927,1933,5,20,USA
Charles Robert,1938-01-23,3,1962,1965,1,23,USA
Robert Ralph,1947-10-09,9,1967,1976,10,9,USA
Jake T.,1912-04-13,8,1936,1944,4,13,USA
Andres,1955-05-25,4,1976,1980,5,25,Mexico
David Michael,1975-07-08,0,2000,2000,7,8,USA
Franklin Miguel,1986-01-24,9,2007,2016,1,24,Venezuela
Julio Ruben,1949-02-18,14,1969,1983,2,18,P.R.
Jose Manuel,1944-12-30,11,1973,1984,12,30,V.I.
Jose Guillermo,1983-02-20,4,2007,2011,2,20,P.R.
Kendrys,1983-06-20,13,2006,2019,6,20,Cuba
Osmer Eduardo,1992-10-30,0,2018,2018,10,30,Venezuela
Richard Angelo,1943-09-20,7,1967,1974,9,20,USA
William Anthony,1972-09-07,0,2000,2000,9,7,USA
Melvin,1972-02-02,12,1999,2011,2,2,Venezuela
Richard Alan,1938-12-05,1,1963,1964,12,5,USA
William L.,1869-10-10,3,1892,1895,10,10,USA
William Nelson,1933-11-27,7,1958,1965,11,27,USA
Carl William,1950-09-26,0,1974,1974,9,26,USA
Brian William,1988-09-30,0,2019,2019,9,30,USA
Charles Vincent,1879-03-26,2,1903,1905,3,26,USA
Charles Barthell,1878-02-22,5,1903,1908,2,22,USA
Colin Richard,1992-10-01,3,2016,2019,10,1,USA
Harry Edwin,1889-04-02,3,1912,1915,4,2,USA
John Herbert,1884-02-16,7,1908,1915,2,16,USA
Albert Thomas,1912-01-01,1,1938,1939,1,1,USA
Michael Robert,1966-04-22,10,1990,2000,4,22,USA
Patrick Joseph,1876-02-07,13,1901,1914,2,7,USA
Roy Ellis,1884-09-17,0,1912,1912,9,17,USA
Samuel,1870-09-16,0,1895,1895,9,16,USA
Jose,1979-10-02,0,2003,2003,10,2,D.R.
Michael Howard,1967-12-13,11,1994,2005,12,13,USA
Forrest Thedore,1881-09-30,0,1909,1909,9,30,USA
David Michael,1942-09-05,7,1963,1970,9,5,USA
Raymond Anderson,1899-12-02,3,1924,1927,12,2,USA
Seth Marvin,1934-08-15,4,1957,1961,8,15,USA
Adrian,1999-02-27,0,2019,2019,2,27,Cuba
Daniel,1930-07-21,0,1958,1958,7,21,Cuba
Brenton Andre,1987-04-21,5,2010,2015,4,21,USA
A. Harry,1869-11-09,1,1891,1892,11,9,USA
Bobby Keith,1954-05-02,11,1978,1989,5,2,USA
Mitchell Austin,1985-09-06,9,2010,2019,9,6,USA
Ramon Rafael,1974-08-15,2,1995,1997,8,15,D.R.
Angel,1955-06-06,1,1981,1982,6,6,Mexico
Diego Rafael,1987-07-21,2,2015,2017,7,21,Venezuela
Edwin A.,1980-07-30,0,2009,2009,7,30,Venezuela
Jose de los Santos Mauricio,1957-11-01,2,1980,1982,11,1,D.R.
Julio,1921-01-28,3,1950,1953,1,28,Cuba
Juan Carlos,1975-02-28,1,2001,2002,2,28,Venezuela
Lewis Howard,1883-08-04,7,1903,1910,8,4,USA
Omar Renan,1952-10-24,11,1975,1986,10,24,Panama
Orber,1977-04-27,5,1999,2004,4,27,Venezuela
Rogelio,1949-09-16,8,1970,1978,9,16,P.R.
David Beale,1889-02-25,0,1913,1913,2,25,USA
Adam Christopher,1990-02-27,4,2015,2019,2,27,USA
Henry W.,1857-10-17,2,1882,1884,10,17,USA
Robert Morris,1926-06-29,8,1950,1958,6,29,USA
Chester Collins,1910-06-06,3,1935,1938,6,6,USA
Harry Richard,1878-11-10,10,1903,1913,11,10,USA
Cyril Arlon,1895-11-11,1,1921,1922,11,11,USA
Edward Carre,1904-05-22,6,1928,1934,5,22,USA
Edwin Willis,1914-11-19,1,1936,1937,11,19,USA
Joseph Michael,1930-11-19,5,1959,1964,11,19,USA
Joe Leonard,1943-09-19,21,1963,1984,9,19,USA
Kevin Lee,1969-12-03,0,1997,1997,12,3,USA
Michael Thomas,1959-10-08,24,1978,2002,10,8,USA
Nyjer Jamid,1980-07-02,7,2007,2014,7,2,USA
Raymond Caryll,1889-06-14,7,1911,1918,6,14,USA
James Edward,1883-10-06,0,1906,1906,10,6,USA
Tom Stephen,1930-05-20,12,1951,1963,5,20,USA
Vernon Thomas,1928-08-08,1,1954,1955,8,8,USA
Meredith Goodwin,1937-01-16,1,1961,1962,1,16,USA
William Joseph,1883-08-24,0,1909,1909,8,24,USA
Edward Jerome,1912-10-12,1,1935,1936,10,12,USA
Eugene John,1863-01-06,8,1884,1892,1,6,USA
George Joseph,1885-07-07,13,1903,1916,7,7,USA
Michael Thomas,1974-03-08,0,2002,2002,3,8,USA
Juan Bautista,1983-11-05,3,2006,2009,11,5,D.R.
Shawn Peter,1992-11-20,0,2016,2016,11,20,USA
Michael William,1991-05-03,5,2014,2019,5,3,USA
John Glen,1947-11-22,1,1973,1974,11,22,USA
William M.,1890-01-23,0,1913,1913,1,23,USA
Alvin,1969-01-06,3,1996,1999,1,6,USA
Russell Lee,1962-04-28,11,1986,1997,4,28,USA
Justin Ernest George,1981-05-15,13,2003,2016,5,15,CAN
Maxwell Anthony,1993-05-13,3,2016,2019,5,13,USA
Daniel Joseph,1955-03-26,0,1983,1983,3,26,USA
Jeffrey Robert,1959-08-17,3,1984,1987,8,17,USA
James Francis,1883-12-04,6,1906,1912,12,4,USA
Reyes Armando,1993-01-06,2,2017,2019,1,6,D.R.
Willard Blackmer,1893-04-09,5,1926,1931,4,9,USA
Anthony Joseph,1986-12-01,0,2016,2016,12,1,USA
Akeel J.,1992-11-14,3,2015,2018,11,14,V.I.
William Lee,1894-11-21,5,1915,1920,11,21,USA
Avery Bryan,1987-03-28,5,2012,2017,3,28,USA
Joseph Harley,1892-04-19,3,1918,1921,4,19,USA
Danny Walker,1946-06-11,1,1968,1969,6,11,USA
Doyt Theodore,1916-07-15,0,1937,1937,7,15,USA
James R.,1860-12-29,0,1884,1884,12,29,USA
Edward,1862-09-29,6,1884,1890,9,29,USA
Walter Edward,1899-12-07,9,1922,1931,12,7,USA
Michael Joseph,1876-05-03,1,1901,1902,5,3,USA
Walter Guy,1895-08-29,1,1927,1928,8,29,USA
Stephen Henry,1866-05-22,0,1887,1887,5,22,USA
William Harold,1965-04-09,12,1988,2000,4,9,USA
John Albert,1876-05-02,1,1902,1903,5,2,USA
John Scott,1955-05-16,17,1977,1994,5,16,USA
James Forrest,1952-09-23,11,1977,1988,9,23,USA
James Samuel,1964-01-19,1,1999,2000,1,19,USA
John Francis,1855-02-19,14,1876,1890,2,19,USA
John J.,1856-12-30,0,1881,1881,12,30,USA
John Dewey,1895-10-22,10,1920,1930,10,22,USA
Joseph Anselm,1904-01-16,4,1932,1936,1,16,USA
John Wallace,1941-08-23,8,1966,1974,8,23,USA
John Daniel,1961-02-23,6,1986,1992,2,23,USA
Justis Logan,1987-08-25,9,2010,2019,8,25,USA
Matthew Christian,1974-08-09,11,1997,2008,8,9,USA
Michael,1867-02-06,3,1887,1890,2,6,USA
Peter R.,1854-01-01,0,1884,1884,1,1,United Kingdom
Philip Melvin,1894-10-18,0,1921,1921,10,18,USA
Thomas J.,1869-08-15,1,1895,1896,8,15,USA
John Walter,1880-01-31,0,1908,1908,1,31,USA
Warren Randall,1974-01-11,4,1999,2003,1,11,USA
Brandon John,1984-07-26,11,2007,2018,7,26,USA
Newell Obediah,1904-09-04,0,1929,1929,9,4,USA
Peter Raymond,1886-12-06,0,1911,1911,12,6,USA
Michael John,1982-03-22,12,2005,2017,3,22,USA
Clayton Grant,1985-04-10,4,2009,2013,4,10,USA
Wycliffe Nathaniel,1931-12-13,8,1961,1969,12,13,USA
Carl Wendle,1944-01-18,7,1969,1976,1,18,USA
Charles Hazen,1854-10-12,3,1882,1885,10,12,USA
Charles Alfred,1983-11-12,11,2008,2019,11,12,USA
Kristopher Colt,1982-04-10,1,2007,2008,4,10,USA
Guy,1893-06-01,10,1914,1924,6,1,USA
Guy,1930-11-04,0,1954,1954,11,4,USA
Kevin Joseph,1968-08-03,0,1991,1991,8,3,USA
William P.,1858-08-07,0,1884,1884,8,7,USA
Walter Joseph,1926-04-12,7,1954,1961,4,12,USA
Rosaire Allen,1945-02-15,2,1965,1967,2,15,USA
Guillermo Alejandro,1983-11-14,4,2009,2013,11,14,Venezuela
Jonathan Solomon,1991-08-15,1,2015,2016,8,15,USA
Lloyd Anthony,1959-11-05,11,1980,1991,11,5,USA
Robert Jonathan,1984-09-14,0,2009,2009,9,14,USA
Dustin Aaron,1981-12-26,6,2006,2012,12,26,USA
Earl Victor,1887-09-07,3,1913,1916,9,7,USA
Arnold Robert,1915-08-09,0,1937,1937,8,9,USA
Walter Frederick,1881-02-27,5,1906,1911,2,27,USA
Felix Inglesby,1853-05-13,NA,NA,NA,5,13,USA
Gerald Braheen,1946-08-09,10,1965,1975,8,9,USA
John William,1957-08-09,10,1982,1992,8,9,USA
Wallace,1910-10-08,16,1935,1951,10,8,USA
Paul Richard,1953-12-20,6,1977,1983,12,20,USA
William Bankhead,1878-12-20,0,1910,1910,12,20,USA
Daniel Ross,1986-04-28,0,2011,2011,4,28,USA
James Frederick,1905-08-21,4,1929,1933,8,21,USA
Julio Alberto,1972-01-29,9,1996,2005,1,29,Panama
Brandon Douglas,1983-09-16,10,2007,2017,9,16,USA
Charles Crosby,1911-03-20,2,1934,1936,3,20,USA
Damian Joseph,1976-11-24,3,2001,2004,11,24,Australia
Howard Glenn,1918-10-17,4,1942,1946,10,17,USA
Donald Louis,1929-01-11,11,1954,1965,1,11,USA
John Lester,1925-05-14,12,1946,1958,5,14,USA
Charles Malcolm,1905-04-18,0,1930,1930,4,18,USA
Earl Dalton,1925-07-21,0,1951,1951,7,21,USA
Raymond Earl,1901-12-05,5,1926,1931,12,5,USA
John Anthony,1896-06-01,11,1918,1929,6,1,USA
Andres Alberto,1966-03-04,0,1991,1991,3,4,D.R.
Daniel Avila,1975-10-09,0,2000,2000,10,9,D.R.
Guillermo,1973-07-25,13,1999,2012,7,25,D.R.
Jose Manuel,1965-03-16,4,1991,1995,3,16,D.R.
Manuel Rafael,1938-02-18,20,1962,1982,2,18,D.R.
Darryl DeWayne,1960-01-21,6,1981,1987,1,21,USA
Elisha Matthew,1918-06-12,0,1945,1945,6,12,USA
Jason Louis,1982-06-22,9,2008,2017,6,22,USA
Taylor Davis,1989-09-18,2,2016,2018,9,18,USA
Charles Edward,1971-10-15,10,1996,2006,10,15,USA
Curtell Howard,1940-09-24,7,1967,1974,9,24,USA
Frank H.,1869-10-01,4,1890,1894,10,1,USA
Glen Hubert,1917-09-28,2,1946,1948,9,28,USA
Albert Theodore,1886-01-16,0,1911,1911,1,16,USA
Anthony David,1975-02-08,0,2003,2003,2,8,USA
William Henry,1858-12-11,2,1883,1885,12,11,CAN
Frank Henry,1860-05-17,6,1880,1886,5,17,USA
Michael Christopher,1988-09-11,8,2011,2019,9,11,USA
James Raleigh,1968-12-29,7,1994,2001,12,29,USA
Lyle Joseph,1969-05-13,6,1995,2001,5,13,USA
Raymond Benjamin,1889-07-12,0,1913,1913,7,12,USA
Harry Harlan,1884-03-24,12,1905,1917,3,24,USA
Joseph Aloysius,1908-04-06,2,1933,1935,4,6,USA
Gabriel Jose,1995-01-09,1,2017,2018,1,9,Venezuela
Steven,1991-08-09,2,2014,2016,8,9,P.R.
Charles Edward,1885-08-15,0,1910,1910,8,15,USA
Jamie,1962-11-18,26,1986,2012,11,18,USA
Peter Michael,1978-12-02,12,2006,2018,12,2,Australia
Ronald Frank,1930-09-16,1,1954,1955,9,16,USA
Philip Ray,1937-01-12,0,1963,1963,1,12,USA
William Lawrence,1920-11-09,3,1942,1945,11,9,USA
William Richard,1971-03-17,10,1996,2006,3,17,USA
Donald Frederick,1927-04-14,11,1948,1959,4,14,USA
Joseph Gordon,1922-12-10,0,1950,1950,12,10,USA
Clarence Francis,1899-09-16,15,1920,1935,9,16,USA
Emmett Jerome,1912-07-20,3,1938,1941,7,20,USA
Leslie Clyde,1919-03-04,4,1941,1945,3,4,USA
Ray Coleman,1912-03-08,16,1935,1951,3,8,USA
Walter John,1894-12-06,4,1922,1926,12,6,USA
Willard Lawrence,1956-08-30,3,1978,1981,8,30,USA
Billy Arnold,1930-09-21,5,1957,1962,9,21,USA
Ignatius Andrew,1903-11-23,0,1924,1924,11,23,USA
Joseph Allen,1922-11-26,1,1951,1952,11,26,USA
Edward Jose,1984-05-10,11,2006,2017,5,10,Venezuela
Hugh Noyes,1913-09-09,12,1935,1947,9,9,USA
Mark Alan,1977-08-05,8,2000,2008,8,5,USA
Michael D.,1858-04-09,4,1882,1886,4,9,Ireland
Terence John,1963-03-09,20,1986,2006,3,9,USA
Anthony John,1859-01-30,13,1881,1894,1,30,Ireland
Martin,1852-08-22,0,1872,1872,8,22,USA
William John,1896-01-23,8,1920,1928,1,23,USA
Charles George,1889-03-15,6,1910,1916,3,15,USA
Conor Joseph,1988-02-25,0,2016,2016,2,25,USA
Frederick William,1907-12-21,1,1933,1934,12,21,USA
Gregory Thomas,1905-09-25,3,1930,1933,9,25,USA
Ford Parker,1917-02-09,0,1944,1944,2,9,USA
Kenneth Scott,1975-01-17,3,2000,2003,1,17,USA
Boyce Cedric,1994-10-01,1,2018,2019,10,1,USA
Richard Charles,1918-03-18,6,1941,1947,3,18,USA
Edward Joseph,1894-08-27,13,1915,1928,8,27,USA
Francis Joseph,1957-05-14,6,1980,1986,5,14,USA
George Joseph,1880-07-04,13,1902,1915,7,4,USA
Gregory Eugene,1971-12-13,0,1998,1998,12,13,USA
Henry J.,1862-04-17,0,1884,1884,4,17,CAN
James Henry,1877-01-09,1,1904,1905,1,9,USA
Joseph Ignatius,1913-07-31,0,1934,1934,7,31,USA
Patrick Joseph,1917-11-01,13,1940,1953,11,1,USA
Steven Rance,1956-01-15,15,1977,1992,1,15,USA
Sean Patrick,1970-04-25,0,1996,1996,4,25,USA
Dominic Joseph,1893-12-18,0,1921,1921,12,18,USA
Francis Joseph,1903-04-08,0,1930,1930,4,8,USA
Joseph H.,1858-10-27,12,1883,1895,10,27,USA
Kevin John,1985-05-26,1,2009,2010,5,26,USA
Jerry Wayne,1952-09-09,14,1974,1988,9,9,USA
John Louis,1857-11-18,0,1884,1884,11,18,USA
Jacob Ferdinand,1890-11-16,0,1918,1918,11,16,USA
Robert Cleveland,1916-01-28,14,1937,1951,1,28,USA
Maxwell Steven,1990-08-25,4,2015,2019,8,25,USA
George,1854-11-20,0,1884,1884,11,20,USA
William Edward,1889-06-28,0,1913,1913,6,28,USA
George David,1918-10-04,13,1943,1956,10,4,USA
Van Lingle,1911-06-08,14,1931,1945,6,8,USA
Carlos Javier,1981-03-12,1,2007,2008,3,12,USA
Manuel,1947-12-31,0,1971,1971,12,31,P.R.
Horatio Brinsmade,1851-07-26,0,1875,1875,7,26,USA
Scott Andrew,1958-12-05,0,1980,1980,12,5,USA
Leslie Ernest,1908-12-01,2,1934,1936,12,1,USA
Daniel Joseph,1989-02-09,0,2015,2015,2,9,USA
Andres Clemente,1999-01-16,0,2019,2019,1,16,Mexico
Arnaldo Rafel,1982-06-21,3,2004,2007,6,21,D.R.
Roberto,1968-03-03,8,1993,2001,3,3,P.R.
Jose Luis,1967-11-11,0,1996,1996,11,11,USA
Michael Anthony,1965-07-12,11,1989,2000,7,12,USA
Noe,1967-11-11,0,1995,1995,11,11,Mexico
Juan Oscar,1969-09-25,0,1995,1995,9,25,USA
Pedro Javier,1968-09-19,6,1990,1996,9,19,P.R.
Yairo,1995-01-23,1,2018,2019,1,23,D.R.
Peter Daniel,1975-06-14,5,1999,2004,6,14,USA
Eric Walter,1977-10-03,9,2000,2009,10,3,USA
Joseph Martin Napoleon,1899-11-06,1,1925,1926,11,6,USA
Clarence Hanford,1883-07-31,0,1905,1905,7,31,USA
Thurman Lee,1947-06-07,10,1969,1979,6,7,USA
Scott Michael,1980-03-07,2,2005,2007,3,7,USA
John Baird,1860-11-14,4,1887,1891,11,14,USA
Masanori,1944-05-06,1,1964,1965,5,6,Japan
Stephen Andrew,1955-02-12,7,1978,1985,2,12,USA
Toru,1985-05-20,0,2015,2015,5,20,Japan
Bobby Ray,1946-05-20,18,1965,1983,5,20,USA
Simeon Augustus,1880-11-21,4,1904,1908,11,21,USA
Thomas Malcolm,1896-10-08,3,1917,1920,10,8,USA
Wilbur Edwin,1875-03-14,0,1908,1908,3,14,USA
John Robert,1921-04-01,1,1956,1957,4,1,USA
Timothy Hayes,1851-06-04,12,1872,1884,6,4,USA
William Eugene,1944-05-07,0,1966,1966,5,7,USA
William R. W.,1981-05-09,2,2007,2009,5,9,USA
Robert J.,1866-12-26,0,1890,1890,12,26,USA
Robert Sylvester,1895-04-26,1,1918,1919,4,26,USA
Cornelius B.,1863-10-15,6,1884,1890,10,15,USA
Cornelius David,1870-11-01,1,1893,1894,11,1,USA
Daniel Joseph,1864-09-10,0,1892,1892,9,10,USA
Daniel Francis,1876-08-11,15,1900,1915,8,11,USA
David Francis,1876-05-04,0,1905,1905,5,4,USA
Daniel Francis,1942-08-23,10,1960,1970,8,23,USA
Dale Bryan,1956-03-12,17,1976,1993,3,12,USA
Daniel Lee,1964-09-18,0,1989,1989,9,18,USA
David Matthew,1981-10-18,9,2006,2015,10,18,USA
Daniel Thomas,1985-04-01,11,2008,2019,4,1,USA
Richard Lee,1931-10-25,0,1954,1954,10,25,USA
Donald Rex,1983-03-10,10,2004,2014,3,10,USA
Herbert Courtland,1886-12-18,0,1914,1914,12,18,USA
Dwayne Keith,1955-03-18,11,1978,1989,3,18,USA
Edward James,1877-01-12,5,1898,1903,1,12,USA
John Edward,1891-10-02,14,1912,1926,10,2,USA
Edward Joseph,1918-08-23,0,1942,1942,8,23,USA
Francis Patrick,1876-04-06,0,1901,1901,4,6,USA
Howard,1882-01-01,0,1909,1909,1,1,USA
Joseph Akin,1866-09-07,1,1886,1887,9,7,USA
John Patrick,1879-05-20,1,1902,1903,5,20,USA
John Joseph,1908-07-14,15,1932,1947,7,14,USA
John Ryan,1991-05-13,6,2013,2019,5,13,USA
Patrick Lawrence,1857-03-17,0,1891,1891,3,17,CAN
Leo Joseph,1889-01-07,0,1915,1915,1,7,USA
Michael Jerome,1888-08-19,4,1912,1916,8,19,USA
Morgan Edward,1867-02-14,11,1890,1901,2,14,USA
Patrick J.,1857-01-02,3,1887,1890,1,2,USA
Patrick Thomas,1958-11-28,NA,NA,NA,11,28,USA
Robert Albert,1960-05-26,10,1985,1995,5,26,USA
Sean Michael,1994-10-04,0,2019,2019,10,4,USA
Thomas Andrew,1945-12-30,11,1968,1979,12,30,USA
Thomas Christian,1979-08-27,1,2006,2007,8,27,USA
Thomas James,1991-04-03,4,2015,2019,4,3,USA
Walter Joseph,1907-09-27,0,1931,1931,9,27,USA
William H.,1864-03-23,0,1884,1884,3,23,USA
William Henry,1869-10-11,3,1894,1897,10,11,USA
Arlington John,1982-03-17,1,2007,2008,3,17,USA
Ambrose Joseph,1913-06-04,0,1936,1936,6,4,USA
William Allenwood,1893-09-06,0,1917,1917,9,6,USA
William Jeremiah,1864-04-13,NA,NA,NA,4,13,USA
Robert Hayes,1898-07-04,0,1923,1923,7,4,USA
Calvin Duane,1971-07-30,5,1999,2004,7,30,USA
Colton James,1990-04-22,1,2015,2016,4,22,USA
Dale Albert,1950-02-02,11,1974,1985,2,2,USA
Daniel Saffle,1973-11-21,1,1999,2000,11,21,USA
Edward Francis,1895-05-08,0,1917,1917,5,8,USA
Eddie Clarence,1956-02-24,20,1977,1997,2,24,USA
George King,1898-09-23,11,1922,1933,9,23,USA
Glenn Everett,1970-11-23,0,1996,1996,11,23,USA
Heath Robertson,1973-04-19,5,1997,2002,4,19,USA
James Oscar,1878-01-16,12,1902,1914,1,16,USA
James Francis,1894-12-31,0,1922,1922,12,31,USA
Joseph Ambrose,1920-11-11,0,1950,1950,11,11,USA
Larry,1953-04-01,5,1974,1979,4,1,USA
Matthew Michael,1970-09-26,0,1995,1995,9,26,USA
Jeremiah J.,1865-01-01,7,1884,1891,1,1,USA
Patrick Joseph,1897-07-18,0,1919,1919,7,18,USA
Raymond Lee,1917-10-12,6,1948,1954,10,12,USA
John Joseph,1884-03-04,11,1906,1917,3,4,USA
Richard Dale,1957-07-06,3,1980,1983,7,6,USA
Anthony Joseph,1904-04-30,0,1923,1923,4,30,USA
Ivan Augustus,1943-04-24,11,1963,1974,4,24,Panama
Daniel Edward,1917-10-08,10,1941,1951,10,8,USA
Matthew Henry,1981-10-03,4,2005,2009,10,3,USA
Anthony Joseph,1947-08-01,9,1969,1978,8,1,USA
Dennis Eugene,1943-12-25,0,1965,1965,12,25,USA
Harrison Scott,1992-03-03,1,2018,2019,3,3,USA
Joseph Anthony,1992-12-04,3,2016,2019,12,4,USA
Stanley Frank,1920-11-21,22,1941,1963,11,21,USA
William Daniel,1905-09-05,0,1932,1932,9,5,USA
Jeffrey Joseph,1963-06-21,4,1986,1990,6,21,USA
Neal Gordon,1980-08-25,1,2007,2008,8,25,USA
Paul,1889-06-24,7,1912,1919,6,24,USA
Ralph Ronald,1954-11-11,3,1982,1985,11,11,USA
Bernard James,1919-10-01,0,1944,1944,10,1,USA
Michael Cole,1968-12-08,17,1991,2008,12,8,USA
Alexander Dominick,1909-03-26,0,1940,1940,3,26,USA
Jeffrey Thomas,1966-12-20,3,1991,1994,12,20,USA
James J.,1851-06-13,NA,NA,NA,6,13,USA
George Edward,1914-06-14,9,1938,1947,6,14,USA
Glenn Calvin,1897-07-09,16,1920,1936,7,9,USA
Charles Solomon,1904-03-16,16,1925,1941,3,16,USA
James Albert,1863-10-22,7,1884,1891,10,22,USA
James Albert,1874-04-08,4,1896,1900,4,8,USA
William Harrison,1910-08-14,6,1935,1941,8,14,USA
Brett Allen,1980-08-17,11,2002,2013,8,17,USA
Elmer Glenn,1894-03-02,7,1915,1922,3,2,USA
George D.,1860-11-13,5,1884,1889,11,13,USA
Gregory Richard,1966-04-14,18,1987,2005,4,14,USA
Ralph Edward,1887-04-08,5,1910,1915,4,8,USA
Henry Harrison,1889-04-27,16,1909,1925,4,27,USA
James Xavier,1969-04-28,0,1996,1996,4,28,USA
Joseph William,1882-03-18,0,1905,1905,3,18,USA
Lynnwood Lincoln,1914-02-23,1,1938,1939,2,23,USA
Michael Stanley,1969-06-26,12,1995,2007,6,26,USA
Randall Kirk,1962-09-19,13,1985,1998,9,19,USA
Richard,1930-04-07,0,1956,1956,4,7,USA
Rodney Luther,1969-06-26,8,1996,2004,6,26,USA
Roderick Demond,1973-01-14,1,1996,1997,1,14,USA
William Bradford,1990-12-10,6,2013,2019,12,10,USA
Aaron Kenneth,1977-09-26,5,1999,2004,9,26,CAN
Robert Howard,1952-10-01,2,1976,1978,10,1,USA
Brian Shawn,1976-09-04,3,2005,2008,9,4,USA
Christopher William,1967-01-05,5,1990,1995,1,5,USA
Herman John,1887-11-19,2,1915,1917,11,19,USA
Xavier Clifford,1978-11-14,14,2000,2014,11,14,USA
Timothy James,1967-02-01,7,1990,1997,2,1,USA
William Taylor,1915-08-19,6,1939,1945,8,19,USA
Louis Marcellus,1887-06-29,0,1912,1912,6,29,USA
Russell Charles,1944-09-19,2,1968,1970,9,19,USA
Clinton Scott,1980-10-25,2,2004,2006,10,25,USA
Walter Harold,1880-03-10,0,1911,1911,3,10,USA
Thomas Edward,1865-10-30,1,1890,1891,10,30,USA
Charles Harrison,1967-05-05,13,1990,2003,5,5,USA
Michael Timothy,1948-03-25,5,1969,1974,3,25,USA
Stephen,1919-05-28,3,1947,1950,5,28,USA
Samuel Ralph,1915-10-19,10,1938,1948,10,19,USA
William Gerard,1953-08-31,8,1976,1984,8,31,USA
Micheal Yoshihide,1976-09-06,1,2003,2004,9,6,Japan
Norihiro,1973-07-24,0,2005,2005,7,24,Japan
Peter Ernest,1914-06-12,3,1936,1939,6,12,USA
Frank,1902-07-05,0,1924,1924,7,5,USA
William Gideon,1876-08-02,4,1897,1901,8,2,USA
Joseph Shane,1977-09-07,2,2002,2004,9,7,USA
Skelton Leroy,1889-12-18,9,1912,1921,12,18,USA
Aloysius Francis,1926-08-29,0,1949,1949,8,29,USA
Daniel,1942-01-11,1,1965,1966,1,11,USA
Michael Anthony,1981-10-31,11,2006,2017,10,31,USA
Tyler Wesley,1991-04-24,3,2016,2019,4,24,USA
Harold Richard,1928-10-01,11,1951,1962,10,1,USA
Lazaro Ramon Gonzalo,1934-11-25,0,1956,1956,11,25,Cuba
William Edward,1900-03-09,1,1929,1930,3,9,USA
Raymond Edmond,1928-11-25,5,1954,1959,11,25,USA
Jerry Austin,1956-01-15,8,1979,1987,1,15,USA
Samuel Woody,1913-08-25,8,1935,1943,8,25,USA
Samuel Franklin,1981-07-12,0,2004,2004,7,12,USA
Leslie Ferdinand,1940-11-16,4,1963,1967,11,16,USA
Omar David,1992-02-10,3,2016,2019,2,10,Venezuela
Christopher Gregg,1981-12-20,10,2006,2016,12,20,USA
William Mitchell,1865-06-24,14,1884,1898,6,24,USA
Charles Francis,1942-07-24,3,1967,1970,7,24,USA
James Edwin,1945-02-09,6,1966,1972,2,9,USA
Kenneth Leland,1888-07-14,2,1912,1914,7,14,USA
Philip,1955-03-08,2,1978,1980,3,8,USA
Robert Marcel,1965-11-13,5,1992,1997,11,13,USA
Joseph Michael,1974-11-22,17,1999,2016,11,22,USA
Joseph Paul,1978-09-28,0,2000,2000,9,28,USA
Peter Alphonsus,1931-09-09,0,1953,1953,9,9,USA
Daniel Donovan,1970-01-06,3,1996,1999,1,6,USA
Daniel James,1983-02-22,7,2010,2017,2,22,USA
Dioner Favian,1984-02-09,12,2004,2016,2,9,Venezuela
Efren,1986-05-14,7,2011,2018,5,14,USA
Jaime,1967-03-27,11,1989,2000,3,27,P.R.
Julio,1934-01-09,8,1962,1970,1,9,P.R.
Oswaldo Ramses,1984-10-02,4,2006,2010,10,2,Venezuela
Reynaldo,1989-12-22,0,2015,2015,12,22,P.R.
Norberto,1970-09-12,0,1993,1993,9,12,P.R.
Yamaico,1987-10-31,3,2010,2013,10,31,D.R.
Vincent P.,1850-04-12,4,1882,1886,4,12,USA
Earl Eugene,1919-05-19,4,1942,1946,5,19,USA
Joshua-Douglas James,1997-06-22,0,2019,2019,6,22,CAN
Roleine Cecil,1892-02-04,7,1917,1924,2,4,USA
Michael John,1917-08-26,5,1939,1944,8,26,USA
Dennis Edward,1968-09-13,12,1991,2003,9,13,USA
John Henry,1858-01-02,5,1879,1884,1,2,USA
Blaine,1978-04-06,4,2001,2005,4,6,USA
Charles Lenard,1931-01-30,7,1956,1963,1,30,USA
Alfred Earle,1891-11-05,8,1916,1924,11,5,USA
Joseph Hunt,1866-05-07,5,1886,1891,5,7,USA
Theophilus Fountain,1876-06-05,0,1905,1905,6,5,USA
James Joseph,1884-12-15,1,1906,1907,12,15,USA
Thomas Joseph,1987-08-17,1,2012,2013,8,17,USA
Zachary Sheridan,1988-11-09,2,2016,2018,11,9,USA
Ronald Andrew,1932-06-18,0,1952,1952,6,18,USA
Thomas Joseph,1879-04-17,10,1904,1914,4,17,Ireland
Troy Lee,1965-09-14,2,1992,1994,9,14,USA
Calvin Amandus,1929-02-18,6,1957,1963,2,18,USA
Douglas Williams,1891-10-08,1,1914,1915,10,8,USA
Ronald Alvin,1930-02-26,6,1952,1958,2,26,USA
Kristopher David,1986-02-01,7,2012,2019,2,1,USA
James Gilmore,1889-02-05,0,1912,1912,2,5,USA
Arthur Neukom,1892-07-31,14,1915,1929,7,31,USA
Gary Wayne,1944-10-29,4,1969,1973,10,29,USA
James Llewellyn,1964-09-24,0,1990,1990,9,24,USA
Alvin Edward,1939-03-26,0,1960,1960,3,26,USA
Robert Otis,1917-11-09,0,1939,1939,11,9,USA
Cecil Fleming,1880-09-23,0,1908,1908,9,23,USA
Michael Robert,1970-04-27,0,1998,1998,4,27,USA
Thomas White,1919-11-07,1,1946,1947,11,7,USA
Bernard Edmund,1895-09-26,7,1920,1927,9,26,USA
Ernest Frederick,1894-11-13,0,1921,1921,11,13,USA
Francis Joseph,1906-12-10,4,1929,1933,12,10,USA
Andrew Anthony,1884-11-30,0,1908,1908,11,30,USA
William F.,1863-09-28,0,1884,1884,9,28,USA
Bryant Lawrence,1974-01-27,0,2002,2002,1,27,USA
John Bradley,1982-12-23,1,2008,2009,12,23,USA
John W.,1849-03-14,18,1872,1890,3,14,USA
Christopher Lars,1985-09-03,4,2010,2014,9,3,USA
David Earl,1944-06-20,9,1968,1977,6,20,USA
George Emmett,1905-02-26,1,1935,1936,2,26,USA
Wayland Eugene,1960-12-03,12,1981,1993,12,3,USA
James Victor,1959-09-05,0,1983,1983,9,5,USA
Jeffrey Allan,1966-11-17,14,1992,2006,11,17,USA
James Lorin,1947-07-04,1,1970,1971,7,4,USA
James Jacob,1989-06-05,6,2013,2019,6,5,USA
Joseph George,1974-10-25,9,2001,2010,10,25,USA
John Clark,1979-03-03,0,2006,2006,3,3,USA
Luther Martin,1893-12-04,0,1919,1919,12,4,USA
Lynn Bernard,1905-02-24,10,1930,1940,2,24,USA
Melvin Frederick,1936-05-30,9,1960,1969,5,30,USA
Raymond,1875-08-04,0,1901,1901,8,4,USA
Albert Francis,1886-05-19,3,1910,1913,5,19,USA
Ricky Lee,1959-05-08,3,1983,1986,5,8,USA
Glenn Richard,1924-11-18,12,1949,1961,11,18,USA
Roger Eugene,1944-06-07,9,1967,1976,6,7,USA
Robert Augustus,1964-05-17,4,1986,1990,5,17,USA
Robert Sidney,1936-08-07,2,1955,1957,8,7,USA
Thomas Cousineau,1917-05-01,0,1945,1945,5,1,USA
Richard Leroy,1939-09-24,7,1963,1970,9,24,USA
Robert Allen,1969-11-28,9,1993,2002,11,28,USA
Hector,1989-06-14,5,2014,2019,6,14,D.R.
Angel Ladimir,1990-12-04,0,2015,2015,12,4,Venezuela
Patrick John,1980-09-04,13,2006,2019,9,4,USA
John Charles,1885-11-11,5,1911,1916,11,11,USA
Graig,1944-08-20,21,1967,1988,8,20,USA
James William,1947-03-02,11,1970,1981,3,2,USA
Morris,1952-01-26,1,1974,1975,1,26,USA
Miles Albion,1886-05-12,0,1909,1909,5,12,USA
Harold Charles,1902-05-13,0,1925,1925,5,13,USA
John Stein,1877-06-08,0,1907,1907,6,8,USA
Nickolas Donald,1980-07-15,1,2001,2002,7,15,USA
Daniel George,1948-03-09,0,1972,1972,3,9,USA
Michael David,1978-03-09,1,2003,2004,3,9,USA
John Henry,1900-10-28,6,1925,1931,10,28,USA
Otto Adam,1894-09-24,0,1917,1917,9,24,USA
Sheldon Lynn,1994-12-10,0,2019,2019,12,10,USA
Ernie Wyre,1919-08-17,3,1950,1953,8,17,USA
Dovydas,1993-01-14,2,2017,2019,1,14,Lithuania
Ernest Alonzo,1902-06-11,2,1926,1928,6,11,USA
Alexander Brown,1850-10-03,0,1873,1873,10,3,USA
Phillip Joseph,1971-01-19,11,1995,2006,1,19,USA
Christopher Jake,1994-11-20,1,2018,2019,11,20,USA
Donald,1926-06-14,11,1949,1960,6,14,USA
Sean William,1993-06-12,2,2017,2019,6,12,USA
John A.,1868-01-14,0,1891,1891,1,14,USA
George Washington,1855-01-05,0,1877,1877,1,5,USA
Thomas Dean,1963-05-17,0,1987,1987,5,17,USA
Marc Alexander,1972-10-19,5,1993,1998,10,19,USA
David Matthew,1973-09-07,9,1999,2008,9,7,USA
Donald Louis,1947-11-07,2,1972,1974,11,7,USA
Harold,1921-05-20,16,1939,1955,5,20,USA
Floyd Elmo,1908-07-16,0,1934,1934,7,16,USA
Joel Ivan,1896-06-01,1,1919,1920,6,1,USA
Maurice Milton,1914-06-22,1,1940,1941,6,22,USA
Albert Dwayne,1960-06-30,7,1985,1992,6,30,USA
Alan Spencer,1969-10-02,1,1999,2000,10,2,USA
Charles,1868-11-05,0,1892,1892,11,5,USA
Frederick William,1942-02-21,5,1962,1967,2,21,USA
Jeffrey Lynn,1948-09-11,8,1976,1984,9,11,USA
Joshua Paul,1982-06-11,1,2007,2008,6,11,USA
Kevin Bradley,1993-08-04,1,2018,2019,8,4,USA
Raymond Francis,1945-06-20,2,1971,1973,6,20,USA
Robert Albert,1880-12-10,1,1910,1911,12,10,USA
Louis Norman,1907-08-11,24,1929,1953,8,11,USA
Heber Hampton,1909-12-13,2,1941,1943,12,13,USA
Lamar Ashby,1910-10-18,12,1935,1947,10,18,USA
Warren Dale,1964-07-03,7,1991,1998,7,3,USA
Eustace James,1877-10-26,9,1900,1909,10,26,USA
Mpho' Gift,1990-01-18,1,2017,2018,1,18,South Africa
Constantine Gregory,1920-12-06,9,1946,1955,12,6,USA
Juan Ramon,1986-08-31,8,2011,2019,8,31,D.R.
Alfred Henry,1852-02-14,2,1875,1877,2,14,United Kingdom
Arthur Francis,1871-07-14,5,1898,1903,7,14,USA
William Beck,1914-12-11,17,1936,1953,12,11,USA
Brett James,1988-07-18,1,2016,2017,7,18,USA
Carl Edward,1962-10-14,5,1986,1991,10,14,USA
Chester Raymond,1897-07-03,6,1926,1932,7,3,USA
Chester Raymond,1931-02-22,13,1951,1964,2,22,USA
David Lawrence,1939-08-29,7,1960,1967,8,29,USA
Donald Leigh,1930-10-30,2,1952,1954,10,30,USA
Dolan Levon,1930-02-28,0,1958,1958,2,28,USA
Frank Collins,1889-08-29,0,1912,1912,8,29,USA
Fred,1894-09-01,5,1917,1922,9,1,USA
Kevin Ronald,1976-03-29,0,2000,2000,3,29,CAN
Charles Augustus,1869-09-14,16,1890,1906,9,14,USA
Ovid Edward,1888-12-30,0,1912,1912,12,30,USA
Thomas Clark,1863-04-14,7,1888,1895,4,14,USA
Thomas Reid,1958-08-05,7,1980,1987,8,5,USA
Roy,1921-03-03,0,1944,1944,3,3,USA
Rodney Lea,1964-12-29,7,1988,1995,12,29,USA
Samuel Anderson,1869-04-20,2,1888,1890,4,20,Ireland
Simon Burdette,1882-07-18,7,1903,1910,7,18,USA
Frederick C.,1850-07-26,7,1875,1882,7,26,USA
Christopher Thomas,1966-05-13,7,1995,2002,5,13,USA
Michael James,1983-02-13,3,2010,2013,2,13,CAN
Douglas Alan,1974-10-02,2,2000,2002,10,2,USA
George Edward,1870-10-17,4,1890,1894,10,17,USA
Hugh N.,1858-01-01,9,1881,1890,1,1,United Kingdom
Justin Brian,1991-11-22,2,2015,2017,11,22,USA
Steven Richard,1955-08-06,7,1978,1985,8,6,USA
Tomas E.,1994-04-12,2,2017,2019,4,12,P.R.
Charles Arthur,1899-05-23,3,1921,1924,5,23,USA
David Glen,1968-12-22,4,1992,1996,12,22,USA
Thomas Edward,1959-08-13,9,1981,1990,8,13,USA
Albert Bernard,1899-06-01,0,1925,1925,6,1,USA
Richard J.,1892-10-24,7,1913,1920,10,24,USA
John Albert,1884-05-13,5,1913,1918,5,13,USA
Joseph Franklin,1944-11-07,21,1967,1988,11,7,USA
Lance Joseph,1979-01-29,4,2003,2007,1,29,USA
Philip Henry,1939-04-01,23,1964,1987,4,1,USA
Gerald Arthur,1966-08-05,1,1992,1993,8,5,USA
Milton Robert,1925-02-08,2,1949,1951,2,8,USA
Jeffrey Scott,1958-12-18,3,1986,1989,12,18,USA
Robert Charles,1927-01-26,11,1951,1962,1,26,USA
Elmer Leroy,1918-02-08,2,1943,1945,2,8,USA
Jeffrey Warren,1983-02-28,4,2008,2012,2,28,USA
Randal Harold,1955-11-15,8,1979,1987,11,15,USA
Jacob Leland,1919-10-19,0,1943,1943,10,19,USA
Alfred Joseph,1911-05-18,2,1934,1936,5,18,USA
Jonathon Joseph,1986-10-27,8,2008,2016,10,27,USA
Charles Bassett,1942-09-24,0,1964,1964,9,24,USA
Adrian,1989-11-12,0,2014,2014,11,12,Cuba
Thomas Andrew,1960-10-27,6,1984,1990,10,27,USA
Kirk Robert,1987-08-07,5,2012,2017,8,7,USA
Fernando Alexis,1982-07-15,4,2006,2010,7,15,Venezuela
Jose Miguel,1975-06-16,4,1998,2002,6,16,Venezuela
Juan Manuel,1965-01-05,2,1986,1988,1,5,P.R.
Melvin,1971-12-28,6,1992,1998,12,28,P.R.
Wilbert,1977-09-25,13,2002,2015,9,25,P.R.
Fu-Te,1982-11-14,1,2009,2010,11,14,Taiwan
John Arnold,1903-07-10,8,1938,1946,7,10,USA
Thomas James,1870-04-14,0,1896,1896,4,14,USA
William E.,1867-01-11,0,1895,1895,1,11,USA
Herbert Clyde,1880-09-10,4,1906,1910,9,10,USA
George Charles,1881-07-14,4,1904,1908,7,14,USA
David Wayne,1969-12-14,7,1992,1999,12,14,Australia
Brandon Tate,1993-03-27,3,2016,2019,3,27,USA
Albert Samuel,1959-04-02,7,1983,1990,4,2,USA
Dustin David,1981-05-06,5,2005,2010,5,6,USA
Merlin Lee,1938-09-01,0,1962,1962,9,1,USA
Ronald Lee,1937-07-01,4,1961,1965,7,1,USA
Tsuyoshi,1984-07-27,1,2011,2012,7,27,Japan
Otho James,1908-09-13,0,1945,1945,9,13,USA
Christopher John,1973-03-09,10,1995,2005,3,9,USA
Ramon A.,1980-02-22,2,2003,2005,2,22,D.R.
Jayson Truitt Edward,1982-08-26,6,2008,2014,8,26,USA
Jacob James,1996-01-09,0,2018,2018,1,9,USA
Laynce Michael,1980-10-30,10,2003,2013,10,30,USA
Albert Richard,1886-04-11,13,1915,1928,4,11,USA
Robert Donell,1961-12-31,3,1987,1990,12,31,USA
Otis Junior,1959-01-09,16,1983,1999,1,9,USA
Russell Eugene,1935-02-19,11,1957,1968,2,19,USA
Christopher Trotman,1974-04-11,12,1996,2008,4,11,USA
Willard Lee,1928-06-17,8,1950,1958,6,17,USA
Rafael Miguel,1919-03-15,2,1951,1953,3,15,Cuba
Milciades Arturo,1964-11-10,10,1984,1994,11,10,D.R.
Paul David,1959-12-16,3,1987,1990,12,16,USA
Jablonski Rico,1989-01-11,0,2015,2015,1,11,USA
Hector,1987-01-26,8,2011,2019,1,26,D.R.
George Washington,1859-08-24,0,1884,1884,8,24,USA
Stephen James,1995-01-11,0,2019,2019,1,11,USA
Matthew Dodge,1963-10-31,10,1985,1995,10,31,USA
Aaron Michael,1993-06-04,4,2015,2019,6,4,USA
Austin Kyle,1989-12-28,0,2019,2019,12,28,USA
Gary Lynn,1948-05-27,10,1967,1977,5,27,USA
Joseph William,1951-05-12,13,1972,1985,5,12,USA
Edward Sylvester,1855-11-07,7,1878,1885,11,7,CAN
Carlos Enrique,1982-12-13,11,2006,2017,12,13,USA
Richard Louis,1943-05-04,0,1967,1967,5,4,USA
Dickie Ray,1956-11-19,11,1979,1990,11,19,USA
Sean Patrick,1989-12-26,2,2013,2015,12,26,USA
Jacob,1994-03-08,0,2019,2019,3,8,USA
Eric Carl,1964-04-28,4,1987,1991,4,28,USA
Hideo,1968-08-31,13,1995,2008,8,31,Japan
Takahito,1969-01-10,0,2002,2002,1,10,Japan
Leo William,1911-07-07,7,1933,1940,7,7,USA
Nicholas Murphy,1989-05-04,3,2013,2016,5,4,USA
Peter John,1881-11-24,3,1904,1907,11,24,USA
Jeremiah Henry,1875-06-23,5,1896,1901,6,23,USA
Jordan,1986-12-08,2,2010,2012,12,8,D.R.
Timothy Charles,1949-07-07,5,1974,1979,7,7,USA
Wayne Oren,1948-07-04,7,1976,1983,7,4,USA
Louis Ellis,1876-08-07,0,1906,1906,8,7,USA
Irving Arnold,1924-11-29,10,1950,1960,11,29,USA
John Alan,1943-12-20,1,1969,1970,12,20,USA
Henry Willis Patrick,1910-07-16,1,1931,1932,7,16,USA
Daniel Edmund,1955-01-11,5,1977,1982,1,11,USA
Fredie Hubert,1942-08-20,18,1962,1980,8,20,USA
Leslie Eugene,1969-02-25,1,1995,1996,2,25,USA
Nelson Augusto,1958-05-23,9,1978,1987,5,23,D.R.
David Stefan,1985-03-02,9,2009,2018,3,2,USA
Daniel David,1993-04-25,5,2014,2019,4,25,USA
Derek Russell,1989-02-14,5,2012,2017,2,14,USA
James Francis,1948-12-20,3,1977,1980,12,20,USA
Leo John,1908-05-17,1,1936,1937,5,17,USA
Michael Kelvin,1955-03-19,15,1975,1990,3,19,USA
William Alex,1948-05-15,10,1971,1981,5,15,USA
Hubbard Edwin,1886-08-16,2,1910,1912,8,16,USA
George Howard,1888-03-05,1,1918,1919,3,5,USA
James Thomas,1939-11-24,11,1964,1975,11,24,USA
Louis Alexander,1891-06-15,11,1913,1924,6,15,USA
Ronald James,1920-04-26,15,1942,1957,4,26,USA
Scott Richard,1946-10-15,0,1969,1969,10,15,USA
Elisha Strong,1873-08-17,1,1896,1897,8,17,USA
Frank Prescott,1845-06-09,0,1871,1871,6,9,USA
Gregory Blakemoor,1972-07-06,13,1996,2009,7,6,USA
Phillip Douglas,1976-02-01,4,2000,2004,2,1,USA
Thomas John,1950-04-26,0,1972,1972,4,26,USA
James K.,1993-12-24,1,2018,2019,12,24,USA
Willie,1950-11-07,3,1977,1980,11,7,USA
Randall William,1967-01-08,1,1989,1990,1,8,USA
Joseph Rudolph,1940-11-08,6,1964,1970,11,8,USA
Donald Edward,1936-01-23,9,1960,1969,1,23,USA
Jacob Andrew,1995-04-03,1,2018,2019,4,3,USA
Chester Linwood,1887-08-07,0,1909,1909,8,7,USA
Ivan Manuel,1987-01-12,9,2010,2019,1,12,D.R.
Louis Alexander,1915-10-12,5,1941,1946,10,12,USA
Rafael Angel,1967-10-26,3,1990,1993,10,26,USA
Roberto,1979-08-15,2,2004,2006,8,15,D.R.
Ralph Joseph,1924-08-05,0,1949,1949,8,5,USA
Winfield Charles,1889-06-16,6,1913,1919,6,16,USA
Leslie Grant,1889-01-25,11,1911,1922,1,25,USA
Abraham Orlando,1976-03-16,11,1997,2008,3,16,D.R.
Abraham,1977-02-05,2,2002,2004,2,5,D.R.
Dominic Manuel,1995-01-17,0,2019,2019,1,17,USA
Edwin,1963-05-27,12,1982,1994,5,27,P.R.
Eduardo Michelle,1987-06-15,9,2010,2019,6,15,D.R.
Franklin,1977-01-18,1,2004,2005,1,18,D.R.
Jhonny J.,1985-11-26,0,2009,2009,11,26,D.R.
Jose,1964-01-13,3,1987,1990,1,13,D.R.
Jose Antonio,1979-03-14,1,2001,2002,3,14,D.R.
Juan Carlos,1982-03-15,9,2005,2014,3,15,D.R.
Renato Rafael,1994-04-04,3,2016,2019,4,4,Venezuela
Vladimir,1975-03-15,11,1998,2009,3,15,Cuba
Jonathan Keith,1971-11-09,5,1995,2000,11,9,USA
Talmadge Raphael,1975-04-09,0,2000,2000,4,9,USA
Howard Ralph,1935-10-18,3,1959,1962,10,18,USA
Vidal Vicente,1987-07-26,5,2013,2018,7,26,USA
William Emory,1859-11-02,0,1884,1884,11,2,USA
Everett Clarence,1893-08-27,0,1919,1919,8,27,USA
Joseph Henry,1928-07-30,22,1944,1966,7,30,USA
Charles Reiff,1870-07-01,0,1895,1895,7,1,USA
Richard Raymond,1944-08-04,4,1966,1970,8,4,USA
Ryan Craig,1973-06-24,1,1997,1998,6,24,USA
Christopher Curtis,1955-06-06,1,1982,1983,6,6,USA
Gerald Smith,1942-11-23,2,1968,1970,11,23,USA
Nyls Wallace Rex,1954-03-07,3,1974,1977,3,7,USA
Ennis Telfair,1883-12-17,6,1909,1915,12,17,USA
Trevor Scott,1993-03-26,0,2018,2018,3,26,USA
Henry Kawaihoa,1910-01-22,11,1934,1945,1,22,USA
Johnny Lane,1946-01-21,11,1970,1981,1,21,USA
Sherman Omar,1970-01-23,4,1993,1997,1,23,Panama
Henry A.,1858-05-17,1,1883,1884,5,17,USA
Scott Michael,1990-03-13,4,2015,2019,3,13,USA
Brett R.,1989-07-01,3,2013,2016,7,1,USA
Kenneth Ray,1956-05-04,15,1977,1992,5,4,USA
Hartman Louis,1864-05-12,0,1888,1888,5,12,USA
Frank Rufus,1876-03-29,4,1906,1910,3,29,USA
Wesley Mitchell,1976-12-22,5,2002,2007,12,22,USA
Preston Michael,1954-04-20,6,1979,1985,4,20,USA
James Thomas,1949-09-13,0,1978,1978,9,13,USA
William Smith,1860-03-14,6,1884,1890,3,14,USA
Robert Allen,1949-04-23,0,1971,1971,4,23,USA
Thomas Joseph,1882-05-09,2,1911,1913,5,9,USA
Charles Hugh,1960-05-01,15,1985,2000,5,1,USA
William Darby,1863-09-01,5,1887,1892,9,1,USA
John F.,1867-04-15,3,1888,1891,4,15,USA
Daniel Joques,1954-04-22,1,1978,1979,4,22,USA
Frank Aloysius,1894-09-13,0,1923,1923,9,13,USA
Edward Joseph,1930-12-11,5,1953,1958,12,11,USA
George Joseph,1889-11-04,0,1915,1915,11,4,USA
John K.,1860-06-12,8,1882,1890,6,12,USA
John Joseph,1873-02-05,4,1899,1903,2,5,USA
John E.,1851-10-22,0,1884,1884,10,22,USA
John Joseph,1866-07-13,8,1891,1899,7,13,CAN
John Thomas,1930-12-11,6,1953,1959,12,11,USA
Peter James,1867-06-16,3,1887,1890,6,16,USA
Peter J.,1877-06-17,6,1901,1907,6,17,USA
Peter Michael,1958-02-09,11,1982,1993,2,9,USA
Peter Robert,1990-07-15,4,2015,2019,7,15,USA
Raymond Joseph,1894-10-31,0,1916,1916,10,31,USA
Sydney Lloyd,1944-02-18,3,1969,1972,2,18,USA
Thomas H.,1860-06-22,8,1882,1890,6,22,USA
Thomas J.,1873-02-20,3,1897,1900,2,20,USA
Thomas Edward,1918-12-19,7,1943,1950,12,19,USA
Alex,1972-03-29,7,1995,2002,3,29,USA
Ivan G.,1982-12-16,0,2008,2008,12,16,Venezuela
Walter Andrew,1920-01-04,0,1944,1944,1,4,USA
Harold David,1912-03-17,0,1935,1935,3,17,USA
Andrew James,1884-09-14,0,1908,1908,9,14,USA
Brian Michael,1977-01-04,0,2000,2000,1,4,USA
Daniel Cornelius,1868-08-11,0,1890,1890,8,11,CAN
Daniel Francis,1929-01-21,12,1950,1962,1,21,USA
Francis Henry,1868-09-15,0,1893,1893,9,15,USA
John Joseph,1866-06-02,23,1887,1910,6,2,USA
Jack William,1958-06-02,6,1981,1987,6,2,USA
James Joseph,1901-02-11,1,1923,1924,2,11,USA
John Joseph,1872-05-16,11,1891,1902,5,16,Ireland
John Charles,1891-12-01,0,1916,1916,12,1,Ireland
John Charles,1904-06-13,1,1928,1929,6,13,USA
Michael Patrick,1980-08-17,5,2006,2011,8,17,USA
Patrick H.,1861-06-10,0,1886,1886,6,10,USA
Patrick Francis,1879-08-04,10,1908,1918,8,4,Ireland
Darren Christopher,1982-10-22,11,2008,2019,10,22,USA
Henry M.,1859-07-08,6,1884,1890,7,8,USA
James Kenneth,1913-03-16,11,1935,1946,3,16,USA
Paul,1920-07-03,1,1944,1945,7,3,USA
William Oliver,1933-02-10,13,1954,1967,2,10,USA
Theodore Joseph,1902-01-04,1,1921,1922,1,4,USA
Johnny Lee,1945-05-29,12,1964,1976,5,29,USA
David Everett,1918-06-05,0,1943,1943,6,5,USA
Herman Boyd,1900-10-13,0,1925,1925,10,13,USA
George Dana,1929-05-27,0,1954,1954,5,27,USA
Harry Herman,1894-04-02,0,1927,1927,4,2,USA
John Eugene,1939-10-07,8,1963,1971,10,7,USA
John Preston,1969-05-26,0,1993,1993,5,26,USA
Jacob Todd,1990-03-27,7,2012,2019,3,27,USA
Rougned Roberto,1994-02-03,5,2014,2019,2,3,Venezuela
Francis Joseph,1897-03-04,15,1919,1934,3,4,USA
Frederick William,1872-09-25,3,1904,1907,9,25,USA
Bryan Alois,1961-03-11,3,1983,1986,3,11,Spain
Trent Carl Wayne,1983-02-28,2,2009,2011,2,28,Australia
Charles Frank,1931-03-12,0,1958,1958,3,12,USA
Joseph Carl,1892-05-24,11,1914,1925,5,24,USA
Ronald John,1956-05-05,12,1978,1990,5,5,USA
Robert Arthur,1896-10-19,20,1915,1935,10,19,USA
Jose Antonio,1968-11-08,15,1990,2005,11,8,D.R.
Rowland Johnie,1952-10-25,11,1972,1983,10,25,USA
Eric George,1985-02-05,11,2006,2017,2,5,USA
Alexi,1983-10-05,8,2010,2018,10,5,D.R.
Nefi Ismael,1989-06-03,1,2015,2016,6,3,D.R.
Warren Harvey,1901-01-24,4,1922,1926,1,24,USA
John Mahlon,1897-11-05,14,1918,1932,11,5,USA
Chad Wayne,1970-11-09,5,1994,1999,11,9,USA
James Dorn,1905-08-10,0,1936,1936,8,10,USA
Benjamin Ambrosio,1949-02-11,15,1971,1986,2,11,Panama
Brian,1992-05-17,0,2019,2019,5,17,USA
Christopher Ryan,1990-04-17,1,2017,2018,4,17,USA
Ambrose Francis,1912-02-17,1,1936,1937,2,17,USA
Joseph Anthony,1906-11-20,0,1925,1925,11,20,USA
Patrick Henry,1869-09-30,10,1892,1902,9,30,USA
Gregory Joseph,1968-05-21,0,1994,1994,5,21,CAN
William Alexander,1881-08-14,1,1909,1910,8,14,CAN
James Francis,1875-12-19,0,1904,1904,12,19,USA
Thomas Francis,1880-07-13,1,1906,1907,7,13,USA
Ryan Patrick,1993-07-26,1,2018,2019,7,26,USA
Tomokazu,1976-03-18,10,1999,2009,3,18,Japan
Curtis Ross,1982-08-08,9,2007,2016,8,8,USA
Joseph Earl,1888-01-10,0,1909,1909,1,10,USA
Michael Livingston,1990-12-14,0,2017,2017,12,14,USA
William McDaniel,1977-08-13,12,2000,2012,8,13,Germany
Kevin Arthur,1971-04-13,0,2003,2003,4,13,USA
Seunghwan,1982-07-15,3,2016,2019,7,15,South Korea
Shohei,1994-07-05,1,2018,2019,7,5,Japan
Kirt Stanley,1968-12-24,2,1997,1999,12,24,USA
Octavio Augie,1974-12-20,10,2000,2010,12,20,USA
Robert Michael,1957-12-17,14,1980,1994,12,17,USA
Miguel Arturo,1975-01-29,3,2003,2006,1,29,Mexico
Hideki,1975-12-25,6,2007,2013,12,25,Japan
Steven Chandler,1991-07-09,2,2016,2018,7,9,USA
Frank Anthony,1896-10-27,0,1920,1920,10,27,USA
Leonard Joseph,1923-07-16,4,1948,1952,7,16,USA
James Bentley,1963-02-21,0,1991,1991,2,21,USA
David,1864-12-18,3,1883,1886,12,18,USA
John Hardin,1932-11-06,0,1956,1956,11,6,USA
John Cyrus,1893-07-15,12,1914,1926,7,15,USA
Robert Carl,1928-01-05,10,1953,1963,1,5,USA
Reuben Henry,1884-05-30,13,1905,1918,5,30,USA
Charles Timothy,1875-10-15,30,1904,1934,10,15,USA
Daniel,1856-10-22,5,1879,1884,10,22,USA
Troy Franklin,1969-08-04,10,1993,2003,8,4,USA
John Garrett,1968-08-05,16,1989,2005,8,5,USA
Franklin Walter,1860-01-09,1,1884,1885,1,9,USA
Steven Robert,1965-10-04,3,1989,1992,10,4,USA
Edward,1938-11-05,1,1960,1961,11,5,P.R.
Jose,1971-03-03,1,1994,1995,3,3,D.R.
Omar,1967-07-06,11,1990,2001,7,6,P.R.
Tony Pedro,1938-07-20,14,1962,1976,7,20,Cuba
Albert,1946-10-14,17,1968,1985,10,14,USA
Andrew Allen,1987-12-03,1,2010,2011,12,3,USA
Robert Lee,1943-02-08,10,1965,1975,2,8,USA
David Jacob,1951-04-07,0,1977,1977,4,7,USA
Darren Christopher,1970-10-06,20,1993,2013,10,6,USA
Francisco Javier,1963-01-31,3,1989,1992,1,31,P.R.
Eugene George,1935-03-22,10,1959,1969,3,22,USA
Hector,1985-04-05,1,2015,2016,4,5,Cuba
Joseph Melton,1965-07-24,12,1989,2001,7,24,USA
Lester Jesus,1988-05-28,3,2011,2014,5,28,Venezuela
Nathaniel,1940-12-13,6,1963,1969,12,13,USA
Thomas Noble,1903-01-15,3,1930,1933,1,15,USA
Federico Emilio,1928-03-18,5,1961,1966,3,18,D.R.
Diomedes Antonio,1919-01-22,3,1960,1963,1,22,D.R.
Miguel Eduardo,1978-07-15,12,2002,2014,7,15,D.R.
James Donald,1945-07-08,1,1966,1967,7,8,USA
Rainer Gustavo,1981-05-31,9,2003,2012,5,31,Venezuela
Luis Francisco,1919-08-11,8,1943,1951,8,11,P.R.
Edgar,1990-04-12,2,2013,2015,4,12,USA
Alan Ray,1957-03-18,0,1980,1980,3,18,USA
Frederic William,1881-07-03,3,1908,1911,7,3,USA
Henry Theodore,1879-01-12,0,1905,1905,1,12,USA
Bernard Charles,1919-09-11,0,1941,1941,9,11,USA
Kevin Gary,1976-07-26,2,2001,2003,7,26,USA
Arthur Ole,1894-09-12,1,1922,1923,9,12,USA
Scott Matthew,1984-01-12,5,2005,2010,1,12,USA
Vern Jarl,1918-03-16,7,1939,1946,3,16,USA
Garrett Andrew,1983-10-18,5,2007,2012,10,18,USA
Greggory William,1966-10-11,13,1988,2001,10,11,USA
Gregory William,1960-09-06,4,1989,1993,9,6,USA
Ivan Massie,1885-10-14,13,1911,1924,10,14,USA
Karl Arthur,1930-07-06,6,1951,1957,7,6,USA
Marvin Clement,1907-05-28,2,1931,1933,5,28,USA
Matthew Kent,1994-03-29,3,2016,2019,3,29,USA
Theodore Otto,1912-08-27,2,1936,1938,8,27,USA
Timothy Lane,1978-08-01,1,2004,2005,8,1,USA
Tyler Ray,1989-10-02,4,2015,2019,10,2,USA
Michael George,1988-08-27,3,2012,2015,8,27,USA
Edward R.,1958-05-28,2,1986,1988,5,28,USA
Ryan Joseph,1980-04-09,0,2006,2006,4,9,USA
Shawn Michael,1987-12-28,2,2014,2016,12,28,USA
Thomas Patrick,1960-12-25,8,1982,1990,12,25,USA
Walter Francis,1903-10-09,NA,NA,NA,10,9,USA
Oliver Edward,1891-03-08,7,1912,1919,3,8,USA
Thomas Edward,1872-12-12,1,1895,1896,12,12,USA
Brian Scott,1984-04-26,1,2012,2013,4,26,USA
Logan Jared,1985-02-13,6,2010,2016,2,13,USA
Randall Jeffrey,1960-08-30,6,1984,1990,8,30,USA
Oran Herbert,1899-05-02,2,1925,1927,5,2,USA
William John,1880-01-22,2,1904,1906,1,22,CAN
Dennis,1866-11-22,0,1893,1893,11,22,USA
Edward J.,1870-05-19,0,1890,1890,5,19,USA
Robert Emmett,1918-01-13,3,1943,1946,1,13,USA
Joseph Henry,1897-02-10,1,1922,1923,2,10,CAN
Harry Mink,1917-05-08,0,1939,1939,5,8,USA
Hugh,1856-04-12,0,1875,1875,4,12,USA
John Joseph,1873-01-10,4,1902,1906,1,10,Ireland
James Leo,1893-02-23,3,1920,1923,2,23,USA
John Francis,1920-04-19,0,1946,1946,4,19,USA
Michael Joyce,1877-09-07,6,1901,1907,9,7,Ireland
George Michael,1898-04-12,8,1919,1927,4,12,USA
Paul Andrew,1963-02-25,16,1985,2001,2,25,USA
Philip Bernard,1879-08-30,0,1904,1904,8,30,USA
Stephen Francis,1891-07-06,17,1911,1928,7,6,USA
James Edward,1860-05-15,9,1883,1892,5,15,CAN
Tyler Alan,1995-06-22,1,2018,2019,6,22,CAN
Manuel Dominguez,1908-10-24,0,1935,1935,10,24,USA
Edward Joseph,1893-02-17,15,1912,1927,2,17,USA
John James,1888-10-13,5,1912,1917,10,13,USA
Steven Robert,1951-10-26,7,1973,1980,10,26,USA
Steven,1961-03-05,15,1985,2000,3,5,USA
Jose Manuel,1963-07-04,12,1983,1995,7,4,P.R.
Michael Lee,1968-05-30,6,1993,1999,5,30,USA
Ernest Eugene,1932-01-24,1,1955,1956,1,24,USA
Luis Javier,1975-08-12,9,1997,2006,8,12,Venezuela
Antonio,1918-10-30,0,1943,1943,10,30,Cuba
Magglio,1974-01-28,14,1997,2011,1,28,Venezuela
Reynaldo,1971-01-11,8,1996,2004,1,11,Cuba
Joseph Charles,1914-11-29,6,1939,1945,11,29,USA
Nathan,1990-02-01,0,2018,2018,2,1,USA
Kevin Leonard,1972-09-01,5,1997,2002,9,1,USA
Donald Lee,1945-03-12,1,1969,1970,3,12,USA
Paulo Roberto,1985-11-01,3,2015,2018,11,1,Brazil
George William,1891-09-16,0,1920,1920,9,16,USA
Jesse Walworth Thayer,1881-01-15,0,1907,1907,1,15,USA
Edilberto,1971-11-23,3,2001,2004,11,23,Cuba
Jesse Russell,1957-04-21,24,1979,2003,4,21,USA
James Patrick,1937-06-22,0,1959,1959,6,22,USA
James Francis,1891-11-28,19,1912,1931,11,28,CAN
James Henry,1850-09-01,32,1872,1904,9,1,USA
John W.,1849-08-23,4,1879,1883,8,23,USA
Joseph Leo,1904-10-28,0,1929,1929,10,28,USA
Michael Joseph,1868-09-01,0,1890,1890,9,1,USA
Joseph Leo,1881-04-13,0,1908,1908,4,13,USA
James Stephen,1883-12-26,0,1908,1908,12,26,USA
Ryan Patrick,1988-04-30,4,2015,2019,4,30,USA
Timothy Patrick,1864-05-18,4,1890,1894,5,18,USA
William John,1891-04-22,1,1913,1914,4,22,USA
David L.,1859-09-29,7,1883,1890,9,29,USA
Forrest Gordon,1917-03-06,2,1943,1945,3,6,USA
Peterson Thomas Gordon,1979-06-08,8,2005,2013,6,8,CAN
Ernest Ralph,1902-09-08,8,1927,1935,9,8,USA
John Joseph,1938-04-22,6,1961,1967,4,22,USA
Joseph Michael,1962-05-31,14,1983,1997,5,31,USA
Jorge,1950-11-26,15,1972,1987,11,26,Mexico
Anthony Yoel,1985-08-24,0,2009,2009,8,24,Venezuela
William,1975-07-24,0,2001,2001,7,24,Cuba
Jose Antonio,1988-10-12,2,2012,2014,10,12,Venezuela
Filomeno Coronada,1939-10-07,9,1960,1969,10,7,USA
Rafael Angel,1991-05-15,7,2012,2019,5,15,Venezuela
Frank Joseph,1951-02-24,0,1973,1973,2,24,USA
Albert Lewis,1872-09-05,14,1895,1909,9,5,USA
Oliverio,1919-12-05,0,1944,1944,12,5,Cuba
David Americo,1975-11-18,19,1997,2016,11,18,D.R.
Daniel,1990-01-05,0,2017,2017,1,5,P.R.
Hector,1969-10-14,4,1998,2002,10,14,P.R.
Javier Victor,1963-01-22,1,1990,1991,1,22,USA
Jose Luis,1947-06-25,2,1969,1971,6,25,P.R.
Jose Daniel,1977-06-13,2,2000,2002,6,13,D.R.
Joseph,1990-08-13,0,2013,2013,8,13,Venezuela
Adalberto,1959-10-24,12,1982,1994,10,24,P.R.
Luis Alberto,1970-05-25,3,1993,1996,5,25,D.R.
Luis Francisco,1995-09-22,1,2018,2019,9,22,USA
Ramon Diogenes,1973-05-23,14,1999,2013,5,23,D.R.
Roberto Gonzalo,1915-06-30,9,1941,1950,6,30,Cuba
Russell Reid,1974-06-05,12,1998,2010,6,5,USA
Daniel David,1981-05-11,3,2005,2008,5,11,USA
John Andrew,1965-12-08,4,1989,1993,12,8,USA
Chad Robert,1980-10-01,2,2005,2007,10,1,USA
Oswald Christian,1900-11-17,1,1928,1929,11,17,USA
John Bode,1903-04-17,6,1925,1931,4,17,USA
Larry Sidney,1935-10-12,6,1957,1963,10,12,USA
Donovan Alan,1969-06-21,12,1992,2004,6,21,USA
Wilferd Pearl,1883-11-28,2,1907,1909,11,28,USA
Danny Leon,1946-06-19,0,1975,1975,6,19,USA
Earnest Preston,1893-04-09,3,1922,1925,4,9,USA
Wayne Harold,1912-10-11,1,1935,1936,10,11,USA
Larry Patrick,1949-05-04,1,1974,1975,5,4,USA
Charles Benjamin,1926-11-23,0,1944,1944,11,23,USA
Joshua Michael,1988-09-03,4,2015,2019,9,3,USA
Keith Richard,1968-10-22,9,1996,2005,10,22,USA
Daniel,1933-11-17,8,1962,1970,11,17,USA
Franquelis Antonio,1981-09-12,3,2005,2008,9,12,D.R.
Henry Girard,1881-04-12,4,1904,1908,4,12,USA
James Champlin,1877-02-24,6,1903,1909,2,24,USA
Claude Wilson,1939-08-09,18,1957,1975,8,9,USA
Milton Darrell,1943-02-14,5,1965,1970,2,14,USA
Frederick K.,1892-08-05,0,1914,1914,8,5,USA
William Charles,1933-01-02,0,1954,1954,1,2,USA
Frederick Raymond,1907-09-15,14,1934,1948,9,15,USA
Roy Lund,1896-05-16,0,1921,1921,5,16,USA
James Michael,1977-04-07,1,2001,2002,4,7,USA
Brian Leonard,1949-06-17,0,1973,1973,6,17,CAN
John Thaddeus,1917-10-17,7,1943,1950,10,17,USA
Joseph Paul,1916-11-15,4,1948,1952,11,15,USA
Sean Daniel,1987-09-01,7,2009,2016,9,1,USA
Alfonso,1965-08-10,6,1990,1996,8,10,USA
Antonio Pedro,1973-04-12,10,1995,2005,4,12,Mexico
Jose Gregorio,1992-12-12,2,2017,2019,12,12,Venezuela
Roberto,1995-02-07,4,2015,2019,2,7,Mexico
Corey Edward,1993-09-03,1,2018,2019,9,3,USA
Roy Edward,1977-08-29,12,2001,2013,8,29,USA
Willis Alexander,1973-04-19,1,1998,1999,4,19,D.R.
Daniel Anthony,1985-02-19,7,2012,2019,2,19,USA
Regino Jose,1915-09-07,0,1945,1945,9,7,Cuba
Ricardo,1972-04-15,2,1995,1997,4,15,P.R.
William Tilford,1886-12-16,4,1907,1911,12,16,USA
Amos Joseph,1947-04-26,17,1967,1984,4,26,USA
Paul Franklin,1889-12-24,0,1912,1912,12,24,USA
Harry George,1886-10-05,0,1909,1909,10,5,USA
Dennis Joseph,1949-03-13,4,1969,1973,3,13,USA
James Jerome,1937-01-10,9,1958,1967,1,10,USA
Martin James,1888-11-27,6,1908,1914,11,27,USA
Akinori,1972-01-13,3,2004,2007,1,13,Japan
Adam Robert,1985-11-22,9,2010,2019,11,22,USA
William Joseph,1940-11-23,2,1962,1964,11,23,USA
Nathan Edward,1951-07-11,7,1974,1981,7,11,USA
James Edward,1951-07-01,7,1974,1981,7,1,USA
John G.,1870-08-21,0,1895,1895,8,21,Netherlands
William John,1862-05-24,0,1887,1887,5,24,USA
Melvin Thomas,1909-03-02,21,1926,1947,3,2,USA
David Alan,1964-11-12,7,1987,1994,11,12,USA
Philip Roland,1961-11-10,0,1986,1986,11,10,USA
John Andrew,1911-02-24,0,1933,1933,2,24,USA
William Austin,1905-06-17,0,1933,1933,6,17,USA
James Paulus,1913-01-20,12,1937,1949,1,20,USA
Joshua Stephen,1984-09-14,6,2008,2014,9,14,USA
Orval,1881-02-02,8,1905,1913,2,2,USA
Lyle Stefan,1977-01-28,13,2001,2014,1,28,USA
Frank W.,1919-05-16,9,1943,1952,5,16,USA
Dillon Ray,1991-08-17,1,2016,2017,8,17,USA
Harry Michael,1951-01-27,0,1976,1976,1,27,USA
Ernest Gayhart,1885-10-07,0,1911,1911,10,7,USA
Robert Dennis,1955-01-01,10,1976,1986,1,1,USA
Dave,1958-04-25,5,1983,1988,4,25,USA
Frank Malcolm,1879-12-23,8,1901,1909,12,23,USA
Lawrence Thomas,1955-05-31,7,1981,1988,5,31,USA
Marvin James,1906-03-22,9,1931,1940,3,22,USA
Arnold Malcolm,1916-04-04,17,1937,1954,4,4,USA
Eric Blake,1971-02-03,8,1995,2003,2,3,USA
Frank Walter,1886-01-25,10,1905,1915,1,25,CAN
Henry Jay,1979-04-23,1,2006,2007,4,23,USA
Henry Cole,1992-07-21,1,2015,2016,7,21,USA
Furman Lee,1908-05-06,0,1935,1935,5,6,USA
Claude Jayhawk,1969-02-10,3,1993,1996,2,10,USA
Jerry Lee,1981-02-16,3,2006,2009,2,16,USA
James Philip,1934-01-16,12,1955,1967,1,16,USA
Spike Dee,1961-04-19,12,1983,1995,4,19,USA
Paul Francis,1924-02-07,NA,NA,NA,2,7,USA
Thomas Llewellyn,1874-11-01,6,1899,1905,11,1,USA
Rudy C.,1987-12-18,0,2014,2014,12,18,USA
Christopher Scott,1991-08-12,6,2013,2019,8,12,USA
Micah Burton,1982-09-28,5,2007,2012,9,28,USA
Richard Wayne,1957-10-20,4,1982,1986,10,20,USA
Henry Havelock,1858-01-04,0,1884,1884,1,4,CAN
Chris Andrew,1977-05-13,0,2005,2005,5,13,Australia
Andrew Paul,1880-05-05,0,1902,1902,5,5,USA
Raymond Francis,1938-08-04,5,1965,1970,8,4,USA
Daniel Leonard,1923-11-26,NA,NA,NA,11,26,USA
Horace Robert,1901-05-25,0,1923,1923,5,25,USA
Marcell,1990-11-12,6,2013,2019,11,12,D.R.
Pablo Jose,1974-08-25,8,2000,2008,8,25,D.R.
Charles Henry,1846-09-24,4,1871,1875,9,24,USA
Edward D. A.,1867-07-08,0,1890,1890,7,8,USA
John Lewis,1956-09-15,9,1977,1986,9,15,USA
Alexander Melchor,1973-07-19,0,1996,1996,7,19,Venezuela
Jordan Patrick,1986-01-30,5,2011,2016,1,30,USA
Patrick Michael,1963-07-23,1,1987,1988,7,23,USA
James Joseph,1960-06-07,0,1987,1987,6,7,USA
John Francis,1945-02-11,0,1963,1963,2,11,USA
Thomas Marian,1946-11-02,17,1970,1987,11,2,USA
Eugene Milo,1887-07-13,7,1912,1919,7,13,USA
Frank,1928-04-10,0,1949,1949,4,10,USA
Joseph Martin,1948-06-02,0,1975,1975,6,2,USA
Christopher Joseph,1996-01-08,0,2019,2019,1,8,USA
Richard Joseph,1870-09-17,9,1896,1905,9,17,USA
Thomas Francis,1908-10-06,11,1932,1943,10,6,USA
Delmar Harold,1887-06-08,0,1912,1912,6,8,USA
Don Wilson,1911-12-05,11,1937,1948,12,5,USA
Ernest Kitchen,1899-03-01,4,1923,1927,3,1,USA
Jorge Rafael,1979-08-11,0,2009,2009,8,11,P.R.
Juan Miguel,1977-02-17,1,2004,2005,2,17,P.R.
Vicente,1977-09-27,13,1999,2012,9,27,Nicaragua
Dennis Ray,1945-04-17,5,1969,1974,4,17,USA
Andrew,1921-02-25,16,1943,1959,2,25,USA
Angel Manuel,1981-07-02,10,2006,2016,7,2,P.R.
David Percy,1949-09-15,4,1973,1977,9,15,CAN
Emilio Enrique,1991-05-07,2,2017,2019,5,7,USA
Jose Antonio,1935-05-05,14,1959,1973,5,5,P.R.
Joseph Francis,1917-10-28,10,1944,1954,10,28,USA
Karl Douglas,1955-03-29,5,1978,1983,3,29,USA
Michael Randy,1940-07-12,0,1968,1968,7,12,USA
Mitchell Otis,1951-10-15,7,1977,1984,10,15,USA
Philippe Rausac,1905-08-23,6,1928,1934,8,23,USA
Samuel Walter,1916-02-11,0,1939,1939,2,11,USA
Vance Linwood,1905-09-15,3,1938,1941,9,15,USA
James Vincent,1937-12-08,14,1955,1969,12,8,USA
Michael Timothy,1960-03-15,11,1984,1995,3,15,USA
Matthew Thomas,1982-11-10,5,2009,2014,11,10,USA
Thomas Alan,1962-07-30,11,1987,1998,7,30,USA
George Lynn,1882-05-05,0,1911,1911,5,5,USA
Leroy Robert,1906-07-07,17,1948,1965,7,7,USA
Phillips Steere,1930-06-08,7,1951,1958,6,8,USA
Lance Telford,1967-07-21,10,1993,2003,7,21,United Kingdom
Robert Rey,1962-11-08,2,1988,1990,11,8,USA
Vicente,1963-07-19,13,1987,2000,7,19,Mexico
Michael Raymond,1917-07-04,0,1939,1939,7,4,USA
Ervin Martin,1928-02-09,11,1945,1956,2,9,USA
Daniel Bennett,1991-10-28,1,2018,2019,10,28,USA
Donn Steven,1962-01-11,10,1988,1998,1,11,USA
David William,1957-08-19,11,1978,1989,8,19,USA
Dean William,1968-12-27,14,1989,2003,12,27,USA
Edwin Henry,1893-06-01,0,1917,1917,6,1,USA
Emilio Antonio,1895-06-13,13,1915,1928,6,13,Cuba
James Alvin,1945-10-15,19,1965,1984,10,15,USA
Lowell Raymond,1947-08-18,5,1969,1974,8,18,USA
Jonathan Matt,1979-03-21,4,2008,2012,3,21,USA
Orlando,1969-01-19,12,1995,2007,1,19,USA
Rafael,1964-09-24,19,1986,2005,9,24,Cuba
Joseph,1902-11-19,0,1931,1931,11,19,USA
Richard Paul,1925-02-13,0,1948,1948,2,13,USA
Edwin Lee,1933-06-10,1,1960,1961,6,10,USA
Joseph,1994-10-26,0,2019,2019,10,26,USA
Stanley Francis,1930-05-01,3,1953,1956,5,1,USA
Jose Luis,1973-08-20,7,1996,2003,8,20,D.R.
Joseph Matthew,1990-10-30,5,2014,2019,10,30,USA
James Franklin,1955-08-06,6,1984,1990,8,6,USA
Thomas Edward,1994-04-28,1,2018,2019,4,28,USA
James Edward,1945-03-01,2,1971,1973,3,1,USA
Alfred Thomas,1917-05-07,7,1948,1955,5,7,USA
John Paul,1940-12-05,1,1961,1962,12,5,USA
Kenneth Wayne,1951-10-01,0,1976,1976,10,1,USA
Laurence Albert,1885-07-21,3,1909,1912,7,21,USA
Jonathan Robert,1980-11-23,11,2005,2016,11,23,USA
Frank Richard,1917-10-21,5,1945,1950,10,21,USA
Stanley Gerard,1951-02-04,7,1974,1981,2,4,USA
Erik Daniel,1966-04-25,3,1991,1994,4,25,USA
John Joseph,1875-04-03,0,1897,1897,4,3,USA
Milton Stephen,1939-05-11,16,1957,1973,5,11,USA
Craig Harold,1969-03-28,10,1993,2003,3,28,USA
Alberto Judas,1962-09-08,4,1985,1989,9,8,Spain
Eduardo Jose,1995-03-06,1,2017,2018,3,6,Venezuela
Edward Miguel,1986-09-30,1,2017,2018,9,30,D.R.
Jimmy Santiago,1988-11-25,5,2011,2016,11,25,D.R.
Johnny Alfonso,1962-09-02,3,1988,1991,9,2,Venezuela
Alfred Joseph,1875-11-11,12,1899,1911,11,11,USA
Mark Alan,1961-09-16,12,1986,1998,9,16,USA
Kelly Jay,1957-10-17,6,1982,1988,10,17,USA
Michael Richard,1983-04-18,0,2008,2008,4,18,USA
Louis Peter,1911-06-25,1,1943,1944,6,25,USA
Byung Ho,1986-07-10,0,2016,2016,7,10,South Korea
Chan Ho,1973-06-30,16,1994,2010,6,30,South Korea
Clarence McKay,1912-05-17,1,1937,1938,5,17,USA
William David,1942-01-14,2,1971,1973,1,14,USA
Richard Blake,1985-06-19,7,2012,2019,6,19,USA
Christian Michael,1975-07-03,0,2001,2001,7,3,USA
James Clayton,1962-12-19,5,1987,1992,12,19,USA
David Gene,1951-06-09,18,1973,1991,6,9,USA
Douglas Wooley,1895-04-24,0,1923,1923,4,24,USA
Harley Park,1872-06-14,8,1893,1901,6,14,USA
Harry William,1947-09-14,6,1970,1976,9,14,USA
Jay,1874-07-08,0,1899,1899,7,8,USA
Jarrod Brent,1988-11-24,2,2011,2013,11,24,USA
Jarrett Paul,1989-01-01,4,2015,2019,1,1,USA
Kyle James,1989-09-30,1,2014,2015,9,30,USA
Clarence Perkins,1893-05-22,0,1915,1915,5,22,USA
Richard Alan,1963-03-20,6,1990,1996,3,20,USA
Roy William,1896-02-29,0,1919,1919,2,29,USA
Francis James,1912-07-08,0,1936,1936,7,8,USA
Maurice Wesley,1939-11-13,8,1964,1972,11,13,USA
Frank Joseph,1895-03-23,3,1921,1924,3,23,USA
James,1892-11-10,2,1915,1917,11,10,USA
Artie William,1911-11-01,2,1937,1939,11,1,USA
William Robert,1849-06-04,1,1875,1876,6,4,USA
Derek Gavin,1968-09-29,2,1992,1994,9,29,USA
Vernon Henry,1895-11-10,0,1921,1921,11,10,USA
Christopher Matthew,1988-02-24,5,2011,2016,2,24,USA
Leroy Earl,1907-04-25,10,1929,1939,4,25,USA
Ian Gene,1989-12-19,0,2017,2017,12,19,USA
Robert Allen,1984-09-08,8,2008,2016,9,8,USA
Melvin Lloyd,1922-06-13,9,1947,1956,6,13,USA
James Arthur,1894-02-01,1,1916,1917,2,1,USA
Chad Michael,1975-07-28,8,2001,2009,7,28,USA
James Vo,1975-02-08,5,1998,2003,2,8,USA
Gerardo Enrique,1987-05-06,10,2009,2019,5,6,Venezuela
Jose Miguel,1972-11-28,9,1995,2004,11,28,D.R.
Manuel Alex,1982-10-30,8,2007,2015,10,30,USA
Jeffrey Dale,1961-08-26,10,1986,1996,8,26,USA
Andrew Barker,1985-10-31,4,2011,2015,10,31,USA
John Henry,1977-11-26,10,2000,2010,11,26,USA
Larry Alton,1953-11-10,14,1974,1988,11,10,USA
Lance Michael,1956-06-15,18,1977,1995,6,15,USA
Samuel,1943-06-12,0,1970,1970,6,12,P.R.
Steven Michael,1967-12-17,8,1995,2003,12,17,USA
James R.,1986-02-27,1,2008,2009,2,27,USA
Walter Edward,1871-07-14,3,1892,1895,7,14,USA
Michael Everett,1954-12-06,4,1977,1981,12,6,USA
Thomas William,1868-04-10,3,1893,1896,4,10,USA
William Raymond,1948-08-17,3,1971,1974,8,17,USA
Casey Robert,1954-04-14,6,1981,1987,4,14,USA
Charles James,1863-07-18,4,1886,1890,7,18,USA
Edward Dixon,1916-05-12,4,1939,1943,5,12,USA
William Edwin,1885-12-27,1,1910,1911,12,27,USA
Thomas Anthony,1939-09-13,2,1963,1965,9,13,USA
Arthur Wesley,1992-09-06,1,2018,2019,9,6,USA
Curtis,1987-02-13,3,2013,2016,2,13,USA
Roy Robert,1917-09-07,5,1943,1948,9,7,USA
Harold Philip,1891-08-30,0,1913,1913,8,30,USA
Stanwood Wendell,1922-10-21,1,1944,1945,10,21,USA
James Bugg,1902-11-15,1,1927,1928,11,15,USA
Benjamin Edwin,1895-10-13,14,1915,1929,10,13,USA
William Herbert,1954-04-22,3,1978,1981,4,22,USA
Carlos Alberto,1931-03-13,0,1950,1950,3,13,Cuba
Camilo Alberto,1934-01-20,17,1954,1971,1,20,Cuba
Valentino Martin,1978-11-17,7,2004,2011,11,17,USA
John Paul,1905-06-25,1,1933,1934,6,25,USA
Larry John,1956-04-25,2,1982,1984,4,25,USA
George Henry,1881-08-28,14,1907,1921,8,28,USA
Kevin Patrick,1953-07-22,4,1974,1978,7,22,USA
Daniel Anthony,1961-10-17,9,1985,1994,10,17,USA
Michael John,1898-11-07,0,1919,1919,11,7,USA
Claude William,1909-04-09,12,1935,1947,4,9,USA
Clifford Scot,1958-11-18,0,1983,1983,11,18,USA
Frank Enrico,1957-08-21,7,1979,1986,8,21,USA
James Washington,1881-07-12,3,1906,1909,7,12,USA
Tyler Brock,1989-12-13,2,2012,2014,12,13,USA
Robert Wayne,1953-12-03,1,1980,1981,12,3,USA
Joseph William,1892-06-06,1,1926,1927,6,6,USA
Frederick Joseph,1944-10-09,13,1968,1981,10,9,USA
Joseph Michael,1986-05-19,3,2011,2014,5,19,USA
Robert Lee,1917-10-27,1,1941,1942,10,27,USA
Bronswell Dante,1970-09-16,1,1998,1999,9,16,USA
Robert Chandler,1959-05-16,13,1985,1998,5,16,USA
Case Lyman,1874-05-07,7,1901,1908,5,7,USA
Lorenzo Clare,1887-10-05,0,1909,1909,10,5,USA
Donald Corey,1979-08-13,11,2000,2011,8,13,USA
Daryl Alan,1943-11-21,6,1968,1974,11,21,USA
David Glenn,1956-07-25,0,1979,1979,7,25,USA
Danny Shane,1971-02-17,8,1996,2004,2,17,USA
Eric Scott,1983-04-08,4,2007,2011,4,8,USA
Gilbert Thomas,1955-09-05,0,1977,1977,9,5,USA
Harry Ernest,1882-01-17,0,1908,1908,1,17,USA
Hamilton,1877-10-13,0,1909,1909,10,13,USA
Henry Joseph,1907-07-17,0,1932,1932,7,17,USA
Jarrod Lane,1973-09-07,2,2001,2003,9,7,USA
Jeffrey Simmons,1968-10-01,0,1995,1995,10,1,USA
John Allen,1967-02-11,3,1992,1995,2,11,USA
John Hollis,1978-01-30,5,2002,2007,1,30,USA
Jordan Andrew,1992-02-12,0,2016,2016,2,12,USA
Kenneth Brian,1964-07-08,6,1988,1994,7,8,USA
Michael Lee,1958-01-26,1,1981,1982,1,26,USA
William Jennings Bryan,1897-01-29,0,1921,1921,1,29,USA
Reginald Allen,1958-11-07,4,1981,1985,11,7,USA
John William,1987-05-11,0,2014,2014,5,11,USA
Roy Lewis,1876-12-17,6,1901,1907,12,17,USA
Scott Robert,1979-06-20,0,2008,2008,6,20,USA
James Wells,1908-12-18,0,1929,1929,12,18,USA
Martin William,1943-04-06,12,1968,1980,4,6,USA
George William,1912-10-07,0,1935,1935,10,7,USA
David Christopher,1984-05-18,0,2009,2009,5,18,USA
Gene Tunney,1926-07-08,0,1944,1944,7,8,USA
Harry Claud,1884-06-29,0,1910,1910,6,29,USA
Spencer Burdette,1988-02-20,2,2014,2016,2,20,USA
Tommy Allen,1935-09-05,0,1957,1957,9,5,USA
Troy Jamieson,1985-09-03,7,2007,2014,9,3,USA
Carlos,1927-11-28,2,1954,1956,11,28,Cuba
David Wayne,1983-06-17,6,2006,2012,6,17,USA
Eugene Edward,1891-05-26,9,1911,1920,5,26,USA
David Confesor,1994-02-06,2,2016,2018,2,6,D.R.
Felipe Adolfo,1983-10-05,7,2007,2014,10,5,D.R.
Ronny Leonel,1981-04-21,7,2005,2012,4,21,D.R.
Joshua William,1975-05-19,8,1999,2007,5,19,USA
Michael George,1945-04-18,6,1968,1974,4,18,USA
Benjamin Michael,1987-10-27,2,2014,2016,10,27,USA
Guilford Paul Hans,1902-11-14,0,1925,1925,11,14,USA
Xavier Brooks,1985-02-25,5,2009,2014,2,25,USA
Simon Francis,1885-07-20,0,1909,1909,7,20,USA
Carl Anthony,1976-01-08,14,1998,2012,1,8,USA
David Lee,1962-08-12,6,1990,1996,8,12,Germany
Donald Stephen,1938-07-13,14,1957,1971,7,13,USA
Roger Allen,1967-10-04,6,1992,1998,10,4,USA
Theodore John,1919-08-15,0,1946,1946,8,15,USA
John,1963-09-06,1,1987,1988,9,6,USA
Stanley Walter,1931-09-06,0,1955,1955,9,6,USA
James Alston,1988-11-06,6,2013,2019,11,6,CAN
Michael DeWayne,1953-09-03,3,1977,1980,9,3,USA
Joel Elias,1994-04-07,0,2019,2019,4,7,D.R.
Pedro Julio,1994-09-27,0,2019,2019,9,27,USA
Frederick Thomas,1880-09-02,5,1906,1911,9,2,USA
George Washington,1889-05-23,0,1920,1920,5,23,USA
Harley Fenwick,1868-01-09,3,1896,1899,1,9,USA
Michael Earl,1961-11-15,0,1984,1984,11,15,USA
George Washington,1871-07-06,0,1894,1894,7,6,USA
Jason Lee,1972-11-22,12,1998,2010,11,22,USA
Michael Joseph,1950-01-26,2,1975,1977,1,26,USA
James Manuel,1991-05-05,4,2015,2019,5,5,USA
Bradley J.,1988-02-02,8,2011,2019,2,2,USA
John Gaston,1910-01-10,8,1937,1945,1,10,USA
Elias,1859-05-23,0,1884,1884,5,23,USA
Richard J.,1836-02-29,6,1871,1877,2,29,USA
William Charles,1885-03-17,1,1908,1909,3,17,USA
Franklin Johnson,1860-03-30,0,1876,1876,3,30,USA
Franklin Thomas,1905-08-31,2,1933,1935,8,31,USA
George Thomas,1888-01-10,5,1912,1917,1,10,USA
Harry James,1889-07-12,2,1917,1919,7,12,USA
James Madison,1925-06-09,6,1949,1955,6,9,USA
Joshua Ray,1977-08-20,2,2002,2004,8,20,USA
Steven Wayne,1983-04-13,12,2007,2019,4,13,USA
Alexander Franklin,1877-03-07,1,1902,1903,3,7,USA
Albert Gregory,1934-09-12,8,1958,1966,9,12,USA
Frank H.,1866-08-30,4,1889,1893,8,30,USA
Isaac Overton,1917-03-01,9,1939,1948,3,1,USA
Jason John,1975-12-29,1,2002,2003,12,29,USA
Montgomery Marcellus,1908-09-02,9,1932,1941,9,2,USA
Terry Bobby Gene,1971-11-10,0,2002,2002,11,10,USA
Marvin Warren,1889-07-16,0,1910,1910,7,16,USA
Jacob Edward,1981-05-31,14,2002,2016,5,31,USA
George Adolphe,1861-09-20,2,1885,1887,9,20,USA
Charles Edward,1896-10-05,2,1915,1917,10,5,USA
Harold Arthur,1917-04-20,6,1943,1949,4,20,USA
Roger Thorpe,1891-02-05,17,1910,1927,2,5,USA
William Joseph,1960-02-16,8,1986,1994,2,16,USA
Leslie Earl,1923-09-17,0,1953,1953,9,17,USA
Joc Russell,1992-04-21,5,2014,2019,4,21,USA
Stuart Russell,1960-01-28,0,1985,1985,1,28,USA
Jorge Enrique,1966-10-12,1,1991,1992,10,12,USA
Alfredo Jose,1960-08-11,2,1987,1989,8,11,Venezuela
Charles P.,1869-10-27,0,1902,1902,10,27,Cuba
Dustin Luis,1983-08-17,13,2006,2019,8,17,USA
Stephen George,1914-07-30,0,1941,1941,7,30,USA
Homer Hefner,1902-10-10,7,1927,1934,10,10,USA
Jack Chiles,1910-08-28,1,1935,1936,8,28,USA
George Allan,1906-08-15,2,1927,1929,8,15,USA
Charles,1929-02-22,0,1956,1956,2,22,USA
Monte,1891-10-08,0,1913,1913,10,8,USA
Carlos Angel,1987-02-22,4,2011,2015,2,22,D.R.
Francisco,1988-06-01,1,2012,2013,6,1,D.R.
Jailen Alphonso,1981-01-04,1,2007,2008,1,4,D.R.
Julio Cesar,1968-09-07,0,1992,1992,9,7,D.R.
Steven Antone,1968-05-21,1,1994,1995,5,21,USA
Henry Clement,1870-11-28,21,1892,1913,11,28,USA
Joseph,1869-11-08,0,1894,1894,11,8,USA
Alejandro,1976-04-06,0,2002,2002,4,6,USA
Michael Alan,1984-01-14,11,2006,2017,1,14,USA
Christian Devont'a,1995-02-21,0,2018,2018,2,21,USA
Edward Charles,1918-03-13,8,1946,1954,3,13,USA
Kit Donovan,1973-08-28,2,2002,2004,8,28,USA
Louis Henri,1863-09-10,0,1886,1886,9,10,USA
Daniel Edward,1968-06-30,4,1992,1996,6,30,USA
Barney,1880-09-10,9,1903,1912,9,10,USA
John,1861-04-23,6,1884,1890,4,23,USA
Brock,1953-11-06,1,1974,1975,11,6,USA
David Joseph,1978-05-24,0,2002,2002,5,24,USA
Rudy Hector,1969-12-17,2,1995,1997,12,17,D.R.
Alejandro,1959-06-25,15,1981,1996,6,25,D.R.
Angel Maria,1975-02-16,3,1998,2001,2,16,D.R.
Ariel,1989-05-20,1,2015,2016,5,20,D.R.
Adalberto,1959-07-11,6,1981,1987,7,11,P.R.
Brayan Eduardo,1982-01-07,11,2005,2016,1,7,Cuba
Carlos Felipe,1978-05-17,13,2001,2014,5,17,D.R.
Elvis,1976-09-15,1,2000,2001,9,15,D.R.
Felix Ricardo,1990-02-25,3,2016,2019,2,25,D.R.
Francisco Antonio,1989-10-12,4,2014,2018,10,12,D.R.
Geronimo,1967-03-29,6,1990,1996,3,29,D.R.
Hipolito,1964-01-30,2,1986,1988,1,30,D.R.
Jesus,1975-03-08,1,1999,2000,3,8,D.R.
James Patrick,1964-09-17,0,1992,1992,9,17,USA
Jose,1942-12-03,3,1969,1972,12,3,Mexico
Juan Francisco,1977-06-27,0,1999,1999,6,27,D.R.
Orlando Gregorio,1933-11-17,17,1958,1975,11,17,Cuba
Ramon Arturo,1962-05-05,0,1989,1989,5,5,D.R.
Ramiro Gauna,1985-07-18,7,2009,2016,7,18,Mexico
Roberto Cesar,1937-04-17,6,1965,1971,4,17,D.R.
Antonio Francesco,1957-06-04,17,1980,1997,6,4,D.R.
Tony Francisco,1981-03-23,3,2006,2009,3,23,D.R.
Ramon Antonio,1982-01-09,5,2006,2011,1,9,D.R.
Wily Modesto,1982-01-23,9,2002,2011,1,23,D.R.
Elmer Clair,1900-08-17,0,1922,1922,8,17,USA
Hunter Andrew,1983-04-13,12,2007,2019,4,13,USA
Russell William,1900-03-11,0,1921,1921,3,11,USA
James Edward,1924-01-07,9,1953,1962,1,7,USA
Lance Michael,1983-09-10,0,2011,2011,9,10,USA
Terry Lee,1960-07-16,14,1984,1998,7,16,USA
Kenneth William,1896-04-24,13,1916,1929,4,24,USA
Hayden Andrew,1984-10-13,5,2005,2010,10,13,USA
Brad Lee,1969-04-14,5,1993,1998,4,14,USA
Clifton Randolph,1984-06-15,10,2008,2018,6,15,USA
George Louis,1896-09-24,0,1917,1917,9,24,USA
Herbert Jefferis,1894-02-10,22,1912,1934,2,10,USA
Shannon Dion,1969-09-11,1,1995,1996,9,11,USA
Bradley Wayne,1978-05-24,14,2000,2014,5,24,USA
William Nathaniel,1968-05-25,2,1992,1994,5,25,USA
Paul Eugene,1931-07-12,0,1954,1954,7,12,USA
Eugene David,1953-06-21,3,1975,1978,6,21,USA
James Elsworth,1863-10-08,5,1884,1889,10,8,USA
Joseph Anthony,1940-10-09,11,1962,1973,10,9,USA
Henry Stephen,1905-09-15,0,1929,1929,9,15,Poland
Joseph Aloysius,1891-09-12,0,1913,1913,9,12,USA
Robert Ernest,1895-05-03,0,1915,1915,5,3,USA
Donald Hoyte,1943-10-08,0,1966,1966,10,8,USA
William Harrison,1865-09-02,0,1894,1894,9,2,USA
Hugh McLaurin,1931-01-18,3,1954,1957,1,18,USA
Raymond Watson,1905-08-05,4,1932,1936,8,5,USA
Senger David,1987-08-14,5,2014,2019,8,14,Venezuela
Freddy,1996-06-04,1,2018,2019,6,4,D.R.
Jhonny Antonio,1982-05-28,14,2003,2017,5,28,D.R.
Joel,1976-03-23,11,2005,2016,3,23,D.R.
Wandy Luis,1991-07-27,3,2016,2019,7,27,D.R.
Wily,1989-05-08,7,2012,2019,5,8,D.R.
Jose Francisco,1994-04-30,4,2015,2019,4,30,Venezuela
Luis,1942-06-17,0,1969,1969,6,17,P.R.
Oswald Jose,1962-10-19,0,1988,1988,10,19,Venezuela
Troy Eugene,1969-08-09,14,1995,2009,8,9,USA
John Patrick,1954-08-31,6,1980,1986,8,31,USA
Luis M.,1984-04-27,3,2009,2012,4,27,D.R.
Luis David,1993-05-09,3,2016,2019,5,9,D.R.
Herbert Rodney,1882-06-07,4,1911,1915,6,7,USA
Antonio Miguel,1980-01-26,3,2003,2006,1,26,D.R.
Audris Joel,1988-12-23,1,2013,2014,12,23,D.R.
Beltran Ogilbio,1981-10-24,0,2006,2006,10,24,D.R.
Carlos Gross,1971-04-14,5,1995,2000,4,14,D.R.
Carlos Eduardo,1990-10-27,3,2015,2018,10,27,Venezuela
Christopher Ralph,1985-07-01,6,2008,2014,7,1,USA
Cionel Felix,1996-04-21,1,2018,2019,4,21,Cuba
Daniel,1971-02-26,0,1996,1996,2,26,USA
Eduardo Atanacio,1969-09-11,13,1993,2006,9,11,USA
Eduardo Rafael,1968-05-04,10,1995,2005,5,4,Venezuela
Eury Eduardo,1990-05-30,3,2012,2015,5,30,D.R.
Fernando,1983-04-23,1,2008,2009,4,23,USA
George Thomas,1937-12-29,0,1958,1958,12,29,USA
Hernan Alejandro,1991-03-26,7,2012,2019,3,26,Venezuela
Juan Pablo,1978-09-03,7,2006,2013,9,3,D.R.
Juan Carlos,1986-11-13,2,2013,2015,11,13,D.R.
Luis Manuel,1985-01-20,2,2011,2013,1,20,D.R.
Martin Roman,1946-02-28,9,1969,1978,2,28,USA
Martin,1991-04-04,7,2012,2019,4,4,Venezuela
Melido Turpen Gross,1966-02-15,8,1987,1995,2,15,D.R.
Michael Irvin,1964-10-19,7,1990,1997,10,19,P.R.
Miguel Angel,1983-09-25,0,2005,2005,9,25,Venezuela
Michael,1992-08-07,1,2018,2019,8,7,P.R.
Neifi Neftali,1973-06-02,11,1996,2007,6,2,D.R.
Odalis Amadol,1978-06-11,10,1998,2008,6,11,D.R.
Oliver,1981-08-15,17,2002,2019,8,15,Mexico
Pascual Gross,1957-05-17,11,1980,1991,5,17,D.R.
Rafael Jerome,1982-05-15,6,2006,2012,5,15,D.R.
Robert Alexander,1969-06-04,7,1994,2001,6,4,Venezuela
Roberto,1988-12-23,5,2014,2019,12,23,P.R.
Santiago Alberto,1975-12-30,1,2000,2001,12,30,D.R.
Salvador Johan,1990-05-10,7,2011,2018,5,10,Venezuela
Timoniel,1975-04-08,7,2000,2007,4,8,D.R.
Atanasio,1942-05-14,22,1964,1986,5,14,Cuba
Antonio Llamas,1966-04-20,4,1988,1992,4,20,Mexico
Tomas Orlando,1973-12-29,13,1995,2008,12,29,Venezuela
Williams David,1991-05-21,1,2015,2016,5,21,Venezuela
Yefri,1991-02-24,0,2016,2016,2,24,D.R.
Yorkis Miguel Vargas,1967-09-30,11,1991,2002,9,30,D.R.
Matthew Alan,1975-06-08,8,1997,2005,6,8,USA
Broderick Phillip,1954-11-23,6,1978,1984,11,23,USA
Cameron Edward,1990-09-27,0,2017,2017,9,27,USA
Cecil Boyce,1940-12-01,0,1967,1967,12,1,USA
Charles Sullivan,1905-09-09,4,1930,1934,9,9,USA
Ralph Foster,1896-02-27,19,1915,1934,2,27,USA
Daniel Lee,1975-03-15,0,1999,1999,3,15,USA
Glen Weston,1983-03-02,11,2006,2017,3,2,USA
Harry Walter,1922-09-06,8,1947,1955,9,6,USA
John Joseph,1924-03-10,0,1950,1950,3,10,USA
Jonathan Samuel,1956-12-13,3,1985,1988,12,13,USA
Samuel Benedict,1951-03-04,2,1977,1979,3,4,USA
Leonard John,1917-11-25,4,1942,1946,11,25,USA
Henry Huston,1888-03-14,2,1910,1912,3,14,USA
Ronald Peter,1936-04-01,12,1961,1973,4,1,USA
William Joseph,1910-06-23,0,1934,1934,6,23,USA
George Wilson,1884-08-13,7,1908,1915,8,13,USA
John Stephenson,1898-02-04,0,1921,1921,2,4,USA
John Grover,1885-01-14,0,1907,1907,1,14,USA
William Dayton,1891-08-30,9,1912,1921,8,30,USA
Boyd Glenn,1914-03-21,0,1941,1941,3,21,USA
Melvin Gray,1934-09-14,1,1963,1964,9,14,USA
Chan Everett,1972-09-13,2,2000,2002,9,13,USA
Clayton Shields,1881-12-18,0,1908,1908,12,18,USA
Gaylord Jackson,1938-09-15,21,1962,1983,9,15,USA
Gerald June,1960-10-30,12,1983,1995,10,30,USA
William Henry,1886-07-28,0,1912,1912,7,28,USA
Herbert Edward,1969-09-15,10,1994,2004,9,15,USA
Jason Kyle,1980-08-18,0,2008,2008,8,18,USA
James Evan,1935-10-30,16,1959,1975,10,30,USA
Emmett Key,1888-10-24,0,1915,1915,10,24,USA
William Patrick,1959-02-04,5,1985,1990,2,4,USA
Ryan Keith,1987-02-13,3,2009,2012,2,13,USA
Herbert Scott,1891-04-17,6,1915,1921,4,17,USA
Robert Alan,1969-10-06,8,1995,2003,10,6,USA
William Andrew,1898-08-17,5,1918,1923,8,17,USA
Stanley,1950-08-25,7,1971,1978,8,25,USA
John Michael,1919-02-27,12,1942,1954,2,27,USA
Vincent William,1985-02-20,5,2010,2015,2,20,USA
Roberto Antonio,1971-06-07,12,1994,2006,6,7,Venezuela
Adam Charles,1965-12-11,4,1987,1991,12,11,USA
Adam L.,1979-05-18,0,2004,2004,5,18,USA
William David,1921-03-20,0,1942,1942,3,20,USA
Robert Andrew,1884-06-16,1,1906,1907,6,16,USA
Bryan Evan,1986-04-09,2,2010,2012,4,9,USA
Brock Alan,1983-11-20,0,2013,2013,11,20,USA
Carl Francis,1925-04-23,2,1955,1957,4,23,USA
Charles Andrew,1942-08-15,7,1962,1969,8,15,USA
Christopher Michael,1972-01-28,5,1996,2001,1,28,USA
Christopher Ronald,1970-11-06,0,1999,1999,11,6,USA
Dillon James,1992-08-31,2,2017,2019,8,31,USA
Dustin Allen,1994-09-10,1,2018,2019,9,10,USA
Fred Ingles,1942-02-08,10,1966,1976,2,8,USA
Gary Charles,1937-04-21,13,1959,1972,4,21,USA
Harding William,1929-10-17,4,1955,1959,10,17,USA
Jace Ryan,1990-05-09,5,2014,2019,5,9,USA
Jeffrey Allen,1963-09-22,0,1989,1989,9,22,USA
James Niels,1908-08-18,6,1931,1937,8,18,USA
John Phillip,1850-04-08,10,1874,1884,4,8,USA
John William,1893-07-14,7,1915,1922,7,14,USA
Kent Franklin,1925-12-21,9,1944,1953,12,21,USA
Kyle Johnathan,1976-04-09,2,1999,2001,4,9,USA
Raymond James,1946-08-27,0,1970,1970,8,27,USA
Richard Devin,1955-11-21,7,1979,1986,11,21,USA
Otto Casper,1885-03-15,2,1912,1914,3,15,USA
Russell Dixon,1914-12-14,11,1936,1947,12,14,USA
Shane Aaron,1988-02-11,4,2013,2017,2,11,USA
Sidney Herbert,1918-01-31,0,1943,1943,1,31,USA
Steven Bradley,1962-11-14,1,1987,1988,11,14,USA
Timothy Louis,1991-02-22,1,2018,2019,2,22,USA
Gregorio Jesus,1984-12-10,10,2008,2018,12,10,Venezuela
Yusmeiro Alberto,1984-11-22,13,2006,2019,11,22,Venezuela
Mark Joseph,1965-11-18,10,1991,2001,11,18,USA
Frederick Lee,1911-01-05,1,1934,1935,1,5,USA
Eugene James,1959-09-25,11,1982,1993,9,25,USA
Benjamin Wayne,1977-04-07,4,1999,2003,4,7,USA
William John,1984-04-29,0,2007,2007,4,29,USA
Jacob Steven,1988-06-05,6,2013,2019,6,5,USA
Americo Peter,1943-06-27,13,1963,1976,6,27,USA
Daniel Joseph,1958-11-13,12,1979,1991,11,13,USA
Patrick Edward,1863-01-10,0,1891,1891,1,10,USA
Andrew Eugene,1972-06-15,18,1995,2013,6,15,USA
Robert Henry,1861-07-19,4,1887,1891,7,19,USA
Christopher Michael,1984-08-15,2,2009,2011,8,15,USA
Gary George,1958-04-03,10,1982,1992,4,3,USA
Harry Jonathan,1957-06-21,0,1983,1983,6,21,USA
Joseph Paul,1955-01-26,3,1980,1983,1,26,USA
Harry Jonathan,1990-07-19,1,2013,2014,7,19,USA
Leon Arthur,1902-06-23,2,1935,1937,6,23,USA
Jim Ned,1881-08-25,0,1914,1914,8,25,USA
George William Paul,1931-11-29,2,1951,1953,11,29,USA
Adam Christopher,1977-06-11,7,2001,2008,6,11,USA
Charles Edward,1866-01-28,5,1889,1894,1,28,USA
Jesse Lee,1894-11-23,9,1921,1930,11,23,USA
Marty Ashley,1962-12-25,0,1989,1989,12,25,USA
Lorenz Johannes,1893-06-22,0,1914,1914,6,22,USA
John,1910-12-10,1,1935,1936,12,10,USA
Francis Xavier,1882-03-31,6,1905,1911,3,31,USA
Nathaniel Frederick,1860-03-17,15,1882,1897,3,17,USA
Edward Joseph,1888-03-04,13,1911,1924,3,4,USA
Robert Raymond,1942-11-13,2,1969,1971,11,13,USA
John Albert,1878-05-24,8,1903,1911,5,24,USA
Daniel Albin,1936-12-20,3,1961,1964,12,20,USA
George Edward,1918-09-04,0,1941,1941,9,4,USA
Leroy Herbert,1919-10-10,0,1945,1945,10,10,USA
Meinhard Charles,1886-05-11,0,1907,1907,5,11,USA
Thomas James,1988-03-08,5,2014,2019,3,8,USA
Raymond William,1909-08-02,2,1936,1938,8,2,USA
Joshua Aaron,1988-02-12,6,2013,2019,2,12,USA
Arthur Thomas,1887-08-14,5,1910,1915,8,14,USA
Daniel,1861-11-05,0,1890,1890,11,5,USA
James Dickson,1854-12-10,1,1884,1885,12,10,USA
Louis A.,1864-03-14,NA,NA,NA,3,14,USA
Ernest Gordon,1908-04-16,11,1931,1942,4,16,USA
Robert Cord,1987-01-23,3,2011,2014,1,23,USA
David Edward,1986-10-09,7,2012,2019,10,9,USA
Edward Jaykill,1879-03-03,11,1902,1913,3,3,USA
Joshua Lee,1978-05-12,8,2000,2008,5,12,USA
Kenneth Allen,1954-08-06,10,1980,1990,8,6,USA
Cornelius Carmen,1840-11-19,5,1871,1876,11,19,USA
Raymond Clifford,1903-12-11,6,1930,1936,12,11,USA
Thomas Allen,1974-03-04,2,2003,2005,3,4,South Korea
Travis Howard,1977-07-25,3,2001,2004,7,25,USA
Adolfo Emilio,1941-12-16,8,1964,1972,12,16,Panama
George Andrew,1977-04-06,4,2004,2008,4,6,USA
William Corcoran,1868-11-09,13,1890,1903,11,9,USA
Brandon Emil,1981-06-28,16,2002,2018,6,28,USA
Brett Maverick,1994-05-30,2,2017,2019,5,30,USA
Albert Abernathy,1904-05-25,0,1930,1930,5,25,USA
John Melvin,1928-02-24,9,1955,1964,2,24,USA
David Earl,1920-05-16,21,1941,1962,5,16,USA
Damon Roswell,1919-06-08,4,1942,1946,6,8,USA
Charles Louis,1872-05-23,12,1899,1911,5,23,USA
Richard Eugene,1931-11-24,4,1962,1966,11,24,USA
Edward David,1901-02-17,11,1924,1935,2,17,USA
Howard Edward,1930-07-08,0,1953,1953,7,8,USA
Norman Edwin,1944-09-20,0,1970,1970,9,20,USA
Evan John,1994-09-11,1,2018,2019,9,11,USA
Heath Michael,1982-03-24,0,2007,2007,3,24,USA
Horace B.,1853-05-14,NA,NA,NA,5,14,USA
John Stephen,1919-05-24,0,1945,1945,5,24,USA
Jack Dorn,1921-09-06,10,1947,1957,9,6,USA
Jason Charles,1974-03-22,4,1999,2003,3,22,USA
Jason Lloyd,1976-09-27,6,2001,2007,9,27,USA
Charles Gene,1970-04-29,6,1993,1999,4,29,USA
Kyle Ray,1984-04-03,2,2009,2011,4,3,USA
Harold Ross,1919-05-16,NA,NA,NA,5,16,USA
Marr B.,1857-06-16,6,1884,1890,6,16,USA
Michael Dwaine,1950-08-19,10,1973,1983,8,19,USA
Paul Anthony,1977-04-15,6,2004,2010,4,15,USA
Clarence Lemuel,1908-11-03,2,1934,1936,11,3,USA
William Taylor,1933-06-18,7,1956,1963,6,18,USA
Thomas Gerard,1889-04-01,7,1915,1922,4,1,USA
Keith Anthony,1959-04-25,17,1982,1999,4,25,USA
Zachary David,1986-09-21,5,2011,2016,9,21,USA
Denis,1985-07-22,0,2012,2012,7,22,D.R.
Thomas Harold,1942-04-07,6,1966,1972,4,7,USA
Steven Robert,1968-01-31,1,1994,1995,1,31,USA
William Joseph,1875-06-25,8,1898,1906,6,25,USA
Adam David,1976-02-08,3,2000,2003,2,8,USA
Douglas William,1965-09-26,0,1991,1991,9,26,USA
Wiley Harold,1874-07-13,5,1898,1903,7,13,USA
Michael Joseph,1968-09-04,15,1992,2007,9,4,USA
Nicholas Thomas,1921-08-27,0,1945,1945,8,27,USA
Robert Michael,1953-02-04,8,1977,1985,2,4,USA
Hipolito Antonio,1969-08-22,10,1992,2002,8,22,D.R.
Ronald Jacques,1935-05-22,6,1960,1966,5,22,CAN
Valentine John,1896-09-08,17,1916,1933,9,8,USA
Charles Thomas,1888-04-12,6,1914,1920,4,12,USA
Calvin Elroy,1976-09-29,7,1998,2005,9,29,V.I.
Charles Albert,1883-03-01,0,1910,1910,3,1,USA
Edgar Everett,1899-05-07,4,1923,1927,5,7,USA
David,1874-05-26,0,1898,1898,5,26,USA
John Thomas,1866-02-20,3,1889,1892,2,20,USA
Oliver Daniel,1870-04-09,12,1896,1908,4,9,USA
Cecil Lee,1970-01-19,0,1998,1998,1,19,USA
Urbane Henry,1899-06-03,1,1931,1932,6,3,USA
Kevin Patrick,1975-03-12,0,2002,2002,3,12,USA
Clarence Douglas,1911-03-28,1,1933,1934,3,28,USA
Clarence William,1897-10-29,0,1918,1918,10,29,USA
Jeffrey Mark,1966-02-12,2,1988,1990,2,12,USA
Mario Peter,1926-07-05,7,1947,1954,7,5,USA
Aloysius Edward,1914-01-19,1,1940,1941,1,19,USA
Jorge Moises,1979-04-17,2,2004,2006,4,17,USA
Felix,1985-02-08,6,2007,2013,2,8,D.R.
Edwin John Otto,1886-09-29,2,1913,1915,9,29,USA
William Benton,1896-05-02,9,1917,1926,5,2,USA
Walter William,1927-04-02,19,1945,1964,4,2,USA
Edward John,1968-10-06,0,1992,1992,10,6,USA
Lavern Jack,1949-06-02,2,1973,1975,6,2,USA
Jeffrey Charles,1969-06-07,0,1995,1995,6,7,USA
Raymond Lester,1897-06-06,2,1924,1926,6,6,USA
Tony Michael,1946-01-29,1,1967,1968,1,29,USA
Marino Paul,1920-09-23,5,1945,1950,9,23,Italy
Albert Felix,1895-10-24,1,1920,1921,10,24,USA
William Leonard,1926-04-15,0,1950,1950,4,15,USA
Juan D'Vaughn,1977-08-14,13,2000,2013,8,14,USA
Christopher Earl,1977-09-25,0,2001,2001,9,25,USA
David P.,1855-08-20,0,1876,1876,8,20,USA
Edmund Dana,1857-10-24,0,1885,1885,10,24,USA
James Anthony,1929-11-14,17,1950,1967,11,14,USA
William Morris,1899-06-14,6,1918,1924,6,14,USA
Anthony John,1976-12-30,18,1998,2016,12,30,USA
Anthony Francis,1906-12-07,7,1931,1938,12,7,USA
Charles William,1889-10-13,0,1914,1914,10,13,USA
Carmen Peter,1982-09-12,1,2007,2008,9,12,USA
Joseph Benjamin,1929-08-04,5,1957,1962,8,4,USA
Jess Willard,1915-07-31,0,1946,1946,7,31,USA
Lipman Emanuel,1845-05-25,16,1871,1887,5,25,USA
George Richard,1932-01-03,0,1956,1956,1,3,USA
Alfred James,1930-07-03,5,1956,1961,7,3,USA
Kevin Andrew,1989-01-04,6,2013,2019,1,4,USA
Brett Michael,1984-09-09,2,2011,2013,9,9,USA
Duane Xavier,1922-07-24,7,1949,1956,7,24,USA
Herman Polycarp,1895-12-26,7,1917,1924,12,26,USA
Cecil Randolph,1894-04-13,0,1915,1915,4,13,USA
Tyler Stephen,1990-05-29,0,2017,2017,5,29,USA
Antone James,1913-01-19,0,1936,1936,1,19,USA
Stolmy Ramon,1990-02-01,2,2013,2015,2,1,D.R.
Horacio,1945-03-12,10,1968,1978,3,12,Mexico
Manuel Elias,1987-06-05,8,2011,2019,6,5,Venezuela
Branden Henry,1989-01-26,1,2015,2016,1,26,USA
Chadwick Hudson,1992-03-29,3,2016,2019,3,29,USA
Luis A.,1974-10-17,1,2001,2002,10,17,D.R.
Michael Francisco,1989-01-18,8,2011,2019,1,18,D.R.
Joel Alberto,1978-09-25,11,2000,2011,9,25,P.R.
Ralph Arthur,1895-10-18,9,1918,1927,10,18,USA
Louis Victor,1943-08-28,20,1964,1984,8,28,USA
George Burton,1859-01-11,9,1884,1893,1,11,USA
Elijah Edward,1880-09-22,0,1903,1903,9,22,CAN
Yohan Jose,1983-12-26,1,2014,2015,12,26,Venezuela
Vada Edward,1938-08-11,17,1958,1975,8,11,USA
Josmil Oswaldo,1989-03-31,3,2013,2016,3,31,Venezuela
William Lerton,1899-04-08,2,1922,1924,4,8,USA
Renyel Eligio,1982-07-08,4,2006,2010,7,8,Venezuela
Ricardo Antonio,1994-01-20,2,2017,2019,1,20,Venezuela
Edward John,1904-06-15,0,1932,1932,6,15,USA
George William,1899-12-20,12,1923,1935,12,20,USA
Henry Harold,1911-04-02,4,1936,1940,4,2,USA
Walter Clement,1893-02-17,15,1913,1928,2,17,USA
Jose Manuel,1989-11-21,5,2014,2019,11,21,Venezuela
James Moir,1853-03-31,0,1883,1883,3,31,CAN
Gregory Daniel,1970-08-07,3,1993,1996,8,7,USA
Gerald Eugene,1947-12-03,0,1978,1978,12,3,USA
Marc George,1970-08-07,2,1997,1999,8,7,USA
Stephen Edward,1991-01-14,4,2015,2019,1,14,USA
James Peter,1929-08-14,7,1953,1960,8,14,USA
Alexander,1914-11-22,1,1938,1939,11,22,USA
Jacob Albert,1894-04-22,1,1917,1918,4,22,USA
Lee Patrick Thomas,1947-11-06,5,1970,1975,11,6,USA
Christopher Francis,1961-09-16,2,1985,1987,9,16,USA
Clarke Alonzo,1899-02-24,8,1921,1929,2,24,USA
Charles Reno,1872-01-12,7,1900,1907,1,12,USA
Joseph Wayne,1953-01-01,3,1981,1984,1,1,USA
Gaylen Richard,1946-06-06,1,1974,1975,6,6,USA
James Michael,1974-04-03,4,1995,1999,4,3,USA
Stanley,1931-03-23,0,1957,1957,3,23,USA
Herman,1865-07-18,0,1890,1890,7,18,USA
Nicholas Johncarlo,1993-02-14,2,2017,2019,2,14,CAN
Juan Roman,1937-02-07,17,1957,1974,2,7,P.R.
Gordon Cecil,1956-07-31,3,1979,1982,7,31,CAN
Emil Joseph,1909-01-31,0,1931,1931,1,31,USA
Edward Stewart,1875-08-31,16,1901,1917,8,31,USA
Edward Arthur,1952-04-09,1,1978,1979,4,9,USA
Erik John,1968-10-30,4,1993,1997,10,30,USA
Phillip Alan,1969-01-27,7,1990,1997,1,27,USA
Donald Joseph,1929-11-09,0,1955,1955,11,9,USA
Elmo Alexander,1938-06-27,1,1962,1963,6,27,V.I.
Alfred Frederick Joseph,1890-04-13,0,1913,1913,4,13,USA
Mizell George,1920-08-21,7,1942,1949,8,21,USA
Kevin Jeffrey,1991-02-26,4,2015,2019,2,26,USA
William,1937-08-05,5,1961,1966,8,5,USA
Daniel Thomas,1962-02-04,17,1986,2003,2,4,USA
Zach Robert,1995-01-21,0,2019,2019,1,21,USA
Rance,1925-12-06,0,1956,1956,12,6,USA
Herbert Eugene,1928-06-14,3,1956,1959,6,14,USA
Norman William,1893-02-21,9,1918,1927,2,21,USA
Walter S.,1869-07-02,0,1891,1891,7,2,USA
Timothy Alfred,1947-01-27,0,1972,1972,1,27,USA
Trevor Patrick,1986-06-15,8,2010,2018,6,15,USA
William Francis,1947-03-21,10,1968,1978,3,21,USA
Eric Vaughn,1963-09-03,13,1986,1999,9,3,USA
Adam Gregory,1991-10-03,3,2016,2019,10,3,USA
Jeffrey Hunter,1965-11-24,0,1991,1991,11,24,USA
Raymond Willis,1917-12-19,7,1942,1949,12,19,USA
Colin Michael,1994-01-17,0,2019,2019,1,17,USA
Biff Benedict,1953-07-25,9,1975,1984,7,25,USA
Clarence Anthony,1924-03-06,10,1949,1959,3,6,USA
John Sigmund,1920-06-10,6,1940,1946,6,10,USA
John Joseph,1932-09-30,16,1953,1969,9,30,USA
Scott Eric,1976-03-18,11,2001,2012,3,18,USA
Michael Harold,1950-08-07,0,1975,1975,8,7,USA
Joseph Frank,1900-06-22,0,1926,1926,6,22,USA
James Willard,1917-06-18,2,1940,1942,6,18,USA
Cletus Elwood,1915-07-01,2,1937,1939,7,1,USA
John William,1952-10-23,1,1979,1980,10,23,USA
Thomas George,1929-08-26,7,1950,1957,8,26,USA
Chester Jennings,1910-09-30,3,1936,1939,9,30,USA
Aaron Elton,1942-04-19,4,1963,1967,4,19,USA
Gregory,1991-09-14,5,2014,2019,9,14,D.R.
Hugh Reid,1910-01-19,5,1943,1948,1,19,USA
Jorge Luis,1993-07-05,5,2014,2019,7,5,D.R.
Placido Enrique,1975-10-10,15,1998,2013,10,10,D.R.
Louis William,1880-03-14,0,1902,1902,3,14,USA
Kevin Michael,1970-06-28,1,1997,1998,6,28,USA
Richard Henry,1950-10-13,5,1973,1978,10,13,USA
Mark S.,1860-10-04,0,1887,1887,10,4,USA
Gustavo Adolfo,1961-10-26,8,1985,1993,10,26,Venezuela
Clifford Anthony,1974-02-27,8,1998,2006,2,27,USA
Kenneth Lyle,1921-01-21,0,1947,1947,1,21,USA
Ezra Dale,1965-08-09,0,1996,1996,8,9,USA
Howard Joseph,1921-06-26,15,1941,1956,6,26,USA
Louis Americo,1901-07-09,12,1932,1944,7,9,Italy
Allen Lorenz,1987-12-05,7,2012,2019,12,5,USA
Nicholas,1917-04-18,8,1937,1945,4,18,USA
John Paul,1954-02-28,0,1977,1977,2,28,USA
Luis Andrew,1963-12-10,13,1987,2000,12,10,D.R.
Thomas Andrew,1988-11-22,8,2011,2019,11,22,USA
Stuart Michael,1984-12-17,0,2012,2012,12,17,USA
John Leon,1905-12-30,0,1934,1934,12,30,USA
Alejandro,1890-05-14,NA,NA,NA,5,14,USA
Dalton Kenrick,1992-12-11,4,2014,2018,12,11,CAN
Carlos Antonio,1959-02-07,0,1985,1985,2,7,P.R.
Daniel Robert,1992-01-16,1,2018,2019,1,16,USA
Erasmus Arlington,1873-01-19,3,1895,1898,1,19,USA
Charles Elmer,1893-06-26,4,1917,1921,6,26,USA
Ralph Benjamin,1888-05-04,0,1910,1910,5,4,USA
Simon Emilio,1976-10-27,0,2004,2004,10,27,CAN
Sidney Alton,1976-11-02,11,1998,2009,11,2,Aruba
Edward Isaih,1874-09-07,4,1900,1904,9,7,USA
James Ralph,1895-05-12,2,1925,1927,5,12,USA
James Richard,1966-04-28,10,1990,2000,4,28,USA
Raymond Herman,1920-01-16,6,1941,1947,1,16,USA
Harlin Welty,1908-03-13,1,1934,1935,3,13,USA
Thomas Iverson,1857-10-14,8,1880,1888,10,14,USA
David,1921-06-17,4,1952,1956,6,17,USA
Paul Edward,1940-08-18,11,1964,1975,8,18,USA
Edward Joseph,1913-08-20,NA,NA,NA,8,20,USA
William Peter,1877-06-07,0,1902,1902,6,7,USA
Sean R.,1994-03-15,0,2019,2019,3,15,USA
Thomas Arthur,1951-10-30,9,1973,1982,10,30,USA
Frederick Alfred,1988-12-27,10,2009,2019,12,27,USA
Aaron Andermon,1986-10-01,5,2009,2014,10,1,USA
Edmund Joseph,1888-12-05,0,1914,1914,12,5,At Sea
Erwin Cooledge,1923-08-10,11,1948,1959,8,10,USA
Robert Lee,1959-07-22,1,1981,1982,7,22,USA
Marquis Donnell,1972-07-05,2,1999,2001,7,5,USA
Charles William,1955-01-12,4,1981,1985,1,12,USA
Colin Frederick,1975-11-23,1,2003,2004,11,23,USA
Daniel Edward,1931-10-17,0,1951,1951,10,17,USA
Darrell Ray,1952-01-17,16,1971,1987,1,17,USA
Richard Twilley,1901-12-30,5,1929,1934,12,30,USA
Irving Marble,1888-05-17,0,1914,1914,5,17,USA
J W,1933-01-17,7,1952,1959,1,17,USA
Ned Swindell,1905-07-06,1,1926,1927,7,6,USA
Odie Oscar,1877-05-24,0,1902,1902,5,24,USA
Alfred,1926-06-27,0,1948,1948,6,27,USA
Arnold Mario,1931-07-05,6,1954,1960,7,5,USA
Mark Steven,1962-10-30,14,1985,1999,10,30,USA
Lawrence Michael,1972-08-20,4,1999,2003,8,20,USA
Jorge Rafael,1971-08-17,16,1995,2011,8,17,P.R.
Leopoldo Jesus,1936-04-15,2,1960,1962,4,15,Cuba
William John,1906-08-02,8,1938,1946,8,2,USA
John Falk,1910-03-16,3,1932,1935,3,16,USA
Scott Vernon,1967-02-11,7,1993,2000,2,11,USA
Gerald Dempsey,1987-03-27,10,2009,2019,3,27,USA
Cumberland Willis,1890-06-20,NA,NA,NA,6,20,USA
Louis Thomas,1926-04-12,6,1946,1952,4,12,USA
Lewis George,1875-04-12,0,1902,1902,4,12,USA
Samuel Gilbert,1896-11-17,0,1922,1922,11,17,USA
Walter Charles,1929-07-09,15,1949,1964,7,9,USA
Louis William,1971-08-21,5,1999,2004,8,21,USA
Maryland Dykes,1910-11-18,0,1938,1938,11,18,USA
Michael Gary,1951-05-16,1,1976,1977,5,16,USA
Nelson Thomas,1911-08-23,13,1936,1949,8,23,USA
Robert,1902-03-18,0,1923,1923,3,18,USA
Nelson Adolph,1899-07-16,0,1922,1922,7,16,USA
John Frederick,1887-02-06,0,1914,1914,2,6,USA
Michael Larry,1970-09-05,0,1996,1996,9,5,USA
Ken Sterling,1947-08-04,0,1967,1967,8,4,USA
Jeared Wells,1878-03-11,0,1903,1903,3,11,USA
Brooks Casey,1990-09-26,3,2016,2019,9,26,USA
Max Walter,1993-08-23,0,2017,2017,8,23,USA
Abner Charles,1860-12-15,2,1884,1886,12,15,USA
Alonzo Sidney,1964-12-12,4,1987,1991,12,12,USA
William Burris,1885-05-08,4,1909,1913,5,8,USA
John Wesley,1941-08-17,16,1961,1977,8,17,USA
Herschel Mack,1993-01-14,1,2017,2018,1,14,USA
William Brian,1973-10-10,6,1998,2004,10,10,USA
LeJon Dante,1973-08-25,4,1997,2001,8,25,USA
Dennis Clay,1963-08-13,8,1985,1993,8,13,USA
Grover David,1940-10-10,0,1963,1963,10,10,USA
Hosken,1955-05-14,5,1978,1983,5,14,USA
John Joseph,1874-07-09,15,1897,1912,7,9,USA
Reginald Bertrand,1891-08-17,0,1913,1913,8,17,USA
Alvin Jacob,1908-07-15,15,1930,1945,7,15,USA
James Willard,1972-01-09,10,1995,2005,1,9,USA
Jeremy Robert,1976-06-18,2,1998,2000,6,18,USA
James Edwin,1859-08-30,1,1884,1885,8,30,USA
Landon Reed,1982-03-19,2,2009,2011,3,19,USA
Robert Leroy,1933-10-17,2,1955,1957,10,17,USA
Martin J.,1856-03-25,3,1881,1884,3,25,USA
Paul Ray,1948-03-19,4,1971,1975,3,19,USA
Raymond Raeth,1888-11-20,11,1913,1924,11,20,USA
Ross John,1968-01-24,2,1993,1995,1,24,USA
Michael Riley,1870-09-22,11,1898,1909,9,22,USA
John Lloyd,1906-03-13,1,1927,1928,3,13,USA
John Calvin,1929-07-08,5,1955,1960,7,8,USA
Leslie Edwin,1909-11-05,1,1938,1939,11,5,USA
Ellis Foree,1906-03-02,1,1932,1933,3,2,USA
Patrick Thomas,1860-06-27,NA,NA,NA,6,27,USA
Philip J.,1854-07-26,7,1878,1885,7,26,USA
Ted Henry,1955-01-31,12,1981,1993,1,31,USA
Victor Pellot,1927-11-01,11,1954,1965,11,1,P.R.
Carl Edgar,1928-01-11,0,1957,1957,1,11,USA
Robert William,1992-12-01,1,2018,2019,12,1,USA
Arquimedez,1973-08-24,2,1995,1997,8,24,D.R.
Martin Manuel,1983-10-27,13,2006,2019,10,27,Venezuela
Wilfred Anthony,1950-04-20,0,1975,1975,4,20,USA
John Steven,1925-08-28,3,1949,1952,8,28,USA
Albert George,1847-11-19,1,1871,1872,11,19,USA
Andrew Elias,1979-08-27,2,2002,2004,8,27,USA
Derrill Burnham,1888-01-10,12,1912,1924,1,10,USA
Francis Bruce,1897-08-24,0,1921,1921,8,24,USA
Lester John,1887-10-08,1,1914,1915,10,8,USA
Thomas Jefferson,1844-01-26,0,1871,1871,1,26,USA
Todd Alan,1967-02-09,14,1992,2006,2,9,USA
John Arthur,1932-08-02,1,1963,1964,8,2,USA
Melvin Aloysius,1914-11-23,1,1940,1941,11,23,USA
James Bartholomew,1917-08-23,0,1948,1948,8,23,USA
Michael Thomas,1888-12-15,5,1914,1919,12,15,USA
George Pepper,1876-06-10,1,1901,1902,6,10,USA
George Bertrand,1931-03-27,0,1961,1961,3,27,Panama
Joseph Edward,1928-10-07,7,1951,1958,10,7,USA
Alexander Crawford,1985-07-25,7,2010,2017,7,25,USA
James Arthur,1961-10-23,7,1984,1991,10,23,USA
Thomas Ryan,1988-12-15,6,2013,2019,12,15,USA
Forest Charles,1906-08-08,4,1938,1942,8,8,USA
Walter B.,1868-04-06,0,1895,1895,4,6,USA
William G.,1863-06-10,0,1890,1890,6,10,USA
Bryan Cole,1986-11-13,0,2014,2014,11,13,USA
Bryan Roberts,1962-06-22,NA,NA,NA,6,22,USA
David Taylor,1985-08-26,11,2008,2019,8,26,USA
John Thomas Reid,1912-11-13,0,1946,1946,11,13,USA
Jimmie William,1941-10-13,4,1967,1971,10,13,USA
James Lyman,1847-09-20,NA,NA,NA,9,20,USA
Joseph Preston,1897-04-10,0,1928,1928,4,10,USA
Joseph Walter,1956-11-29,10,1980,1990,11,29,USA
Robert Alexander,1917-10-21,0,1939,1939,10,21,USA
Robert Simpson,1939-12-10,9,1962,1971,12,10,USA
Gerald Edward,1919-11-09,12,1941,1953,11,9,USA
Curtis John,1968-12-17,13,1993,2006,12,17,USA
Jason Orville,1983-10-09,7,2008,2015,10,9,USA
Eddie Lee,1974-04-08,0,1998,1998,4,8,USA
John Gooding,1891-06-23,1,1911,1912,6,23,USA
Alejandro Antonio,1976-06-19,1,2003,2004,6,19,Venezuela
Ariel,1969-10-22,6,1995,2001,10,22,Cuba
Christian Michael,1972-08-24,0,2005,2005,8,24,USA
Raymond Lee,1906-12-30,13,1933,1946,12,30,USA
Donald Mark,1938-04-05,0,1962,1962,4,5,USA
Joshua Cole,1988-01-26,0,2013,2013,1,26,USA
Thomas Albert,1964-08-13,16,1987,2003,8,13,USA
Walter Farr,1861-05-09,1,1883,1884,5,9,USA
Bret Randolph,1977-06-15,6,2001,2007,6,15,USA
Mark William,1980-09-07,4,2002,2006,9,7,USA
Harold William,1936-01-25,0,1957,1957,1,25,USA
Christopher Davis,1970-01-31,4,1996,2000,1,31,USA
James Arthur,1935-09-09,0,1959,1959,9,9,USA
Noah Richard,1900-10-27,0,1923,1923,10,27,USA
Scott Christopher,1977-01-02,7,2004,2011,1,2,USA
George,1864-05-30,2,1888,1890,5,30,USA
Jurickson Barthelomeus,1993-02-20,7,2012,2019,2,20,Curacao
Kenneth Luke,1978-02-23,2,2000,2002,2,23,Australia
Michael James,1950-12-15,7,1976,1983,12,15,USA
William Jacob,1895-03-10,0,1923,1923,3,10,USA
James Thompson,1893-07-16,6,1920,1926,7,16,USA
Herschel Clinton,1887-11-28,0,1912,1912,11,28,USA
John Olgus,1902-11-20,0,1929,1929,11,20,USA
Earl Henry,1895-04-02,0,1920,1920,4,2,USA
Hubert Shelby,1900-09-01,10,1922,1932,9,1,USA
James Calvin,1917-12-16,1,1944,1945,12,16,USA
Charles Leroy,1883-04-10,1,1907,1908,4,10,USA
Austin Daniel,1989-08-31,2,2017,2019,8,31,USA
Ronald Ralph,1951-10-21,8,1975,1983,10,21,USA
Gregory Russell,1949-10-02,10,1976,1986,10,2,USA
Stephen Michael,1989-07-23,2,2012,2014,7,23,USA
George Lawrence,1907-06-22,6,1930,1936,6,22,USA
Kirby,1960-03-14,11,1984,1995,3,14,USA
Troy Levi,1889-12-10,0,1911,1911,12,10,USA
Cesar David,1991-04-01,2,2017,2019,4,1,D.R.
Migel Antonio,1948-05-08,0,1970,1970,5,8,Mexico
Brandon Duane,1975-10-05,3,2002,2005,10,5,USA
Timothy Dean,1967-01-26,5,1992,1997,1,26,USA
John G.,1876-07-10,1,1898,1899,7,10,USA
Terry Stephen,1956-07-08,14,1977,1991,7,8,CAN
Richard Gerald,1953-03-16,0,1974,1974,3,16,USA
Yasiel,1990-12-07,6,2013,2019,12,7,Cuba
Jose Alberto,1980-01-16,18,2001,2019,1,16,D.R.
Luis Bienvenido,1955-11-18,8,1977,1985,11,18,D.R.
Andrew Jacob,1995-04-25,0,2019,2019,4,25,USA
Charles Michael,1955-02-07,8,1981,1989,2,7,USA
Alfonso,1957-01-23,3,1983,1986,1,23,Mexico
Juan Carlos,1971-08-05,10,1994,2004,8,5,Venezuela
Harvey Jerome,1967-10-20,6,1991,1997,10,20,USA
William Thomas,1973-10-09,10,1995,2005,10,9,USA
Spencer Armstrong,1893-04-11,0,1925,1925,4,11,USA
Nicholas Paul,1977-11-08,13,2001,2014,11,8,USA
William Aloysius,1854-03-16,11,1879,1890,3,16,USA
David Kent,1982-04-22,5,2008,2013,4,22,USA
John Nolan,1942-07-16,5,1964,1969,7,16,USA
Everett Virgil,1904-06-15,3,1926,1929,6,15,USA
Robert Thomas,1929-07-14,12,1954,1966,7,14,USA
Matthew Taylor,1990-07-17,0,2016,2016,7,17,USA
Jesse Rhoades,1881-05-11,0,1904,1904,5,11,USA
Oscar E.,1872-12-09,0,1895,1895,12,9,USA
William Patrick,1886-01-06,6,1908,1914,1,6,USA
Luke Webber,1986-05-10,2,2012,2014,5,10,USA
Eddy William,1953-09-25,3,1976,1979,9,25,USA
Daniel Christopher,1982-09-17,0,2007,2007,9,17,USA
Patrick Edward,1953-12-03,7,1977,1984,12,3,USA
Steven Zachary McGuire,1987-07-03,6,2011,2017,7,3,USA
Ambrose Nicholas,1880-09-09,3,1903,1906,9,9,USA
Joseph Jason,1977-02-22,11,2003,2014,2,22,USA
James Edward,1932-11-01,2,1955,1957,11,1,USA
John Nicholas,1931-11-25,0,1954,1954,11,25,USA
Robert Edward,1967-02-13,1,1994,1995,2,13,USA
Ewald,1910-08-27,6,1939,1945,8,27,USA
Harlan Albert,1905-11-29,0,1928,1928,11,29,USA
Harry Thomas,1861-11-29,3,1884,1887,11,29,USA
Frank Anthony,1908-07-30,14,1932,1946,7,30,USA
Timothy Matthew,1960-02-04,0,1986,1986,2,4,USA
Kevin Robert,1988-11-28,4,2014,2018,11,28,USA
Gregory Michael,1957-03-12,NA,NA,NA,3,12,USA
Chad Michael,1978-08-17,13,2004,2017,8,17,USA
James Robert,1946-10-09,3,1969,1972,10,9,USA
Thomas Francis,1935-04-01,5,1953,1958,4,1,USA
Cal Paul,1995-02-10,0,2019,2019,2,10,CAN
Paul John,1968-11-03,13,1992,2005,11,3,CAN
William H.,1870-06-25,2,1891,1893,6,25,USA
William Eddleman,1928-11-28,0,1954,1954,11,28,USA
Melvin Joseph,1918-03-04,10,1942,1952,3,4,USA
Melvin Douglas,1942-03-26,8,1964,1972,3,26,USA
George William,1903-02-10,0,1931,1931,2,10,USA
Carlos Jose,1982-08-28,8,2006,2014,8,28,USA
Juniel Alberto,1992-09-19,0,2016,2016,9,19,Venezuela
Joseph L.,1852-11-16,15,1871,1886,11,16,USA
Ruben Eduardo,1979-01-05,3,2000,2003,1,5,Venezuela
James Harold,1917-10-04,0,1939,1939,10,4,USA
Jose Gregorio,1995-11-09,0,2019,2019,11,9,Venezuela
Francis Ralph,1939-05-11,5,1965,1970,5,11,USA
Leon Abner,1882-05-05,1,1906,1907,5,5,USA
Thomas A.,1887-10-21,2,1913,1915,10,21,USA
Francis Patrick,1869-03-09,0,1891,1891,3,9,USA
Robb Michael,1977-03-17,7,2003,2010,3,17,USA
Thomas Raymond,1968-03-27,6,1990,1996,3,27,USA
Franklin Cady,1876-08-24,0,1899,1899,8,24,USA
Frank William,1927-11-27,1,1949,1950,11,27,USA
John Picus,1883-07-01,24,1909,1933,7,1,Slovakia
Joseph James,1862-12-24,17,1884,1901,12,24,Australia
John Edward,1885-09-12,0,1911,1911,9,12,USA
Mark David,1974-05-21,3,1999,2002,5,21,USA
Roman Tredarian,1993-05-14,3,2016,2019,5,14,USA
Clarence Carr,1881-09-25,1,1902,1903,9,25,USA
Thomas Oscar,1864-04-25,4,1886,1890,4,25,USA
Wellington Hunt,1918-05-14,0,1941,1941,5,14,USA
Luis Raul,1962-04-28,9,1983,1992,4,28,P.R.
Rey Francisco,1963-11-11,3,1986,1989,11,11,P.R.
Carlos Narcis,1965-08-26,5,1988,1993,8,26,Venezuela
Humberto,1979-08-02,11,2003,2014,8,2,Venezuela
Jose Guillermo,1989-01-24,7,2012,2019,1,24,Colombia
Luis Joaquin,1951-12-25,1,1974,1975,12,25,P.R.
Omar,1981-10-24,9,2005,2014,10,24,USA
Rafael Octavio,1969-09-07,0,1996,1996,9,7,D.R.
Arthur Lincoln,1938-04-11,1,1962,1963,4,11,USA
James Patrick,1954-10-22,17,1975,1992,10,22,USA
Guillermo Antonio,1981-11-29,10,2004,2014,11,29,Venezuela
Dan Raymond,1953-02-07,11,1979,1990,2,7,USA
Brian Charles,1967-11-05,2,1995,1997,11,5,USA
Joseph Patrick,1900-01-16,0,1922,1922,1,16,USA
John Andrew,1960-06-23,6,1982,1988,6,23,USA
Charles Henry,1932-05-06,1,1957,1958,5,6,USA
Joshua Wayne,1978-10-15,1,2006,2007,10,15,USA
Michael Gregory,1980-01-17,2,2006,2008,1,17,USA
Ryan Neil,1981-04-17,13,2004,2017,4,17,USA
Stephen Stepanovich,1916-12-05,0,1940,1940,12,5,USA
Marvin Eugene,1921-07-25,3,1947,1950,7,25,USA
Michael,1962-11-16,0,1992,1992,11,16,USA
Richard Raymond,1937-04-02,7,1962,1969,4,2,USA
Charles Gardner,1854-12-11,11,1880,1891,12,11,USA
George B.,1856-04-08,0,1883,1883,4,8,USA
John Young,1848-06-29,4,1871,1875,6,29,USA
Raymond Allen,1906-01-19,9,1934,1943,1,19,USA
Roy,1881-02-22,0,1911,1911,2,22,USA
David Martin,1948-12-26,9,1971,1980,12,26,USA
Donald Russell,1893-09-05,8,1913,1921,9,5,USA
Douglas Lee,1944-07-30,10,1967,1977,7,30,USA
Drew Leon,1901-05-14,0,1921,1921,5,14,USA
Paul Revere,1861-10-14,11,1883,1894,10,14,USA
Scott David,1968-03-03,11,1990,2001,3,3,USA
Brad William,1972-10-27,11,1995,2006,10,27,USA
Robert Vincent,1974-01-07,0,1999,1999,1,7,USA
Ryan Ashley,1971-08-09,0,1998,1998,8,9,CAN
Jack William,1913-04-14,0,1936,1936,4,14,USA
Harold Herman,1932-10-10,3,1954,1957,10,10,USA
Kenneth David,1917-08-08,15,1939,1954,8,8,USA
Albert Martin,1941-11-27,0,1969,1969,11,27,USA
John Cornelius,1875-02-20,0,1904,1904,2,20,USA
Thomas Francis,1881-10-05,0,1909,1909,10,5,USA
Don Carlos Patrick,1883-11-15,14,1909,1923,11,15,USA
Brady John,1972-09-17,6,1997,2003,9,17,USA
Frank Roland,1904-05-26,1,1932,1933,5,26,USA
Thomas,1946-06-16,2,1971,1973,6,16,USA
Eric James,1951-11-01,1,1975,1976,11,1,USA
Charles David,1954-07-14,5,1979,1984,7,14,USA
John M.,1864-07-16,3,1887,1890,7,16,USA
Lawrence Glenn Hope,1930-03-09,1,1957,1958,3,9,USA
Tanner Scott,1992-12-25,1,2018,2019,12,25,USA
Timothy,1959-09-16,23,1979,2002,9,16,USA
Timothy,1979-08-31,3,2001,2004,8,31,USA
Steven Nicholas,1975-06-02,1,1999,2000,6,2,USA
David Christopher,1951-09-28,2,1978,1980,9,28,USA
Gary Louis,1954-10-28,3,1982,1985,10,28,USA
Aaron James,1977-01-22,3,2004,2007,1,22,USA
Jason Paul,1973-06-29,2,1998,2000,6,29,USA
Edward Charles,1935-05-30,7,1960,1967,5,30,USA
John Austin,1887-04-21,1,1909,1910,4,21,USA
Brooks Lee,1988-06-29,1,2012,2013,6,29,USA
Samuel Beryl,1885-08-03,0,1910,1910,8,3,USA
Robert Louis,1917-01-16,7,1946,1953,1,16,USA
Elmer Donald,1916-08-01,1,1939,1940,8,1,USA
Warren Dawson,1906-11-01,0,1926,1926,11,1,USA
Daniel Allan,1957-05-01,0,1983,1983,5,1,USA
Alexander Ramon,1974-10-03,2,1998,2000,10,3,Venezuela
Alexei Fernando,1981-09-22,8,2008,2016,9,22,Cuba
Aramis,1978-06-25,17,1998,2015,6,25,D.R.
Carlos Alejandro,1991-04-24,1,2017,2018,4,24,D.R.
Edwar Emilio,1981-03-28,3,2007,2010,3,28,D.R.
Elizardo,1983-01-28,4,2004,2008,1,28,D.R.
Elvin,1987-10-10,0,2012,2012,10,10,D.R.
Erasmo,1976-04-29,4,2003,2007,4,29,USA
Erasmo Jose,1990-05-02,7,2012,2019,5,2,Nicaragua
Hanley,1983-12-23,14,2005,2019,12,23,D.R.
Harold Andres,1994-09-06,0,2019,2019,9,6,Colombia
Hector Bienvenido,1971-12-15,1,1999,2000,12,15,D.R.
Horacio,1979-11-24,8,2003,2011,11,24,USA
Juan Carlos,1988-08-16,6,2013,2019,8,16,Nicaragua
Jose Enrique,1992-09-17,6,2013,2019,9,17,D.R.
Jose Altagracia,1990-01-21,4,2014,2018,1,21,D.R.
Julio Cesar,1977-08-10,6,1999,2005,8,10,D.R.
Mario,1957-09-12,5,1980,1985,9,12,P.R.
Manuel Aristides,1972-05-30,18,1993,2011,5,30,D.R.
Maximiliano R.,1984-10-11,2,2008,2010,10,11,Venezuela
Milton,1950-04-02,9,1970,1979,4,2,P.R.
Neil Andrew,1989-05-25,5,2014,2019,5,25,USA
Nicholas Randolph,1989-08-01,0,2019,2019,8,1,USA
Noe,1989-12-22,4,2015,2019,12,22,USA
Orlando,1951-12-18,5,1974,1979,12,18,Colombia
Rafael Emilio,1958-02-18,12,1980,1992,2,18,D.R.
Ramon Emilio,1981-08-31,8,2006,2014,8,31,D.R.
Ramon A.,1982-09-16,1,2008,2009,9,16,Venezuela
Roberto,1971-08-17,1,1998,1999,8,17,Mexico
Santiago,1978-08-15,0,2006,2006,8,15,D.R.
Wilkin Emilio,1985-10-25,4,2009,2013,10,25,D.R.
Yefry,1993-11-28,1,2018,2019,11,28,D.R.
Alejandro,1986-09-20,6,2012,2018,9,20,USA
Roberto,1955-11-05,6,1978,1984,11,5,Cuba
Cesar,1984-06-22,7,2009,2016,6,22,USA
Jesus Manuel,1918-04-12,0,1944,1944,4,12,Venezuela
Domingo Antonio,1958-03-29,12,1978,1990,3,29,D.R.
Edgar Jose,1975-03-06,0,1997,1997,3,6,Venezuela
Edubray Eduar,1992-12-19,3,2016,2019,12,19,Venezuela
John Joseph,1965-08-06,0,1991,1991,8,6,USA
Kenneth Cecil,1967-06-06,0,1997,1997,6,6,USA
Mario Martin,1977-10-19,0,2003,2003,10,19,USA
Pedro,1935-04-28,15,1955,1970,4,28,Cuba
Wilson Abraham,1987-08-10,9,2010,2019,8,10,Venezuela
Robert Arthur,1973-12-03,1,1999,2000,12,3,USA
James Willard,1916-04-04,5,1947,1952,4,4,USA
William Thrace,1920-02-20,0,1945,1945,2,20,USA
Fernando David,1965-12-20,0,1992,1992,12,20,Panama
Matthew Garrett,1989-09-24,0,2019,2019,9,24,USA
Michael Jeffrey,1954-03-29,7,1978,1985,3,29,USA
Michael James,1960-07-08,0,1987,1987,7,8,USA
Thomas H.,1864-08-08,5,1885,1890,8,8,USA
Anthony Ronald,1989-09-09,2,2014,2016,9,9,USA
Robert Lee,1948-06-06,4,1976,1980,6,6,USA
Joseph Gregory,1969-12-18,11,1995,2006,12,18,USA
Newton John,1880-02-03,0,1907,1907,2,3,CAN
James Odell,1960-08-19,0,1988,1988,8,19,USA
Scott Philip,1975-10-29,0,2003,2003,10,29,USA
Richard Hilton,1931-03-07,4,1953,1957,3,7,USA
Leonard Shenoff,1949-02-12,11,1971,1982,2,12,USA
Stephen LeCharles,1974-05-01,4,2003,2007,5,1,Japan
Willie Larry,1954-07-06,17,1975,1992,7,6,USA
Merritt Thomas,1938-05-10,7,1962,1969,5,10,USA
Frank Robert Donald,1923-02-16,1,1949,1950,2,16,USA
Bryan Cody,1976-02-17,12,2001,2013,2,17,USA
Jeffrey Dean,1960-11-11,2,1981,1983,11,11,USA
Clayton Anthony,1981-03-09,6,2007,2013,3,9,USA
Earl Wellington,1921-05-20,3,1949,1952,5,20,USA
Joseph Aloysius,1894-02-06,2,1921,1923,2,6,USA
Patrick Leland,1967-07-13,9,1992,2001,7,13,USA
Vernon Fred,1928-05-11,NA,NA,NA,5,11,USA
William Angle,1888-02-05,11,1909,1920,2,5,USA
Victor John Angelo,1919-03-28,9,1946,1955,3,28,USA
Colby Ryan,1986-08-11,9,2009,2018,8,11,USA
Cory Taylor,1987-11-06,3,2013,2016,11,6,USA
Dennis Lee,1959-04-18,12,1983,1995,4,18,USA
Eric Ralph,1952-03-22,8,1975,1983,3,22,USA
Henry Florian,1895-04-18,0,1915,1915,4,18,USA
Robert Paul,1989-04-02,1,2014,2015,4,2,USA
Darrell Wayne,1981-01-13,3,2005,2008,1,13,USA
Frederick Helsher,1943-09-01,1,1968,1969,9,1,USA
Frederick Helsher,1973-01-05,0,1998,1998,1,5,USA
Alfred Gary,1973-01-10,1,1998,1999,1,10,USA
Morris Charles,1887-12-25,11,1909,1920,12,25,USA
Kelly Eugene,1945-09-28,0,1965,1965,9,28,USA
Jon Charles,1971-12-22,0,2000,2000,12,22,USA
Paul Hawthorne,1944-01-23,9,1963,1972,1,23,USA
Stephen Wayne,1953-09-09,1,1980,1981,9,9,USA
Thomas Jefferson,1870-12-01,3,1903,1906,12,1,USA
Robert John,1949-06-16,0,1972,1972,6,16,USA
Jon Erich,1978-09-27,11,2002,2013,9,27,USA
Robert Joyce,1942-03-14,1,1966,1967,3,14,USA
Douglas James,1948-12-15,9,1972,1981,12,15,USA
Clarence George,1952-08-20,2,1977,1979,8,20,USA
Rangel,1992-04-24,0,2019,2019,4,24,Cuba
Joshua Joseph,1988-01-21,3,2015,2018,1,21,USA
Shane William,1955-07-27,11,1978,1989,7,27,USA
John William,1892-08-17,12,1914,1926,8,17,USA
Carl Grady,1889-01-31,1,1915,1916,1,31,USA
Christopher Thomas,1982-01-12,6,2005,2011,1,12,USA
Curtis Lowell,1933-11-18,0,1958,1958,11,18,USA
Robert Henry,1886-09-17,0,1910,1910,9,17,USA
Floyd Kinnard,1957-07-27,7,1980,1987,7,27,USA
Irving Burton,1864-01-22,3,1888,1891,1,22,USA
James Francis,1944-12-01,9,1965,1974,12,1,USA
John Cornelius,1957-03-01,9,1981,1990,3,1,USA
Kenneth Alan,1974-11-27,7,1999,2006,11,27,USA
Larry Dale,1958-03-11,0,1982,1982,3,11,USA
Frederick Charles,1875-11-12,4,1901,1905,11,12,USA
Arthur Lawrence,1882-02-24,7,1904,1911,2,24,USA
Jean Claude Marc,1937-05-07,12,1959,1971,5,7,CAN
Harry H.,1862-02-20,4,1888,1892,2,20,USA
Louis Anthony,1894-12-11,0,1919,1919,12,11,USA
John Patrick,1984-01-04,0,2010,2010,1,4,USA
Robert Andrew,1984-01-21,1,2009,2010,1,21,USA
Robert Glenn,1991-10-01,5,2014,2019,10,1,USA
Barry John,1947-02-05,1,1973,1974,2,5,USA
Alfred James,1840-05-25,4,1871,1875,5,25,United Kingdom
Robert,1843-08-28,1,1872,1873,8,28,USA
Colin D.,1990-07-01,1,2015,2016,7,1,USA
Raudy Miguel,1993-10-29,2,2017,2019,10,29,D.R.
Randy Max,1960-01-08,12,1983,1995,1,8,USA
Arthur Garfield,1879-11-10,0,1903,1903,11,10,USA
Jacob Tyler,1991-03-18,5,2014,2019,3,18,USA
William Britt,1973-08-19,6,2000,2006,8,19,USA
Leroy,1943-08-11,0,1969,1969,8,11,USA
Jeffrey James,1955-10-01,15,1979,1994,10,1,USA
Philip Mark,1881-10-03,0,1906,1906,10,3,USA
Christopher Timothy,1987-12-05,0,2015,2015,12,5,USA
Arthur Anthony,1914-03-04,7,1938,1945,3,4,USA
Frank Beall,1944-06-07,4,1968,1972,6,7,USA
Jeffrey Allen,1964-04-30,11,1992,2003,4,30,USA
John,1859-10-29,1,1882,1883,10,29,USA
Philip,1862-06-07,8,1882,1890,6,7,USA
Anthony Vito,1983-08-29,6,2011,2017,8,29,USA
William Joshua,1987-02-19,10,2009,2019,2,19,USA
Philip Hayden,1890-01-25,1,1912,1913,1,25,USA
Timothy James,1978-02-12,8,2001,2009,2,12,USA
John Anthony,1909-09-24,0,1932,1932,9,24,Poland
George Howard,1902-04-07,1,1928,1929,4,7,USA
Peter Irvine,1954-08-25,6,1976,1982,8,25,USA
Joseph Randall,1961-01-14,3,1988,1991,1,14,USA
Mark Allen,1974-01-05,9,1999,2008,1,5,USA
Prentice Montezz,1979-08-23,0,2003,2003,8,23,USA
Julian Jawonn,1977-03-10,7,2000,2007,3,10,USA
Glenn Vincent,1948-01-11,0,1974,1974,1,11,USA
Harry John,1887-09-13,0,1909,1909,9,13,USA
John McKittrick,1910-09-03,0,1935,1935,9,3,USA
Michael Patrick,1971-05-05,12,1998,2010,5,5,USA
Todd Richard,1985-05-17,3,2012,2015,5,17,USA
Howard Wayne,1945-11-25,4,1965,1969,11,25,USA
Gary Eugene,1956-11-01,12,1982,1994,11,1,USA
Robert Scott,1951-01-05,0,1978,1978,1,5,USA
Addison Devon,1988-12-27,7,2011,2018,12,27,USA
Andrew Joseph,1993-05-10,3,2016,2019,5,10,USA
William Joseph,1922-11-12,0,1952,1952,11,12,USA
Robert Edward,1945-01-12,1,1969,1970,1,12,USA
Christopher William,1990-05-20,0,2015,2015,5,20,United Kingdom
Cody Austin,1993-04-15,3,2016,2019,4,15,USA
Darren A. Douglass,1965-10-16,2,1990,1992,10,16,USA
William Edgar,1922-02-20,0,1949,1949,2,20,USA
Nicholas,1867-03-22,0,1891,1891,3,22,USA
Eric Shane,1980-12-02,1,2006,2007,12,2,USA
Evan David,1985-12-31,1,2013,2014,12,31,USA
Howard Dean,1936-12-21,13,1958,1971,12,21,USA
Hugh A.,1852-05-10,0,1874,1874,5,10,USA
John Burwell,1933-02-02,2,1961,1963,2,2,USA
Jerry Maxwell,1955-10-08,9,1981,1990,10,8,USA
Jeffrey Scott,1962-11-12,16,1984,2000,11,12,USA
Jeremy Thomas,1981-06-15,7,2004,2011,6,15,USA
Jody Eric,1962-07-26,10,1987,1997,7,26,USA
Keith A.,1978-10-08,0,2005,2005,10,8,USA
Milton D.,1890-07-04,4,1911,1915,7,4,USA
Michael Benton,1992-11-18,4,2015,2019,11,18,USA
Richard Allen,1964-08-16,15,1988,2003,8,16,USA
Ronald Lee,1942-11-02,18,1966,1984,11,2,USA
Steven Vincent,1965-03-11,13,1992,2005,3,11,USA
Ralph Edwin,1890-10-18,0,1915,1915,10,18,USA
James Herman,1901-10-01,2,1930,1932,10,1,USA
Kevin Patrick,1978-03-11,1,2005,2006,3,11,USA
Harold Henry,1918-07-23,18,1940,1958,7,23,USA
Calvin,1973-06-10,7,1997,2004,6,10,USA
Andrew Jackson,1904-02-07,3,1927,1930,2,7,USA
Richard Benjamin,1941-09-29,9,1964,1973,9,29,USA
Stanley Milton,1899-02-25,0,1918,1918,2,25,USA
Robert Edwin,1904-06-24,5,1926,1931,6,24,USA
Robert Daniel,1991-03-26,3,2015,2018,3,26,South Korea
Rudolph Valentino,1930-05-21,2,1954,1956,5,21,USA
William Wright,1899-01-23,5,1926,1931,1,23,USA
Joseph Charles,1872-07-12,0,1898,1898,7,12,USA
Michael John,1887-11-19,2,1917,1919,11,19,USA
Philip Raymond,1937-04-06,12,1960,1972,4,6,USA
Nicholas D.,1978-09-04,1,2004,2005,9,4,USA
Steven Craig,1983-05-16,1,2008,2009,5,16,USA
Antone,1897-10-31,1,1924,1925,10,31,USA
Walter Phillip,1888-08-31,7,1912,1919,8,31,USA
Frank Bernard,1909-09-19,3,1933,1936,9,19,USA
Daniel Robert,1976-07-12,4,1999,2003,7,12,USA
Richard Wendell,1896-11-23,1,1922,1923,11,23,USA
Herman Charles,1917-11-23,0,1949,1949,11,23,USA
Frederic Carl,1943-03-16,10,1964,1974,3,16,USA
William Alexander,1857-05-17,1,1883,1884,5,17,CAN
Earl Percy,1913-06-08,0,1946,1946,6,8,USA
Sean Ian,1995-08-30,1,2018,2019,8,30,Guam
Jessie Thomas,1962-06-01,1,1987,1988,6,1,USA
Ryan Allen,1985-04-24,0,2013,2013,4,24,USA
Scott Donald,1947-01-07,1,1969,1970,1,7,USA
William Joseph,1873-10-09,8,1896,1904,10,9,USA
Archer Edwin,1891-08-17,0,1917,1917,8,17,USA
Bernard Eugene,1884-02-07,0,1909,1909,2,7,USA
Charles Thomas,1867-02-15,8,1889,1897,2,15,USA
Alexander Aloysius,1884-08-25,0,1909,1909,8,25,USA
Harold John,1894-04-01,0,1919,1919,4,1,USA
John Good,1858-10-05,11,1880,1891,10,5,USA
William Henry,1868-05-09,0,1896,1896,5,9,USA
Thomas Henry,1884-08-03,6,1908,1914,8,3,USA
Kevin Michael,1964-06-28,5,1988,1993,6,28,USA
Nolan G.,1983-10-12,7,2009,2016,10,12,USA
Michael Wayne,1949-08-06,0,1974,1974,8,6,USA
Chad Karl,1982-04-09,3,2008,2011,4,9,USA
Walter Joseph,1890-04-21,0,1915,1915,4,21,USA
Arthur Conrad,1899-05-29,9,1919,1928,5,29,USA
Arthur August,1903-01-27,0,1928,1928,1,27,USA
John Patrick,1992-07-19,1,2017,2018,7,19,USA
Zachary Ryan,1993-01-28,2,2017,2019,1,28,USA
Charles W.,1856-02-07,4,1883,1887,2,7,USA
Robert Joseph Thomas,1909-01-02,7,1931,1938,1,2,USA
Harold Patrick,1919-03-17,12,1940,1952,3,17,USA
Jacob,1887-12-12,0,1911,1911,12,12,USA
Charles,1861-08-28,0,1884,1884,8,28,USA
Harrie Crane,1891-06-14,0,1911,1911,6,14,USA
Laurence P.,1858-11-20,1,1877,1878,11,20,USA
Frank Carl,1874-07-25,6,1904,1910,7,25,USA
Albert Allen,1909-01-08,0,1932,1932,1,8,USA
Thomas Edward,1914-08-06,0,1938,1938,8,6,USA
Brian Eric,1978-02-28,3,2001,2004,2,28,USA
Christopher Michael,1977-12-31,6,2001,2007,12,31,USA
Henry Peter,1867-06-29,6,1893,1899,6,29,USA
Kenneth John,1951-06-24,10,1972,1982,6,24,USA
Bryan Robert,1972-06-03,7,1995,2002,6,3,USA
Desmond Lamont,1973-09-16,11,1996,2007,9,16,USA
Willis John,1878-03-14,0,1904,1904,3,14,USA
Michael John,1966-03-23,15,1991,2006,3,23,USA
Wilhelmus Abraham,1954-03-08,1,1979,1980,3,8,Netherlands
Alexander Norman,1886-02-21,3,1912,1915,2,21,USA
Gerald Peter,1952-11-08,9,1975,1984,11,8,USA
Anthony John,1991-01-24,2,2016,2018,1,24,USA
Anthony Michael,1990-06-06,6,2013,2019,6,6,USA
Erwin Arthur,1891-12-11,0,1913,1913,12,11,USA
Dustin Hunter,1992-01-28,3,2016,2019,1,28,USA
Cohen Willams,1962-05-09,0,1991,1991,5,9,USA
Marshall Daniel,1936-05-25,0,1959,1959,5,25,USA
Luis Jose,1997-02-26,0,2019,2019,2,26,Venezuela
Warren Richard,1944-03-16,4,1968,1972,3,16,USA
Harold Eugene,1938-07-02,6,1961,1967,7,2,USA
James David,1915-03-07,1,1938,1939,3,7,USA
Steven,1944-12-10,14,1969,1983,12,10,USA
William Beneditto,1924-10-14,6,1953,1959,10,14,USA
George Anthony,1901-09-29,9,1930,1939,9,29,USA
Edgar Enrique,1976-08-07,15,1996,2011,8,7,Colombia
Richard Avina,1961-12-25,8,1986,1994,12,25,USA
Robert Willis,1917-11-06,3,1939,1942,11,6,USA
Jason Edward,1980-12-27,7,2005,2012,12,27,USA
Andrew David,1953-10-07,1,1978,1979,10,7,USA
Roger Allen,1940-08-03,8,1964,1972,8,3,USA
Eldon John,1928-10-04,8,1953,1961,10,4,USA
Xavier Frederick,1912-10-13,2,1943,1945,10,13,USA
Christopher Paul,1982-11-04,8,2005,2013,11,4,USA
Lawrence P.,1848-08-10,0,1875,1875,8,10,France
Dino Paolo,1924-09-23,2,1949,1951,9,23,USA
Michael Jerome,1979-01-03,5,2002,2007,1,3,USA
Mervin Weldon,1943-06-06,12,1968,1980,6,6,USA
George Edward,1868-07-29,1,1891,1892,7,29,USA
Adolph John,1894-01-29,0,1922,1922,1,29,USA
Kenneth Leo,1934-04-30,3,1961,1964,4,30,USA
Edward Marvin,1882-12-01,12,1905,1917,12,1,USA
Paul Richard,1947-01-12,4,1975,1979,1,12,USA
Rickey Eugene,1949-05-16,19,1972,1991,5,16,USA
Jerry,1949-06-19,21,1969,1990,6,19,USA
Todd Michael,1969-06-28,0,1992,1992,6,28,USA
Ben Daniel,1988-05-03,7,2010,2017,5,3,USA
David Allen,1953-02-12,4,1978,1982,2,12,USA
Rafael Alberto,1970-04-10,13,1995,2008,4,10,D.R.
Alexander,1994-08-29,3,2016,2019,8,29,USA
Anthony Loza,1981-10-16,4,2005,2009,10,16,USA
Argenis N.,1982-09-25,1,2008,2009,9,25,D.R.
Carlos Alberto,1969-04-04,9,1994,2003,4,4,USA
Dennys,1977-04-19,14,1997,2011,4,19,Mexico
Franmil Federico,1995-07-07,1,2018,2019,7,7,D.R.
Gerardo,1993-05-13,0,2019,2019,5,13,Mexico
Gilberto Rolando,1963-12-10,8,1983,1991,12,10,D.R.
Jesus Enmanuel,1993-02-21,0,2018,2018,2,21,D.R.
Jose Bernabe,1983-06-11,15,2003,2018,6,11,D.R.
Jose Ariel,1983-02-26,0,2006,2006,2,26,D.R.
Joseph Albert,1984-11-20,9,2007,2016,11,20,USA
Napoleon Aguilera,1919-11-24,7,1943,1950,11,24,Cuba
Pablo,1993-09-05,1,2018,2019,9,5,D.R.
Rene,1978-02-21,1,2003,2004,2,21,Venezuela
Victor Jose,1994-10-05,1,2018,2019,10,5,Venezuela
Allie Pierce,1917-02-10,12,1942,1954,2,10,USA
Archie Edward,1946-01-03,4,1968,1972,1,3,USA
Armando Martin,1966-05-01,11,1991,2002,5,1,Mexico
William Dee,1884-08-14,1,1913,1914,8,14,USA
Robert Allen,1947-01-21,6,1969,1975,1,21,USA
Bryan Patrick,1995-01-27,0,2019,2019,1,27,USA
Carl Nettles,1903-02-01,12,1927,1939,2,1,USA
Thomas Hart,1855-06-29,0,1882,1882,6,29,USA
Charles Lawrence,1865-05-01,0,1889,1889,5,1,USA
Gordon Craig,1952-12-27,14,1975,1989,12,27,USA
Daniel Vance,1919-11-26,0,1945,1945,11,26,USA
Donald Edward,1953-04-16,1,1978,1979,4,16,USA
Gregory Adam,1985-07-03,5,2008,2013,7,3,USA
Harold Craig,1960-11-26,11,1983,1994,11,26,USA
Kenneth Lee,1947-01-04,6,1970,1976,1,4,USA
Mark Andrew,1983-08-03,12,2007,2019,8,3,USA
Matthew Paul,1984-10-02,6,2010,2016,10,2,USA
Matthew William,1990-12-03,2,2016,2018,12,3,USA
Robert James,1959-04-19,7,1983,1990,4,19,USA
Ross Ernest,1887-08-20,1,1914,1915,8,20,USA
Ronn Dwayne,1958-09-28,8,1982,1990,9,28,USA
Richard Shane,1968-03-26,12,1992,2004,3,26,USA
Tommie D.,1941-08-15,9,1963,1972,8,15,USA
Jacob Alan,1993-03-16,2,2017,2019,3,16,USA
Robert John,1919-02-13,2,1947,1949,2,13,USA
Kenneth Johnston,1893-09-28,1,1914,1915,9,28,USA
John Philip,1979-05-29,1,2006,2007,5,29,USA
Charles Flint,1901-01-24,12,1924,1936,1,24,USA
William Joseph,1900-08-16,4,1929,1933,8,16,USA
William Pearl,1869-03-14,9,1890,1899,3,14,USA
Barton Emory,1879-10-04,7,1902,1909,10,4,USA
Arthur Lee,1969-10-24,20,1991,2011,10,24,USA
William Clarence,1871-06-27,0,1893,1893,6,27,USA
Charles Anderson,1885-04-07,3,1906,1909,4,7,USA
James Lamar,1927-05-13,7,1952,1959,5,13,USA
John Gordon,1907-08-11,7,1929,1936,8,11,USA
Karl Derrick,1968-08-21,5,1990,1995,8,21,USA
Richard Alan,1953-05-16,15,1974,1989,5,16,USA
Kevin Jay,1955-11-22,2,1982,1984,11,22,USA
William Daniel,1983-04-01,2,2010,2012,4,1,USA
Harold J.,1899-03-30,7,1926,1933,3,30,USA
Dennis Joseph,1941-09-20,5,1964,1969,9,20,USA
Frank Joseph,1953-02-24,3,1976,1979,2,24,USA
Charles Mark,1968-11-20,0,1995,1995,11,20,USA
Robert Turnbull,1899-05-28,0,1926,1926,5,28,USA
Delbert W.,1922-10-27,16,1945,1961,10,27,USA
Harry Francis,1901-11-22,10,1923,1933,11,22,USA
Harold Housten,1924-02-11,6,1948,1954,2,11,USA
James Edward,1953-03-08,15,1974,1989,3,8,USA
Leonard Oliver,1918-09-02,1,1944,1945,9,2,USA
Patrick Edward,1963-11-02,0,1991,1991,11,2,USA
Edgar Charles,1890-02-20,19,1915,1934,2,20,USA
Scott Adam,1981-09-21,1,2013,2014,9,21,USA
Antoan Edward,1983-10-08,3,2011,2014,10,8,Bahamas
William Henry,1878-01-24,0,1901,1901,1,24,USA
Robert Clinton,1935-08-19,11,1955,1966,8,19,USA
Christopher Robert,1974-06-07,9,2000,2009,6,7,USA
Clayton Colby,1983-09-12,11,2008,2019,9,12,USA
Daniel,1863-01-25,10,1884,1894,1,25,USA
Danny Adam,1983-06-09,2,2007,2009,6,9,D.R.
Duane Lee,1936-12-16,0,1960,1960,12,16,USA
Dustin A.,1984-01-09,1,2009,2010,1,9,USA
Frederick Charles,1927-11-03,0,1951,1951,11,3,USA
Garrett Thomas,1988-05-27,8,2011,2019,5,27,USA
Eugene,1953-09-29,7,1977,1984,9,29,USA
Gordon Clark,1938-07-19,2,1964,1966,7,19,USA
Abram Harding,1855-04-21,13,1879,1892,4,21,USA
John William,1892-10-03,1,1915,1916,10,3,USA
Jeffrey Scott,1965-08-26,4,1989,1993,8,26,USA
Jeffrey Scott,1963-08-29,0,1990,1990,8,29,USA
James Rodney,1950-03-07,9,1971,1980,3,7,USA
Kenneth Franklin,1915-05-02,4,1942,1946,5,2,USA
Kevin Grant,1980-09-12,0,2009,2009,9,12,USA
Lee Edward,1948-09-18,5,1971,1976,9,18,USA
Michael Anthony,1958-05-24,4,1980,1984,5,24,USA
Clifford Nolen,1903-01-18,10,1929,1939,1,18,USA
Paul Rapier,1908-11-21,14,1932,1946,11,21,USA
Russell Earl,1965-01-27,1,1989,1990,1,27,USA
Thomas Mitchell,1883-08-07,0,1917,1917,8,7,USA
Trevor Michael,1993-05-15,1,2018,2019,5,15,USA
Lance Clayton,1897-12-18,11,1921,1932,12,18,USA
Peter Gerard,1939-10-29,12,1962,1974,10,29,USA
Elwood Lewis,1883-08-23,7,1906,1913,8,23,USA
Robert Eugene,1965-09-05,0,1989,1989,9,5,USA
Beryl Justice,1907-08-24,1,1933,1934,8,24,USA
Donald Lester,1919-10-27,10,1941,1951,10,27,USA
John H.,1855-03-05,10,1875,1885,3,5,USA
J Lee,1857-05-05,7,1879,1886,5,5,USA
Raymond Sinclair,1896-06-05,1,1920,1921,6,5,USA
Scott Daniel,1979-08-30,4,2008,2012,8,30,CAN
Allen Gordon,1927-02-07,2,1951,1953,2,7,USA
John Marcellus,1873-02-08,0,1898,1898,2,8,USA
Emil Henry,1888-09-14,0,1911,1911,9,14,Germany
Woodrow Earl,1916-03-09,5,1939,1944,3,9,USA
Joseph Mark,1991-05-21,3,2016,2019,5,21,USA
Wesley Branch,1881-12-20,9,1905,1914,12,20,USA
David William,1935-07-12,7,1963,1970,7,12,USA
Richard James,1933-12-04,0,1959,1959,12,4,USA
Joseph Francis,1876-12-12,3,1898,1901,12,12,USA
Marvin August,1921-01-08,8,1942,1950,1,8,USA
Christian,1859-10-07,0,1884,1884,10,7,USA
John J.,1867-09-26,3,1891,1894,9,26,USA
Arthur Ramon,1895-07-23,1,1916,1917,7,23,USA
Alfredo Cruz,1944-07-04,0,1969,1969,7,4,USA
Henry Paul,1897-05-17,7,1923,1930,5,17,USA
Dennis Michael,1945-11-22,2,1970,1972,11,22,USA
Dorsey Lee,1875-03-25,0,1899,1899,3,25,USA
Elmer Ray,1914-07-31,10,1939,1949,7,31,USA
John Ludy,1905-10-03,18,1930,1948,10,3,USA
Joshua Travis,1991-10-12,2,2017,2019,10,12,USA
Gregory Lee,1945-07-17,NA,NA,NA,7,17,USA
Jacob Augustus,1888-07-23,0,1914,1914,7,23,USA
Jeffrey Allen,1980-08-17,1,2007,2008,8,17,USA
Stephen George,1929-04-29,16,1950,1966,4,29,USA
Harvey Donald,1921-10-10,7,1942,1949,10,10,USA
John Richard,1975-08-29,5,2000,2005,8,29,USA
Charles Joseph,1990-01-30,1,2014,2015,1,30,USA
Elmer Jay,1889-02-25,0,1910,1910,2,25,USA
Andre Albanez,1988-07-05,2,2013,2015,7,5,Brazil
Damon Nikco,1967-01-11,0,1991,1991,1,11,USA
Bradley Kenneth,1973-05-14,3,1997,2000,5,14,USA
Paul David,1975-11-02,1,2000,2001,11,2,USA
Jerrod Ashley,1974-05-16,3,2000,2003,5,16,USA
Shawn Willis,1980-07-25,3,2006,2009,7,25,USA
Joseph Aloysius,1886-12-11,8,1911,1919,12,11,USA
James David,1952-11-09,NA,NA,NA,11,9,USA
Adam David,1972-10-04,7,1997,2004,10,4,USA
Lewis Sidney,1910-04-22,12,1934,1946,4,22,USA
David Allan,1958-11-28,16,1979,1995,11,28,USA
Ronald Gene,1964-09-05,0,1995,1995,9,5,USA
William Joseph,1918-01-29,7,1946,1953,1,29,USA
John Dungan,1914-10-28,10,1937,1947,10,28,USA
Emory Elmo,1897-01-07,5,1922,1927,1,7,USA
Jose Antonio,1965-05-13,18,1984,2002,5,13,D.R.
Culley,1914-05-09,6,1941,1947,5,9,USA
Ernest,1960-10-02,8,1985,1993,10,2,USA
Michael Austin,1997-04-02,0,2019,2019,4,2,USA
George Michael,1956-10-06,7,1979,1986,10,6,USA
James Joseph,1886-11-10,0,1910,1910,11,10,USA
James Norman,1895-05-25,2,1921,1923,5,25,CAN
Leon Francis,1906-08-20,0,1944,1944,8,20,USA
Matthew Paul,1979-08-02,6,1999,2005,8,2,USA
Andrew John,1959-03-05,2,1980,1982,3,5,USA
Juan Manuel,1979-01-23,9,2001,2010,1,23,Venezuela
Ricardo,1970-04-13,11,1997,2008,4,13,Mexico
Jeffrey Alan,1955-07-03,0,1979,1979,7,3,USA
James Joseph,1895-02-15,11,1917,1928,2,15,USA
Frank C.,1860-10-12,3,1883,1886,10,12,USA
Roger Royce,1980-12-21,5,2005,2010,12,21,USA
Robert John,1921-04-21,0,1950,1950,4,21,USA
Alexis Israel,1981-02-18,11,2004,2015,2,18,USA
Armando,1971-09-13,5,1998,2003,9,13,P.R.
Daniel,1972-11-11,1,1997,1998,11,11,Spain
Edwin Gabriel,1994-04-21,0,2019,2019,4,21,P.R.
Juan Onofre Velez,1942-07-14,0,1969,1969,7,14,P.R.
Yacksel,1993-06-27,2,2017,2019,6,27,P.R.
William Oliver,1964-12-16,11,1987,1998,12,16,USA
Calvin Edwin,1960-08-24,20,1981,2001,8,24,USA
Calvin Edwin,1935-12-17,NA,NA,NA,12,17,USA
Allen Stevens,1952-10-18,4,1978,1982,10,18,USA
Walter Franklin,1916-11-26,0,1935,1935,11,26,USA
Raymond Roy,1933-07-09,0,1962,1962,7,9,USA
Charles Dawson,1920-12-01,2,1944,1946,12,1,USA
James Albert,1909-10-14,7,1936,1943,10,14,USA
Charles August,1894-10-13,3,1917,1920,10,13,USA
Percival Sumner,1877-01-24,0,1905,1905,1,24,USA
David Richard,1976-10-23,11,1999,2010,10,23,USA
William Charles,1967-05-29,6,1992,1998,5,29,USA
Claude Cassius,1873-10-05,12,1897,1909,10,5,USA
Jay Seay,1936-11-20,4,1964,1968,11,20,USA
Todd Everett,1971-11-07,7,1997,2004,11,7,USA
Wallace Reid,1965-07-12,5,1987,1992,7,12,USA
Floyd Alexander,1870-06-01,0,1890,1890,6,1,USA
William Herbert,1893-10-12,4,1912,1916,10,12,USA
Lewis Elmer,1875-09-07,6,1902,1908,9,7,USA
Reggie Blake,1960-01-23,1,1986,1987,1,23,USA
Edward West,1855-04-26,0,1876,1876,4,26,USA
James Michael,1944-10-23,0,1970,1970,10,23,USA
Kevin D.,1965-06-08,9,1989,1998,6,8,USA
Luis Wilfredo,1979-08-30,8,2000,2008,8,30,Venezuela
Bienvenido,1968-01-11,2,1992,1994,1,11,D.R.
Jesus Manuel,1952-08-02,7,1975,1982,8,2,P.R.
Carlos Alberto,1978-06-10,1,2003,2004,6,10,P.R.
Carlos Luis,1988-05-20,0,2014,2014,5,20,Venezuela
Felipe Javier,1991-07-05,4,2015,2019,7,5,Venezuela
German,1960-07-06,2,1983,1985,7,6,P.R.
Manuel Joseph,1921-07-22,9,1952,1961,7,22,USA
Juan Luis,1978-07-03,11,2001,2012,7,3,Venezuela
Luis Antonio,1964-01-03,12,1986,1998,1,3,P.R.
Luis,1978-06-21,0,2000,2000,6,21,Mexico
Mariano,1969-11-29,18,1995,2013,11,29,Panama
John Milton,1948-10-30,14,1970,1984,10,30,USA
Michael Rene,1976-09-08,10,2001,2011,9,8,P.R.
Rene,1983-07-31,15,2004,2019,7,31,P.R.
Roberto,1969-01-01,4,1995,1999,1,1,P.R.
Ruben,1973-11-14,8,1995,2003,11,14,Panama
Rabell Saul,1977-12-07,4,2006,2010,12,7,P.R.
Thomas Javier,1988-10-27,1,2016,2017,10,27,USA
Yadiel,1992-05-02,4,2015,2019,5,2,P.R.
Arthur Bernard,1899-08-02,4,1921,1925,8,2,USA
Eppa,1891-05-03,21,1912,1933,5,3,USA
Anthony Vincent,1989-08-08,8,2011,2019,8,8,USA
John Costa,1912-07-30,4,1938,1942,7,30,USA
Todd Michael,1971-05-24,1,1998,1999,5,24,USA
Philip Francis,1917-09-25,15,1941,1956,9,25,USA
Sendy,1980-06-21,0,2006,2006,6,21,D.R.
Donn Mitchell,1989-12-14,2,2014,2016,12,14,USA
Jason Glenn,1976-04-20,0,2003,2003,4,20,USA
John F.,1867-11-19,0,1887,1887,11,19,USA
Melvin Earl,1933-01-25,9,1953,1962,1,25,USA
Michael Stephen,1869-12-23,0,1899,1899,12,23,USA
Wilbur Charles,1882-11-28,5,1910,1915,11,28,USA
Rudolph Charles,1871-10-20,0,1899,1899,10,20,Poland
Joseph Rodger,1971-10-11,9,1995,2004,10,11,USA
Michael Thomas,1930-11-08,3,1961,1964,11,8,USA
Tanner B.,1986-10-05,6,2013,2019,10,5,USA
Frederick R.,1867-11-10,2,1890,1892,11,10,USA
Bruce Duane,1959-09-10,1,1979,1980,9,10,USA
Phillip Jacob,1976-05-23,0,2004,2004,5,23,USA
Thomas Vardasco,1913-02-09,1,1933,1934,2,9,USA
Andre Levett,1957-10-02,4,1981,1985,10,2,USA
Bertrand Roland,1954-10-03,7,1979,1986,10,3,USA
Leon Joseph,1963-10-27,12,1986,1998,10,27,USA
Robert Eugene,1946-10-02,12,1967,1979,10,2,USA
Brian Michael,1977-10-09,13,2001,2014,10,9,USA
Charles Culbertson,1896-01-31,9,1919,1928,1,31,USA
Christopher William,1979-08-23,1,2006,2007,8,23,USA
James Connor,1981-09-10,1,2007,2008,9,10,USA
Curtis Benjamin,1929-08-16,2,1954,1956,8,16,USA
Davis Aydelotte,1889-09-25,10,1912,1922,9,25,USA
Daryl Berdene,1936-01-05,0,1962,1962,1,5,USA
David Leonard,1933-06-30,4,1962,1966,6,30,Panama
Dale,1942-04-12,0,1967,1967,4,12,USA
David Arthur,1944-09-11,12,1969,1981,9,11,USA
David Wayne,1951-02-17,10,1972,1982,2,17,USA
David Ray,1972-05-31,9,1999,2008,5,31,Japan
David Alan,1985-04-09,11,2008,2019,4,9,USA
Daniel Roger,1985-09-30,3,2014,2017,9,30,USA
Daniel Ray,1994-03-22,2,2017,2019,3,22,USA
Preston James,1891-09-16,6,1913,1919,9,16,USA
Donald Alexander,1930-10-15,0,1954,1954,10,15,USA
Eugene Edward,1899-12-25,11,1919,1930,12,25,USA
Grant William,1977-09-13,4,2000,2004,9,13,USA
Jerry Lee,1943-10-13,1,1969,1970,10,13,USA
Jeriome Paul,1977-03-30,2,2002,2004,3,30,USA
James Newsom,1895-10-13,1,1924,1925,10,13,USA
Alfred James,1928-01-29,1,1954,1955,1,29,USA
Kevin Lynn,1968-01-29,3,1993,1996,1,29,USA
Kenneth Elwin,1988-03-09,0,2015,2015,3,9,USA
Leon Kauffman,1951-01-22,10,1974,1984,1,22,USA
Michael Francis,1970-10-09,2,1996,1998,10,9,USA
Nathan Daniel,1977-09-03,8,2002,2010,9,3,USA
Raymond,1895-08-25,0,1919,1919,8,25,USA
Charles Emory,1918-08-08,0,1943,1943,8,8,USA
Richard Paul,1944-10-14,5,1966,1971,10,14,USA
Richard Wayne,1968-09-15,5,1993,1998,9,15,USA
Robin Evan,1926-09-30,18,1948,1966,9,30,USA
Ryan Alan,1980-09-19,8,2006,2014,9,19,USA
Sherrard Alexander,1919-01-01,12,1940,1952,1,1,CAN
Sidney Dean,1971-09-07,0,1995,1995,9,7,USA
Clarence Ashley,1888-01-11,1,1913,1914,1,11,USA
Joseph Albert Armand,1917-05-19,5,1941,1946,5,19,USA
Tyler Patrick,1987-12-23,1,2012,2013,12,23,USA
Willis Augusto,1975-06-19,5,1999,2004,6,19,D.R.
William Joseph,1964-01-13,5,1985,1990,1,13,USA
Aaron Andrew,1915-06-23,8,1943,1951,6,23,USA
William,1865-01-19,0,1889,1889,1,19,USA
William Henry,1943-06-26,17,1966,1983,6,26,USA
Brooks Calbert,1937-05-18,22,1955,1977,5,18,USA
Bruce Philip,1954-04-16,2,1978,1980,4,16,USA
Charles Henry,1856-07-27,1,1884,1885,7,27,USA
Christopher James,1984-05-12,0,2013,2013,5,12,CAN
Clinton Michael,1985-02-16,4,2012,2016,2,16,USA
Craig George,1948-08-21,5,1972,1977,8,21,USA
David Tanner,1946-05-22,1,1970,1971,5,22,USA
Dewey Everett,1955-04-28,2,1979,1981,4,28,USA
Derrick Lamar,1987-09-28,0,2013,2013,9,28,USA
Don Allen,1957-06-08,14,1978,1992,6,8,USA
Drew Elliott,1992-04-20,2,2017,2019,4,20,USA
Earl John,1936-11-03,6,1958,1964,11,3,USA
William Edward,1920-12-15,15,1942,1957,12,15,USA
Floyd Andrew,1936-05-09,8,1960,1968,5,9,USA
Frederic Henry,1856-07-06,0,1884,1884,7,6,USA
Frank,1935-08-31,20,1956,1976,8,31,USA
John Henry,1887-08-16,7,1911,1918,8,16,USA
Humberto Valentino,1930-06-25,5,1955,1960,6,25,Panama
John Washburn,1880-07-15,0,1902,1902,7,15,USA
Jack Roosevelt,1919-01-31,9,1947,1956,1,31,USA
John Edward,1921-02-20,0,1949,1949,2,20,USA
Jeffrey Daniel,1960-12-13,8,1984,1992,12,13,USA
Jeffrey Mark,1961-12-14,5,1987,1992,12,14,USA
Kenneth Neal,1969-11-03,2,1995,1997,11,3,USA
Kerry Keith,1973-10-03,8,1998,2006,10,3,USA
William Clyde,1882-03-05,7,1903,1910,3,5,USA
Ronald Dean,1962-03-24,8,1984,1992,3,24,USA
Shane Michael,1984-10-30,9,2009,2018,10,30,USA
Trayvon Andrew Dwayne,1987-09-01,1,2011,2012,9,1,USA
Alfred Valentine,1848-08-31,0,1872,1872,8,31,USA
Wilbert,1864-06-29,16,1886,1902,6,29,USA
William H.,1859-09-19,10,1882,1892,9,19,USA
Martin Stanford,1854-03-30,NA,NA,NA,3,30,USA
Joseph Anthony,1879-03-02,1,1904,1905,3,2,USA
Hansel Manuel,1990-08-13,4,2015,2019,8,13,D.R.
Mauricio Antonio,1989-03-05,0,2013,2013,3,5,Venezuela
Oscar Manuel,1976-04-09,2,2005,2007,4,9,Mexico
Rafael Orlando,1947-10-20,3,1969,1972,10,20,D.R.
Sergio,1946-04-16,4,1972,1976,4,16,Mexico
Victor Enrique,1997-05-19,2,2017,2019,5,19,D.R.
Thomas James,1946-01-15,1,1974,1975,1,15,USA
Michael Dominick,1916-03-02,3,1943,1946,3,2,USA
Armando,1926-12-07,0,1945,1945,12,7,Cuba
Bennett Harold,1896-08-15,0,1914,1914,8,15,USA
John Joseph,1890-11-22,3,1914,1917,11,22,USA
Louis Joseph,1919-01-11,0,1944,1944,1,11,USA
Michael Joseph,1963-03-14,2,1988,1990,3,14,USA
Isaac Broc,1876-11-03,1,1905,1906,11,3,USA
John Loy,1974-10-17,5,1998,2003,10,17,USA
Patrick Edward,1955-01-09,2,1976,1978,1,9,USA
Lester Henry,1912-08-19,0,1936,1936,8,19,USA
Richard Martin,1959-11-07,1,1983,1984,11,7,USA
Kenneth Andre Ian,1934-12-02,10,1957,1967,12,2,Bahamas
Wilbur Kincaid,1887-04-18,1,1915,1916,4,18,USA
William Sherman,1922-12-05,1,1944,1945,12,5,USA
Brady Paul,1990-09-17,3,2016,2019,9,17,USA
Brendan Austin,1996-08-09,0,2019,2019,8,9,USA
Robert Leroy,1938-08-16,8,1961,1969,8,16,USA
Eric Chapman,1930-02-05,0,1954,1954,2,5,USA
Fernando,1977-03-18,17,2002,2019,3,18,D.R.
Carlos Antonio,1992-12-10,4,2015,2019,12,10,USA
Alexander Enmanuel,1975-07-27,22,1994,2016,7,27,USA
Aneury,1987-12-13,1,2011,2012,12,13,D.R.
Aurelio,1947-12-28,16,1967,1983,12,28,Mexico
Carlos,1967-11-01,4,1991,1995,11,1,Mexico
Ivan Dereck,1992-06-05,1,2018,2019,6,5,USA
Eduardo,1952-03-06,6,1973,1979,3,6,P.R.
Edwin,1960-08-14,3,1982,1985,8,14,P.R.
Eddy,1981-08-08,2,2004,2006,8,8,D.R.
Eddy,1985-12-01,0,2012,2012,12,1,Cuba
Eduardo Jose,1993-04-07,4,2015,2019,4,7,Venezuela
Eliseo,1946-05-24,8,1968,1976,5,24,P.R.
Felix Antonio,1972-09-09,11,1995,2006,9,9,D.R.
Fernando,1984-06-18,7,2009,2016,6,18,USA
Fernando Pedro,1924-04-29,1,1958,1959,4,29,Cuba
Francisco,1972-12-11,6,1995,2001,12,11,USA
Francisco Jose,1982-01-07,15,2002,2017,1,7,Venezuela
Francisco,1983-02-26,1,2010,2011,2,26,Mexico
Guillermo Segundo,1978-05-15,2,2007,2009,5,15,Venezuela
Guilder Alfredo,1983-07-24,0,2014,2014,7,24,Venezuela
Hector Antonio,1920-06-13,0,1952,1952,6,13,Cuba
Henry Anderson,1967-11-08,10,1992,2002,11,8,D.R.
Henry Alberto,1987-02-25,5,2009,2014,2,25,Venezuela
Henry Alejandro,1990-02-09,1,2012,2013,2,9,Venezuela
Ivan,1971-11-27,20,1991,2011,11,27,P.R.
Jefry Osvaldo,1993-07-26,1,2018,2019,7,26,D.R.
Jose,1894-02-23,2,1916,1918,2,23,Cuba
Jose Ilich,1974-12-18,2,2000,2002,12,18,P.R.
John Joseph,1978-01-20,1,2005,2006,1,20,USA
Joely,1991-11-14,1,2016,2017,11,14,D.R.
Joshua Joel,1984-12-18,0,2011,2011,12,18,USA
Jose Daniel,1995-08-29,0,2019,2019,8,29,Venezuela
Liubiemithz,1976-11-05,0,1999,1999,11,5,Venezuela
Luis Orlando,1980-06-27,6,2005,2011,6,27,Venezuela
Nerio,1971-03-04,6,1996,2002,3,4,D.R.
Rafael,1984-09-24,1,2009,2010,9,24,D.R.
Ricardo,1960-09-21,4,1986,1990,9,21,USA
Richard Anthony,1963-03-01,13,1990,2003,3,1,USA
Ricardo Antonio,1978-05-21,3,2002,2005,5,21,D.R.
Ricardo Jose,1992-08-31,1,2017,2018,8,31,Venezuela
Richard Agustin,1990-03-04,2,2017,2019,3,4,D.R.
Roberto,1941-02-05,3,1967,1970,2,5,Venezuela
Rosario Isabel,1969-07-08,2,1989,1991,7,8,Mexico
Ronny,1992-04-17,1,2018,2019,4,17,D.R.
Ruben Dario,1964-08-04,2,1986,1988,8,4,D.R.
Sean John,1985-04-26,11,2008,2019,4,26,USA
Steven James,1970-11-29,0,1995,1995,11,29,USA
Steven Francis,1991-04-16,3,2012,2015,4,16,USA
Luis Antonio,1970-08-15,0,1996,1996,8,15,P.R.
Victor Manuel,1961-07-14,5,1984,1989,7,14,USA
Wandy Fulton,1979-01-18,10,2005,2015,1,18,D.R.
Wilfredo Jose,1979-03-20,0,2001,2001,3,20,Venezuela
Wilking Jose,1990-03-02,0,2014,2014,3,2,Venezuela
Yorman Jose,1992-08-15,0,2014,2014,8,15,Venezuela
Edward Jack,1931-07-03,11,1955,1966,7,3,USA
Chaz Daniel,1986-10-09,6,2013,2019,10,9,USA
James Clay,1904-01-07,0,1923,1923,1,7,USA
Gary Steven,1954-12-05,12,1976,1988,12,5,USA
Joshua James,1982-08-04,5,2008,2013,8,4,USA
Ronald Jon,1956-08-19,7,1981,1988,8,19,USA
Elwin Charles,1916-02-26,16,1938,1954,2,26,USA
Michael Joseph,1963-09-12,1,1989,1990,9,12,USA
Oscar Frederick Louis,1900-02-19,9,1923,1932,2,19,USA
Walter Henry,1902-08-28,7,1927,1934,8,28,USA
Edward Bernard,1905-08-06,0,1929,1929,8,6,USA
Joseph Anthony,1912-07-15,0,1938,1938,7,15,USA
Charles Wilber,1893-07-28,NA,NA,NA,7,28,USA
William George,1904-11-24,15,1925,1940,11,24,USA
Brian Alan,1982-07-17,1,2006,2007,7,17,USA
Orlin Woodrow,1912-11-05,0,1935,1935,11,5,USA
Edward Antonio,1978-08-29,4,2002,2006,8,29,D.R.
Emmett E.,1867-10-11,0,1890,1890,10,11,USA
Esmil Antonio,1985-08-14,6,2009,2015,8,14,D.R.
Jay Lewis,1888-08-03,0,1914,1914,8,3,USA
Jason Douglas,1988-03-13,2,2014,2016,3,13,USA
Jacob Ray,1995-04-18,0,2019,2019,4,18,USA
James F.,1872-04-09,1,1896,1897,4,9,USA
James Randall,1967-01-03,0,1995,1995,1,3,USA
Joshua Cole,1994-07-10,1,2018,2019,7,10,USA
Kenneth Scott,1964-11-10,19,1989,2008,11,10,USA
Charles Kevin,1968-08-20,2,1992,1994,8,20,USA
Lee Otis,1913-10-08,0,1938,1938,10,8,USA
Mark Elliot,1986-01-30,2,2010,2012,1,30,USA
Stanley Frank,1913-04-26,0,1938,1938,4,26,USA
Stephen Douglas,1949-10-26,12,1973,1985,10,26,USA
Taylor Allen,1990-12-17,3,2016,2019,12,17,USA
Thomas Andrew,1892-02-12,4,1917,1921,2,12,USA
Tyler S.,1990-12-17,0,2019,2019,12,17,USA
Francis Clinton,1889-07-19,6,1915,1921,7,19,USA
Garry Earl,1940-04-16,6,1963,1969,4,16,USA
Michael George,1948-02-22,2,1973,1975,2,22,USA
Saul Walter,1922-03-24,8,1949,1957,3,24,USA
David Grant,1964-05-08,2,1990,1992,5,8,USA
George Anthony,1874-09-15,6,1901,1907,9,15,USA
Ryan Lee,1983-10-07,3,2008,2011,10,7,USA
Daniel Jay,1956-01-10,3,1983,1986,1,10,USA
William Joseph,1945-07-01,1,1967,1968,7,1,USA
Leslie Norvin,1946-03-05,2,1967,1969,3,5,United Kingdom
Daniel,1965-09-27,0,1997,1997,9,27,USA
Ray,1895-06-05,1,1921,1922,6,5,USA
Anton Ambrose,1928-12-23,3,1953,1956,12,23,USA
Octavio Victor,1939-03-06,15,1962,1977,3,6,Cuba
Joshua Luke,1994-06-30,0,2019,2019,6,30,USA
Melquiades,1966-12-10,9,1990,1999,12,10,D.R.
Minervino Alejandro,1933-11-26,2,1966,1968,11,26,Cuba
Miguel Elias,1989-02-24,5,2014,2019,2,24,Venezuela
Stanley Andrew,1919-04-21,10,1942,1952,4,21,USA
James Ivan,1942-12-14,10,1962,1972,12,14,USA
Scott Bruce,1975-04-04,16,1996,2012,4,4,USA
Robert Abial,1908-10-17,11,1931,1942,10,17,USA
Nathan Mardis,1977-03-27,0,2000,2000,3,27,USA
William,1856-06-10,0,1884,1884,6,10,USA
David Dwane,1989-12-21,1,2015,2016,12,21,USA
James Calvin,1978-11-27,16,2000,2016,11,27,USA
Raymond Copeland,1886-09-08,0,1912,1912,9,8,USA
William Russell,1904-03-31,3,1927,1930,3,31,USA
Richard John,1938-04-16,9,1961,1970,4,16,USA
Damian Michael,1977-09-15,4,2000,2004,9,15,USA
James Robert,1985-09-30,1,2014,2015,9,30,CAN
William Anthony,1938-10-11,1,1964,1965,10,11,USA
Jason Anthony,1979-06-24,3,2002,2005,6,24,USA
James King,1927-04-06,0,1950,1950,4,6,USA
John Anthony,1934-08-23,9,1958,1967,8,23,USA
Jose Rafael,1963-05-21,2,1984,1986,5,21,D.R.
Jordan R.,1993-04-21,0,2019,2019,4,21,CAN
Michael Desport,1972-03-03,0,1999,1999,3,3,USA
Ronald James,1960-11-06,2,1984,1986,11,6,USA
Salvatore J.,1993-10-12,2,2017,2019,10,12,USA
Thomas Michael,1958-10-25,0,1987,1987,10,25,USA
Allen Isaiah,1927-05-26,0,1954,1954,5,26,USA
Alexander Rafael,1983-09-09,1,2008,2009,9,9,Venezuela
Davis Javier,1983-03-30,0,2006,2006,3,30,Panama
Edgardo Ralph,1957-12-09,13,1977,1990,12,9,P.R.
Enny Manuel,1991-01-24,5,2013,2018,1,24,D.R.
Fernando Ernesto,1994-12-24,1,2018,2019,12,24,D.R.
Juan Carlos,1976-06-04,13,1999,2012,6,4,P.R.
Armando,1967-10-29,6,1997,2003,10,29,USA
Niuman Jose,1985-01-24,1,2009,2010,1,24,Venezuela
Ramon,1959-01-08,1,1984,1985,1,8,D.R.
Ricardo,1984-11-06,4,2009,2013,11,6,USA
Stefen Daniel,1988-10-17,2,2014,2016,10,17,USA
Andrew James,1985-12-24,8,2010,2018,12,24,USA
Austin Allen,1988-11-22,8,2011,2019,11,22,USA
Kevin Andrew,1961-05-23,6,1985,1991,5,23,USA
Edwin Americus,1897-09-13,12,1920,1932,9,13,USA
Enrique,1947-07-15,5,1977,1982,7,15,Mexico
John,1929-07-07,6,1953,1959,7,7,USA
Sergio Francisco,1983-03-04,11,2008,2019,3,4,USA
Vicente,1943-04-12,14,1968,1982,4,12,Mexico
Edward Marcus,1969-09-19,0,1993,1993,9,19,USA
Henri Joseph,1887-05-05,3,1913,1916,5,5,USA
Bruce,1990-12-09,5,2013,2018,12,9,Venezuela
Gilberto,1953-11-18,3,1976,1979,11,18,USA
Hector Luis,1988-02-26,6,2013,2019,2,26,Venezuela
Jorge Leonardo,1988-02-16,2,2014,2016,2,16,Venezuela
Jose Gregorio,1994-03-03,3,2016,2019,3,3,Venezuela
Matthew Stephen,1980-01-10,3,2003,2006,1,10,USA
Eugene Lawrence,1958-01-13,2,1981,1983,1,13,USA
Phillip Anthony,1941-03-05,16,1961,1977,3,5,USA
James Phillip,1942-09-23,12,1968,1980,9,23,USA
George Brinton McClellan,1863-10-21,0,1891,1891,10,21,USA
Rolando Audley,1962-02-15,2,1988,1990,2,15,Jamaica
Frank,1884-10-12,0,1914,1914,10,12,Czech Republic
Patrick Eugene,1957-11-28,0,1981,1981,11,28,USA
Charles Henry,1899-03-17,18,1923,1941,3,17,USA
John Christopher,1971-11-21,2,1993,1995,11,21,USA
Jorge,1950-04-28,3,1970,1973,4,28,P.R.
Rafael Antonio,1972-01-01,2,1998,2000,1,1,D.R.
Adonis Enmanuel,1994-11-17,0,2019,2019,11,17,D.R.
Carlos,1984-09-21,2,2008,2010,9,21,D.R.
Jose Antonio,1974-11-09,4,1996,2000,11,9,USA
Luis,1955-12-06,3,1977,1980,12,6,P.R.
Adam Marcos,1983-05-20,10,2008,2018,5,20,USA
Leonel,1981-05-28,2,2008,2010,5,28,USA
Alberto,1987-01-10,1,2016,2017,1,10,D.R.
German Amed,1995-11-20,2,2017,2019,11,20,D.R.
Warren Vincent,1914-07-03,12,1939,1951,7,3,USA
Eddie Manuel,1991-09-28,4,2015,2019,9,28,P.R.
Francisco Alberto,1980-09-28,1,2006,2007,9,28,D.R.
Angel Ramon,1945-05-05,5,1971,1976,5,5,P.R.
Melvin Gregorio,1973-05-25,0,1997,1997,5,25,D.R.
Randy Miguel,1994-05-18,2,2017,2019,5,18,D.R.
Rodrigo,1977-12-14,0,2003,2003,12,14,D.R.
Santiago,1939-07-25,0,1965,1965,7,25,P.R.
Sandy,1985-08-22,3,2010,2013,8,22,D.R.
Victor Manuel,1966-08-26,0,1990,1990,8,26,D.R.
Wilin Arismendy,1989-02-23,4,2011,2015,2,23,D.R.
John Junior,1933-05-13,13,1957,1970,5,13,USA
Robert Richard,1967-03-15,3,1989,1992,3,15,USA
Brian Leonard,1976-02-13,4,1997,2001,2,13,USA
Eli Ethelbert,1875-09-08,1,1898,1899,9,8,USA
Charles Alfred,1885-09-01,0,1909,1909,9,1,USA
Donald Gary,1947-03-19,3,1971,1974,3,19,USA
Robert Edward,1931-12-10,7,1955,1962,12,10,USA
David,1950-06-26,9,1972,1981,6,26,P.R.
James John,1856-07-04,8,1882,1890,7,4,USA
Michael John-Ferrero,1976-08-25,2,2004,2006,8,25,USA
Albert Leonard,1924-02-29,9,1947,1956,2,29,USA
Brian James,1985-09-17,2,2012,2014,9,17,USA
Goodwin George,1912-08-28,9,1937,1946,8,28,CAN
Harry,1908-06-22,0,1930,1930,6,22,USA
Lawrence John,1910-05-21,9,1936,1945,5,21,USA
Louis,1904-03-05,0,1923,1923,3,5,USA
Max,1902-12-23,2,1931,1933,12,23,USA
Simon,1903-11-13,1,1925,1926,11,13,USA
Steven Allen,1964-10-31,3,1988,1991,10,31,USA
Trevor Jordan,1990-05-29,7,2012,2019,5,29,USA
Wayne Scott,1965-02-19,1,1991,1992,2,19,USA
Peter Edward,1941-04-14,23,1963,1986,4,14,USA
Peter Edward,1969-11-16,0,1997,1997,11,16,USA
John William Joseph,1901-11-15,0,1922,1922,11,15,USA
Emerson Corey,1918-01-25,2,1944,1946,1,25,USA
Seth Daniel,1988-11-02,1,2014,2015,11,2,USA
John Edward,1974-11-19,2,1998,2000,11,19,USA
Floyd Robert,1928-11-02,6,1950,1956,11,2,USA
Chester Franklin,1903-03-11,2,1924,1926,3,11,USA
Lee Ravon,1915-02-03,9,1936,1945,2,3,USA
Chester James,1917-04-01,5,1939,1944,4,1,USA
Clifford David,1928-08-03,0,1954,1954,8,3,USA
Cody Joseph,1980-12-23,12,2003,2015,12,23,USA
Zachary M.,1988-06-09,6,2013,2019,6,9,USA
David Wade,1977-03-19,14,2002,2016,3,19,USA
Donald Raymond,1914-07-16,8,1938,1946,7,16,USA
Joseph Donald,1972-05-28,0,1995,1995,5,28,USA
Ernest Bertram,1880-03-31,0,1902,1902,3,31,CAN
Gary Douglas,1947-09-16,9,1968,1977,9,16,USA
George Sidney,1892-06-27,0,1918,1918,6,27,USA
Joseph Anthony,1921-03-13,0,1952,1952,3,13,USA
Joseph Andrew,1993-05-21,4,2015,2019,5,21,USA
Mark Joseph,1954-08-08,8,1982,1990,8,8,USA
Claud,1881-06-17,5,1904,1909,6,17,USA
Francis James,1921-03-01,0,1944,1944,3,1,USA
Robert Charles,1989-06-24,5,2012,2017,6,24,USA
Tyson William,1987-04-22,9,2010,2019,4,22,USA
Elam Jose,1964-02-16,7,1991,1998,2,16,P.R.
Marvin,1927-10-18,3,1948,1951,10,18,USA
Robert Frank,1892-08-28,7,1914,1921,8,28,USA
Edward Hill,1870-12-18,0,1899,1899,12,18,USA
Robert Burton,1923-09-17,0,1945,1945,9,17,USA
John Albert,1872-04-18,0,1897,1897,4,18,USA
Francis Charles,1878-10-11,7,1903,1910,10,11,USA
Claude James,1880-01-01,0,1905,1905,1,1,USA
Michael Thomas,1990-02-15,3,2013,2016,2,15,USA
Jack Houston,1905-03-14,12,1925,1937,3,14,USA
Lawrence Lee,1954-03-12,1,1981,1982,3,12,USA
Vincent Antonio,1980-04-07,6,2006,2012,4,7,USA
Virle Gene,1944-09-27,0,1970,1970,9,27,USA
Michael Gregory,1980-04-25,1,2006,2007,4,25,USA
Edd J.,1893-05-08,18,1913,1931,5,8,USA
Philip John,1870-10-24,0,1890,1890,10,24,CAN
Aaron Ryan,1977-08-29,10,2001,2011,8,29,USA
David,1881-12-06,0,1911,1911,12,6,CAN
John Albert,1886-06-16,8,1906,1914,6,16,USA
Wade Lee,1960-09-07,4,1984,1988,9,7,USA
David Elwood,1854-10-09,11,1877,1888,10,9,USA
Donald Howard,1936-04-03,0,1963,1963,4,3,USA
Harland Stimson,1896-04-20,0,1916,1916,4,20,USA
John Charles,1856-12-08,11,1879,1890,12,8,USA
Kenneth Darrell,1933-12-31,2,1963,1965,12,31,USA
Carvel William,1916-01-13,9,1939,1948,1,13,USA
Benjamin Ramon,1988-11-15,2,2014,2016,11,15,USA
W. Edward,1857-10-22,2,1882,1884,10,22,USA
Lynwood Thomas,1910-01-11,16,1933,1949,1,11,USA
Charlie Leland,1899-07-23,0,1923,1923,7,23,USA
Michael Evan,1953-01-31,1,1980,1981,1,31,USA
Clarence Henry,1878-02-12,NA,NA,NA,2,12,USA
Richard Garnet,1964-02-25,5,1990,1995,2,25,USA
Ryan Benjamin,1983-01-26,7,2007,2014,1,26,Australia
Christopher Ryan,1990-08-14,1,2017,2018,8,14,USA
James Henry,1858-01-17,3,1884,1887,1,17,USA
Robert Charles,1884-06-22,0,1906,1906,6,22,USA
Emil Arthur,1907-05-26,0,1933,1933,5,26,USA
Stanley Dean,1967-08-31,3,1991,1994,8,31,USA
Jean-Pierre,1920-06-26,0,1946,1946,6,26,CAN
Luther Franklin,1902-07-29,5,1924,1929,7,29,USA
Norman Brooks,1928-11-15,0,1950,1950,11,15,USA
Jeron Kennis,1952-10-18,15,1973,1988,10,18,USA
Willie Arthur,1954-04-11,0,1981,1981,4,11,USA
Richard Louis,1927-03-27,4,1950,1954,3,27,USA
David Scott,1956-08-05,9,1977,1986,8,5,USA
Victor Joseph,1938-10-19,5,1964,1969,10,19,USA
Wilkin Chal,1978-11-18,1,2002,2003,11,18,D.R.
Ryan Anthony,1990-03-11,4,2014,2018,3,11,USA
Albert William,1913-05-10,4,1940,1944,5,10,USA
John Edward,1946-01-02,3,1969,1972,1,2,USA
Jorge Jesus,1945-04-23,1,1966,1967,4,23,Mexico
William Arthur,1903-03-11,7,1927,1934,3,11,USA
Andrew James,1988-12-30,4,2014,2018,12,30,USA
David Michael,1957-09-01,7,1981,1988,9,1,USA
John Joel,1917-01-15,6,1940,1946,1,15,USA
George Napoleon,1884-09-30,9,1907,1916,9,30,USA
John Edmund,1863-08-30,0,1884,1884,8,30,USA
Joseph Oden,1946-09-07,15,1967,1982,9,7,USA
Richard,1887-08-25,17,1910,1927,8,25,USA
Frederick Donald,1931-08-16,7,1957,1964,8,16,USA
John Herman,1882-07-10,1,1903,1904,7,10,USA
Ernest William,1909-02-13,0,1945,1945,2,13,USA
Kenneth Victor,1946-12-29,8,1969,1977,12,29,USA
Matthew Alexander,1969-10-16,2,1996,1998,10,16,USA
Herold Dominic,1896-02-20,19,1915,1934,2,20,USA
Kirk Wesley,1970-12-01,12,1993,2005,12,1,USA
Walter Henry,1893-09-13,10,1917,1927,9,13,USA
Darin Cortland,1986-07-28,4,2012,2016,7,28,USA
Rudolph Joseph,1926-10-28,1,1949,1950,10,28,USA
Scott Patrick,1969-12-29,4,1993,1997,12,29,USA
Bruce Wayne,1963-10-04,11,1986,1997,10,4,USA
Chance Kraig,1988-09-08,2,2011,2013,9,8,USA
Johnny Renando,1971-07-29,8,1993,2001,7,29,USA
Charles Herbert,1905-05-03,23,1924,1947,5,3,USA
Justin Marshall,1982-04-12,10,2007,2017,4,12,USA
Vernon Gerald,1951-01-25,12,1974,1986,1,25,USA
Carlos Joaquin,1979-01-22,11,2006,2017,1,22,Panama
Giraldo,1938-12-05,7,1964,1971,12,5,Cuba
Manuel,1951-11-01,2,1978,1980,11,1,P.R.
Jose Rafael,1994-10-21,2,2017,2019,10,21,Venezuela
Randy Radames,1977-10-19,2,2008,2010,10,19,USA
Rio Noble,1994-05-22,3,2016,2019,5,22,USA
Joseph Vincent,1916-06-16,1,1943,1944,6,16,USA
Nicholas Bruno,1991-09-06,4,2015,2019,9,6,USA
William George,1891-03-27,3,1914,1917,3,27,USA
Richard Lambert,1981-06-03,1,2008,2009,6,3,USA
Paul William,1958-05-21,7,1981,1988,5,21,USA
James Edward,1928-01-28,13,1951,1964,1,28,USA
Thomas William,1955-04-17,1,1985,1986,4,17,USA
Sean David,1974-06-21,2,1998,2000,6,21,USA
Daniel Joseph,1985-03-30,8,2009,2017,3,30,USA
Joshua Matthew,1982-08-18,6,2005,2011,8,18,USA
Jacob,1867-08-05,NA,NA,NA,8,5,USA
Ryan Kittman,1975-03-31,4,1999,2003,3,31,USA
Cameron Arthur,1988-09-28,4,2013,2017,9,28,USA
Glendon James,1974-11-07,12,1997,2009,11,7,USA
Jesse Howard,1889-12-26,0,1925,1925,12,26,USA
Robert Ransom,1925-12-21,12,1948,1960,12,21,USA
James Thomas,1974-03-24,0,2002,2002,3,24,USA
Amos Wilson,1871-05-30,12,1889,1901,5,30,USA
Christopher Patrick,1986-10-22,7,2012,2019,10,22,USA
Scott Drew,1963-06-08,3,1990,1993,6,8,USA
Adam William,1983-04-14,3,2008,2011,4,14,USA
Addison Wayne,1994-01-23,4,2015,2019,1,23,USA
Allen,1893-07-31,10,1915,1925,7,31,USA
William Ellis,1948-10-21,17,1969,1986,10,21,USA
Harvey Holmes,1887-01-10,1,1914,1915,1,10,USA
Jack Erwin,1905-10-24,14,1926,1940,10,24,USA
James Clayton,1986-01-08,6,2010,2016,1,8,USA
Jeffrey Lee,1961-09-02,13,1983,1996,9,2,USA
James William,1918-10-01,9,1942,1951,10,1,USA
John Albert,1894-10-20,5,1917,1922,10,20,USA
John William,1961-01-05,9,1984,1993,1,5,USA
Clarence Dickson,1890-07-08,2,1910,1912,7,8,USA
Lloyd Opal,1913-04-10,0,1938,1938,4,10,USA
Paul A.,1871-03-20,0,1894,1894,3,20,USA
Ewell Albert,1889-03-12,10,1913,1923,3,12,USA
Glen David,1915-01-26,8,1939,1947,1,26,USA
John,1858-04-01,0,1882,1882,4,1,USA
Kevin Alexander,1984-07-08,0,2010,2010,7,8,USA
Marius Ugo,1914-07-19,7,1939,1946,7,19,USA
Richard Frank,1941-07-12,0,1966,1966,7,12,USA
Henry Alexander,1925-11-10,3,1944,1947,11,10,USA
George Herman,1895-02-06,21,1914,1935,2,6,USA
James Hollis,1886-09-26,0,1910,1910,9,26,USA
John William,1925-05-05,0,1952,1952,5,5,CAN
Richard David,1951-03-27,13,1973,1986,3,27,USA
Joshua Alan,1989-04-21,5,2012,2017,4,21,USA
Milton,1919-03-18,0,1947,1947,3,18,USA
Mark Dwayne,1960-08-28,8,1982,1990,8,28,USA
Rusty Allen,1983-03-16,1,2009,2010,3,16,USA
Robert Victor,1975-12-28,10,1999,2009,12,28,USA
John Collins,1906-01-04,8,1930,1938,1,4,USA
Brendan Wood,1982-03-26,9,2007,2016,3,26,USA
John Budd,1885-10-06,1,1912,1913,10,6,USA
Cornelius Joseph,1920-02-27,12,1942,1954,2,27,USA
Dusty Mitchell,1984-09-02,1,2008,2009,9,2,USA
John Bernard,1868-11-12,24,1889,1913,11,12,USA
Jack,1884-09-19,3,1908,1911,9,19,USA
John Francis,1905-05-05,0,1929,1929,5,5,USA
Jason Paul,1976-01-21,1,1999,2000,1,21,USA
James P.,1863-02-11,18,1885,1903,2,11,USA
Kenneth Frederick,1968-10-24,7,1992,1999,10,24,USA
Kyle,1991-09-25,5,2014,2019,9,25,USA
Michael Patrick,1868-06-07,0,1895,1895,6,7,USA
Michael James,1941-11-25,10,1964,1974,11,25,USA
Michael Sean,1977-07-06,8,2002,2010,7,6,USA
Lynn Nolan,1947-01-31,27,1966,1993,1,31,USA
Wilfred Patrick Dolan,1898-03-15,14,1919,1933,3,15,USA
Robert James,1973-06-24,2,1999,2001,6,24,USA
Dominic Joseph,1903-06-09,11,1935,1946,6,9,USA
Thomas,1863-05-09,0,1884,1884,5,9,USA
Eugene Rudolph,1906-11-15,0,1931,1931,11,15,USA
Gary Lawrence,1948-06-17,1,1972,1973,6,17,USA
Hyun-Jin,1987-03-25,6,2013,2019,3,25,South Korea
Jae Kuk,1983-05-30,2,2006,2008,5,30,South Korea
Marc Walter,1985-08-29,9,2009,2018,8,29,USA
Kirk Craig,1979-05-23,6,2002,2008,5,23,USA
Carsten Charles,1980-07-21,18,2001,2019,7,21,USA
Erik Douglas,1974-10-14,3,1999,2002,10,14,USA
Bret William,1964-04-11,17,1984,2001,4,11,USA
Alexander,1910-02-14,1,1936,1937,2,14,USA
Christopher Andrew,1962-01-19,8,1988,1996,1,19,USA
Mark Edison,1980-04-30,0,2008,2008,4,30,USA
Frank,1924-08-30,2,1951,1953,8,30,USA
Brian Walter,1971-06-22,0,1996,1996,6,22,USA
Raymond Michael,1940-12-26,17,1960,1977,12,26,USA
Michael George,1946-05-30,8,1973,1981,5,30,USA
William Henry,1981-09-21,3,2006,2009,9,21,USA
William Carl,1976-10-11,1,2002,2003,10,11,USA
Casey Scott,1990-07-13,5,2014,2019,7,13,USA
Donnie Lamont,1975-06-17,9,1998,2007,6,17,USA
Raymond Lee,1980-09-19,0,2005,2005,9,19,USA
Robert Frank,1937-01-15,3,1960,1963,1,15,USA
Robert,1938-02-19,3,1963,1966,2,19,USA
Edward Roman,1931-01-19,6,1960,1966,1,19,USA
James Michael,1951-08-07,0,1974,1974,8,7,USA
Ryan Keith,1982-10-04,0,2009,2009,10,4,USA
Theodore,1936-04-01,2,1960,1962,4,1,USA
Connor William,1991-10-01,1,2018,2019,10,1,USA
Christopher Andrew,1981-08-14,0,2004,2004,8,14,USA
Olmedo,1970-10-08,13,1994,2007,10,8,Panama
Thomas Judson,1921-07-26,6,1949,1955,7,26,USA
Harry,1864-03-16,0,1890,1890,3,16,USA
Anthony Joseph,1965-03-03,4,1994,1998,3,3,USA
Samuel B.,1848-08-12,0,1871,1871,8,12,USA
Marc Richard,1971-04-16,0,1997,1997,4,16,USA
Victor Sylvester,1891-05-04,8,1911,1919,5,4,USA
John Franklin,1917-09-25,13,1942,1955,9,25,USA
Michael Eric,1973-09-10,0,1998,1998,9,10,USA
Takashi,1970-02-14,6,2006,2012,2,14,Japan
Lenn Haruki,1954-06-08,10,1977,1987,6,8,USA
Tyler Artolo,1989-07-20,4,2015,2019,7,20,USA
Noel Fernando,1985-05-30,9,2010,2019,5,30,Mexico
Juan,1978-11-07,2,2006,2008,11,7,D.R.
Mark Bruce,1961-03-08,7,1984,1991,3,8,USA
Marino,1981-10-02,0,2008,2008,10,2,D.R.
Argenis Antonio,1961-11-04,5,1983,1988,11,4,Venezuela
Daniel Dariel,1990-01-11,6,2013,2019,1,11,D.R.
Jeffrey Dewan,1980-11-24,3,2006,2009,11,24,USA
Luis Ernesto,1956-05-19,12,1980,1992,5,19,Venezuela
Oscar Enrique,1978-06-27,8,2002,2010,6,27,Venezuela
Christopher,1989-03-30,9,2010,2019,3,30,USA
Frederick Link,1902-05-02,0,1924,1924,5,2,USA
William Ansil,1876-11-12,0,1902,1902,11,12,USA
Henry Houston,1855-05-15,3,1879,1882,5,15,USA
William Franklin,1917-03-08,5,1945,1950,3,8,USA
Roger William,1971-03-06,3,1993,1996,3,6,USA
Harry Franklin,1885-02-03,13,1908,1921,2,3,USA
Bradley Keith,1980-01-03,0,2007,2007,1,3,USA
Rutherford Eduardo,1940-12-03,8,1964,1972,12,3,Panama
Roger Elliott,1891-05-11,0,1912,1912,5,11,USA
Timothy James,1968-08-24,14,1992,2006,8,24,USA
Angel Isaac,1986-06-08,0,2008,2008,6,8,D.R.
Jarrod Scott,1985-05-02,11,2007,2018,5,2,USA
Otto Hamlin,1903-01-23,13,1932,1945,1,23,USA
Augustus William,1885-12-29,0,1908,1908,12,29,USA
John Theodore,1914-01-05,12,1933,1945,1,5,USA
Manuel,1912-06-30,4,1939,1943,6,30,USA
Jeffrey Alan,1985-01-23,11,2008,2019,1,23,USA
Joseph Charles,1952-06-28,11,1976,1987,6,28,USA
Edward William,1924-09-01,0,1951,1951,9,1,USA
Ronald Edward,1930-02-28,5,1954,1959,2,28,USA
Clint Joseph,1983-05-15,2,2007,2009,5,15,USA
William Albert,1963-01-18,4,1990,1994,1,18,USA
William Amos,1955-04-02,8,1978,1986,4,2,USA
Adrian David,1991-10-07,3,2016,2019,10,7,USA
Benjamin Damon,1975-04-27,1,1998,1999,4,27,USA
Christopher Keith,1978-05-23,4,2006,2010,5,23,USA
Keyvius N.,1991-01-06,1,2015,2016,1,6,USA
Amado Ruperto,1938-12-06,2,1962,1964,12,6,D.R.
Joseph Jonas,1905-03-21,0,1930,1930,3,21,USA
Juan Milton,1960-12-09,15,1983,1998,12,9,D.R.
Roger Howard,1961-01-05,1,1988,1989,1,5,USA
Samuel Earle,1874-02-20,0,1895,1895,2,20,USA
Alejandro,1988-09-08,3,2010,2013,9,8,USA
Gustave E.,1895-02-23,1,1923,1924,2,23,USA
Aaron Jacob,1992-07-01,5,2014,2019,7,1,USA
Adrian Arturo,1990-08-16,2,2017,2019,8,16,Venezuela
Alejandro,1959-02-14,5,1982,1987,2,14,D.R.
Alex Anthony,1966-04-08,0,1989,1989,4,8,USA
Alexis,1976-08-26,4,2001,2005,8,26,Cuba
Anibal Alejandro,1984-02-27,13,2006,2019,2,27,Venezuela
Angel Luis,1983-09-20,7,2006,2013,9,20,P.R.
Angel Luis,1989-11-28,0,2017,2017,11,28,D.R.
Brian Lee,1978-08-08,6,2006,2012,8,8,USA
Yolmer Carlos,1992-06-29,5,2014,2019,6,29,Venezuela
Celerino,1944-02-03,1,1972,1973,2,3,Mexico
Duaner,1979-10-14,7,2002,2009,10,14,D.R.
Eduardo Nazareth,1989-02-16,2,2011,2013,2,16,Venezuela
Felix Antonio,1981-08-03,0,2003,2003,8,3,D.R.
Frederick Philip,1977-12-21,9,2002,2011,12,21,USA
Gabriel,1983-09-02,6,2008,2014,9,2,USA
Gary,1992-12-02,4,2015,2019,12,2,D.R.
Hector Enrique,1989-11-17,6,2011,2017,11,17,Venezuela
Humberto A.,1983-05-28,0,2008,2008,5,28,D.R.
Israel,1963-08-20,2,1988,1990,8,20,Cuba
Jesus Paulino,1974-10-11,6,1998,2004,10,11,D.R.
Jonathan Omar,1982-11-19,7,2006,2013,11,19,P.R.
Luis Mercedes Escoba,1953-08-24,4,1981,1985,8,24,Venezuela
Orlando,1956-09-07,3,1981,1984,9,7,P.R.
Raul Guadalupe,1930-12-12,8,1952,1960,12,12,Cuba
Rey Francisco,1967-10-05,14,1991,2005,10,5,P.R.
Romulo Ignacio,1984-04-28,3,2007,2010,4,28,Venezuela
Jorge Anthony,1988-05-20,4,2013,2017,5,20,USA
Jared Lawrence,1978-03-02,2,2001,2003,3,2,USA
Ryne Dee,1959-09-18,16,1981,1997,9,18,USA
Anthony Marcus,1974-03-02,2,1999,2001,3,2,USA
Alexander Bennett,1865-02-16,4,1888,1892,2,16,USA
David Andrew,1979-08-29,2,2003,2005,8,29,USA
Dee Wilman,1921-04-08,0,1945,1945,4,8,USA
Deion Luwynn,1967-08-09,12,1989,2001,8,9,USA
John Frank,1945-11-20,0,1965,1965,11,20,USA
Kenneth George,1941-07-08,12,1964,1976,7,8,USA
Raymond Floyd,1916-12-04,7,1942,1949,12,4,USA
Reginald Jerome,1949-09-09,0,1974,1974,9,9,USA
Reginald Laverne,1967-12-01,16,1991,2007,12,1,USA
Roy Garvin,1892-08-01,1,1917,1918,8,1,USA
Roy Lee,1894-06-10,2,1918,1920,6,10,USA
Scott Douglas,1956-07-22,18,1978,1996,7,22,USA
Scott Gerald,1969-03-25,6,1993,1999,3,25,USA
Warren Williams,1877-08-02,1,1903,1904,8,2,USA
John Henry,1897-07-03,5,1923,1928,7,3,USA
Michael Joseph,1915-10-17,11,1942,1953,10,17,USA
Danny E.,1979-04-07,1,2005,2006,4,7,Venezuela
Freddy Carol,1982-08-16,1,2008,2009,8,16,Mexico
Pablo Emilio,1986-08-11,11,2008,2019,8,11,Venezuela
Patrick Jordan,1996-10-18,0,2019,2019,10,18,USA
Charles Duane,1947-12-17,8,1967,1975,12,17,USA
Gerald Robert,1987-09-28,5,2011,2016,9,28,USA
Thomas James,1950-12-22,1,1975,1976,12,22,USA
Chance Steven,1972-06-02,1,1998,1999,6,2,USA
John Frederick,1919-08-09,8,1943,1951,8,9,USA
John Doward,1917-06-23,6,1940,1946,6,23,USA
John Stanley,1929-05-18,11,1956,1967,5,18,USA
Meredith Leroy,1966-12-24,4,1991,1995,12,24,USA
Manuel de Jesus,1944-03-21,13,1967,1980,3,21,Panama
Edward Robert,1923-07-07,2,1949,1951,7,7,USA
Amauri,1979-07-04,0,2011,2011,7,4,Cuba
Benjamin Turner,1907-09-02,2,1929,1931,9,2,USA
Miguel Angel,1993-05-11,4,2015,2019,5,11,D.R.
Andres Confesor,1968-02-05,0,1990,1990,2,5,D.R.
Anthony Roger,1994-10-19,2,2017,2019,10,19,Venezuela
Carlos,1986-04-08,9,2010,2019,4,8,D.R.
Daniel Ernesto,1990-11-07,5,2014,2019,11,7,D.R.
Dennis Anfernee,1996-04-12,1,2018,2019,4,12,D.R.
Domingo Alberto,1992-08-05,5,2014,2019,8,5,D.R.
Edgar,1991-10-16,1,2017,2018,10,16,D.R.
Ervin Ramon,1982-12-12,14,2005,2019,12,12,D.R.
Frank-Paul,1967-10-24,6,1995,2001,10,24,USA
Johan Alexander,1979-03-13,12,2000,2012,3,13,Venezuela
Julio Franklin,1973-01-20,9,1997,2006,1,20,D.R.
Marino,1972-05-10,1,1998,1999,5,10,D.R.
Pedro,1976-09-21,0,2001,2001,9,21,D.R.
Rafael Francisco,1958-01-31,7,1983,1990,1,31,D.R.
Benito,1965-03-09,19,1986,2005,3,9,P.R.
Hector Felipe,1987-12-16,8,2011,2019,12,16,USA
Jose Guillermo,1928-09-04,2,1954,1956,9,4,P.R.
Jose Rafael,1940-08-15,7,1963,1970,8,15,P.R.
Jose Rafael,1974-11-05,8,1997,2005,11,5,P.R.
Ramon DeJesus,1979-08-31,12,2002,2014,8,31,D.R.
Alan Joel,1948-05-19,5,1968,1973,5,19,USA
Angel Ramon,1979-08-14,2,2001,2003,8,14,P.R.
Chad Roque,1981-04-28,0,2006,2006,4,28,USA
Francisco Alejandro,1974-03-09,0,2003,2003,3,9,D.R.
D. Louis,1889-01-17,NA,NA,NA,1,17,USA
Luis Gustavo,1991-02-11,1,2017,2018,2,11,D.R.
Nelson Gil,1961-07-27,6,1987,1993,7,27,Cuba
Omir,1981-04-29,5,2008,2013,4,29,P.R.
Rafael,1955-11-24,0,1979,1979,11,24,P.R.
Ronald Edward,1940-02-25,14,1960,1974,2,25,USA
Sergio Jose,1983-07-04,5,2010,2015,7,4,USA
Victor Irving,1976-10-02,6,2001,2007,10,2,D.R.
David J.,1987-01-02,2,2011,2013,1,2,USA
Bronson Kiheimahanaomauiakeo,1983-04-06,0,2007,2007,4,6,USA
Dane Kealoha,1979-04-08,8,2003,2011,4,8,USA
Luis Alexander,1993-05-16,4,2014,2018,5,16,Venezuela
Dennis Scott,1981-04-09,3,2006,2009,4,9,USA
Joseph Alexander,1893-09-24,0,1921,1921,9,24,USA
Manuel Eduardo,1956-02-02,7,1976,1983,2,2,Venezuela
William Florine,1927-09-19,5,1951,1956,9,19,USA
Kazuhiro,1968-02-22,3,2000,2003,2,22,Japan
Mack Daniel,1962-08-03,8,1987,1995,8,3,USA
Robert Doffell,1975-03-09,0,1998,1998,3,9,USA
Joshua Blake,1984-12-23,3,2011,2014,12,23,USA
Thomas Victor Nicholas,1940-08-28,9,1961,1970,8,28,USA
Luis Arturo,1976-07-21,1,2000,2001,7,21,D.R.
Francis Field,1926-05-28,0,1951,1951,5,28,USA
Kevin Andrew,1956-08-09,4,1978,1982,8,9,USA
Edward,1919-01-03,6,1943,1949,1,3,USA
Henry John,1917-03-17,18,1941,1959,3,17,USA
Scott William,1971-11-09,7,1999,2006,11,9,USA
Dennis James,1949-01-04,0,1970,1970,1,4,USA
Douglas Long,1969-12-13,0,1993,1993,12,13,USA
Joseph Francis,1981-06-16,9,2005,2014,6,16,USA
Michael Edward Brett,1986-11-19,8,2009,2017,11,19,CAN
Russell Collier,1906-03-12,0,1927,1927,3,12,USA
Anthony Scott,1974-04-29,2,1997,1999,4,29,USA
Warwick Anthony,1990-01-16,2,2016,2018,1,16,Australia
Albert Charles,1868-09-02,0,1890,1890,9,2,USA
Richard Daniel,1963-11-23,14,1986,2000,11,23,USA
John Robert,1921-12-01,7,1942,1949,12,1,USA
Donald Anthony,1919-03-05,1,1944,1945,3,5,USA
John Joseph,1964-04-22,3,1987,1990,4,22,USA
James Harold,1883-08-29,3,1912,1915,8,29,USA
Theodore Edmund,1937-02-21,9,1962,1971,2,21,USA
Robert Paul,1941-06-02,8,1959,1967,6,2,USA
Joseph Cain,1985-11-04,3,2011,2014,11,4,USA
Donald Snyder,1908-08-28,0,1929,1929,8,28,USA
Ralph Austin,1879-02-03,1,1908,1909,2,3,USA
Morris,1929-01-13,0,1954,1954,1,13,USA
Carl Ernest,1927-11-04,15,1948,1963,11,4,USA
Carl Everett,1890-10-19,1,1915,1916,10,19,USA
Edwin Milby,1910-09-10,NA,NA,NA,9,10,USA
Richard Clyde,1948-04-07,3,1974,1977,4,7,USA
Willard Newton,1864-07-29,0,1883,1883,7,29,USA
David John,1958-09-22,5,1982,1987,9,22,USA
Erik Oliver,1904-11-05,0,1928,1928,11,5,USA
Stephen Louis,1960-01-29,13,1981,1994,1,29,USA
William Nisbeth,1917-07-27,4,1939,1943,7,27,USA
Louis I.,1854-02-04,11,1873,1884,2,4,USA
Philip Andrew,1871-01-02,0,1891,1891,1,2,USA
John James,1985-01-24,0,2010,2010,1,24,USA
Joshua Alan,1993-12-17,0,2019,2019,12,17,USA
Robert Joseph,1987-02-15,6,2012,2018,2,15,USA
Gerard Michael,1924-09-27,2,1948,1950,9,27,USA
Bobby Leon,1977-10-04,1,2009,2010,10,4,USA
John Anthony,1907-03-22,0,1931,1931,3,22,USA
Frank John,1913-06-16,0,1939,1939,6,16,USA
Robert Guy,1966-08-09,10,1991,2001,8,9,USA
William Dennis,1881-03-07,8,1903,1911,3,7,USA
Frank Aloysius,1890-04-28,0,1909,1909,4,28,USA
Mortimer J.,1861-03-18,0,1890,1890,3,18,USA
Patrick J.,1861-03-25,0,1884,1884,3,25,CAN
James Patrick,1952-09-23,3,1974,1977,9,23,USA
Patricio Athelstan,1917-11-11,0,1956,1956,11,11,Panama
Ray Wilson,1917-07-23,11,1942,1953,7,23,USA
Randy James,1952-06-22,1,1979,1980,6,22,USA
Guerrant McCurdy,1949-04-08,6,1972,1978,4,8,USA
Stephen Russell Mallory,1903-01-14,3,1929,1932,1,14,USA
Leslie George,1913-11-23,5,1935,1940,11,23,USA
Steven Wayne,1966-04-11,7,1992,1999,4,11,USA
Paul,1943-03-03,10,1964,1974,3,3,USA
Alexander,1892-11-11,2,1919,1921,11,11,USA
Harold,1925-04-06,0,1945,1945,4,6,USA
Sidney,1918-02-03,1,1950,1951,2,3,USA
Robert Walden,1944-05-22,NA,NA,NA,5,22,USA
William Herman,1876-02-04,17,1901,1918,2,4,USA
Harry Edward,1924-06-23,0,1952,1952,6,23,USA
Jeffrey Scott,1960-05-31,5,1989,1994,5,31,USA
Mark Philip,1948-06-05,0,1972,1972,6,5,USA
Harry C.,1846-08-14,7,1871,1878,8,14,USA
Jimmie Ronald,1936-04-05,7,1961,1968,4,5,USA
Joseph Arthur,1937-08-06,2,1959,1961,8,6,USA
Jordan James,1986-09-04,6,2009,2015,9,4,USA
Logan Edward,1986-09-08,5,2011,2016,9,8,USA
John Edward,1934-02-25,5,1958,1963,2,25,USA
Arthur Lawrence,1924-04-25,4,1951,1955,4,25,USA
Walter,1889-09-23,2,1911,1913,9,23,USA
Eugene David,1970-06-05,1,1995,1996,6,5,USA
Ray William,1892-08-12,17,1912,1929,8,12,USA
LeRoy John,1908-11-09,13,1932,1945,11,9,USA
Robert Martin,1886-12-07,13,1914,1927,12,7,USA
Charles Murrell,1919-06-08,6,1944,1950,6,8,USA
Walter Henry,1889-08-22,18,1913,1931,8,22,USA
Arthur Otto,1905-06-30,2,1932,1934,6,30,USA
Wilburt,1886-01-20,1,1911,1912,1,20,USA
George Albert,1914-11-21,3,1937,1940,11,21,USA
Edward T.,1858-07-18,1,1882,1883,7,18,USA
Daniel Ernest,1954-12-01,14,1977,1991,12,1,USA
Jeffrey Charles,1955-10-25,0,1981,1981,10,25,USA
Alexander John,1891-03-19,4,1913,1917,3,19,Russia
Scott Anthony,1990-10-06,4,2015,2019,10,6,USA
Allen George,1888-10-27,2,1913,1915,10,27,USA
Frederick,1891-07-01,1,1914,1915,7,1,USA
Henry William,1900-07-31,1,1922,1923,7,31,USA
Owen Franklin,1913-12-24,0,1943,1943,12,24,USA
Aaron Alvin Marcus,1975-08-15,0,1999,1999,8,15,USA
Robert Boden,1913-08-11,10,1941,1951,8,11,USA
Theodore J.,1864-04-05,2,1888,1890,4,5,USA
Gilbert Eugene,1889-08-29,0,1912,1912,8,29,USA
Carl Alvin,1927-01-01,11,1943,1954,1,1,USA
Frank S.,1865-06-28,19,1887,1906,6,28,USA
John G.,1866-02-16,1,1893,1894,2,16,USA
Richard Alan,1942-11-05,9,1965,1974,11,5,USA
Richard Paul,1965-02-03,3,1992,1995,2,3,USA
Albert Herman,1864-09-13,1,1890,1891,9,13,USA
Clyde Daniel,1927-12-26,1,1954,1955,12,26,USA
Gerard Anthony,1917-04-13,0,1939,1939,4,13,USA
Frederick George,1903-04-28,0,1923,1923,4,28,USA
Michael,1917-11-20,1,1945,1946,11,20,USA
Henry Leonard,1919-04-11,5,1946,1951,4,11,USA
John Bluford,1887-11-20,7,1913,1920,11,20,USA
Joseph Maurice,1895-08-10,0,1919,1919,8,10,USA
Tanner Ross,1987-01-17,5,2012,2017,1,17,USA
William Joseph,1958-01-20,6,1982,1988,1,20,USA
Robert Elmer,1926-01-18,0,1950,1950,1,18,USA
Frederick John,1944-07-25,7,1969,1976,7,25,USA
Maxwell M.,1984-07-27,11,2008,2019,7,27,USA
Charles,1900-06-01,0,1931,1931,6,1,Germany
Louis Martin,1886-06-12,0,1910,1910,6,12,USA
Louis Joseph,1881-03-29,0,1902,1902,3,29,USA
Maurice Francis,1892-04-17,0,1917,1917,4,17,USA
Nathan John,1984-02-15,7,2007,2014,2,15,USA
Charles Thomas,1937-10-25,4,1961,1965,10,25,USA
Curtis Montague,1966-11-14,19,1988,2007,11,14,USA
Elbert Isaiah,1900-03-29,0,1922,1922,3,29,USA
Ryan Michael,1988-04-11,2,2016,2018,4,11,USA
William Gibbons,1896-07-10,0,1920,1920,7,10,USA
Calvin Drew,1962-06-16,7,1984,1991,6,16,USA
Harry Ernest,1890-06-15,0,1914,1914,6,15,USA
Harry Fenton,1878-09-20,12,1902,1914,9,20,USA
George Henry,1878-01-12,7,1904,1911,1,12,USA
Daniel Robert,1986-05-09,3,2009,2012,5,9,USA
William Cordes,1941-11-05,0,1965,1965,11,5,USA
Victor Joseph,1884-12-04,6,1908,1914,12,4,USA
Brian Patrick,1985-12-21,9,2010,2019,12,21,USA
Frederick Paul,1891-05-19,0,1923,1923,5,19,Germany
Travis Jay,1984-10-19,1,2009,2010,10,19,USA
August C.,1988-10-20,0,2014,2014,10,20,USA
Jay D.,1949-07-31,0,1971,1971,7,31,USA
Norman John,1916-09-25,6,1938,1944,9,25,USA
Brian Robert,1973-12-07,0,2003,2003,12,7,USA
Raymond Henry,1896-01-25,7,1915,1922,1,25,USA
Alan George,1943-11-12,0,1967,1967,11,12,USA
George Edward,1924-09-06,0,1952,1952,9,6,USA
Gustavus Heinrich,1850-09-26,NA,NA,NA,9,26,USA
Charles,1880-09-12,5,1906,1911,9,12,USA
Robert Benjamin,1933-04-22,7,1958,1965,4,22,USA
Charles John,1886-07-19,6,1909,1915,7,19,USA
Frederick M.,1866-02-13,11,1890,1901,2,13,USA
Curtis Allen,1970-03-16,0,1995,1995,3,16,USA
David Joseph,1957-04-22,11,1981,1992,4,22,USA
David Frederick,1956-12-22,0,1981,1981,12,22,USA
Frederick Albert,1916-02-09,3,1944,1947,2,9,USA
Henry Martin,1873-06-26,0,1903,1903,6,26,USA
Jason David,1973-01-29,14,1995,2009,1,29,USA
Jeffrey Thomas,1971-02-21,0,1996,1996,2,21,USA
John Albert,1920-11-27,15,1941,1956,11,27,USA
Konrad Albert,1984-08-02,2,2010,2012,8,2,USA
Michael Jack,1949-09-27,17,1972,1989,9,27,USA
Frederich Christoph Herman,1890-07-23,0,1913,1913,7,23,USA
Walter Joseph,1887-03-20,9,1916,1925,3,20,USA
Willard Raymond,1928-05-29,7,1952,1959,5,29,USA
Stephen John,1980-02-04,0,2005,2005,2,4,USA
Charles Otto,1891-01-01,1,1914,1915,1,1,USA
Henry Alrives,1925-01-17,0,1943,1943,1,17,USA
Brian Duncan,1976-11-26,12,2000,2012,11,26,USA
Daniel Louis,1942-08-29,6,1963,1969,8,29,USA
David Lee,1949-06-18,2,1972,1974,6,18,USA
Frank Fred,1880-03-12,0,1910,1910,3,12,USA
Jeffrey Theodore,1952-12-06,0,1981,1981,12,6,USA
Karl Otto,1899-09-20,1,1922,1923,9,20,USA
Peter Joseph,1895-08-20,5,1914,1919,8,20,USA
Gerald Thomas,1947-01-15,0,1968,1968,1,15,USA
Louis W.,1862-03-03,5,1884,1889,3,3,USA
Albert Fred,1923-02-02,18,1945,1963,2,2,USA
Scott David,1973-10-02,11,1999,2010,10,2,USA
John Richard,1935-01-07,18,1953,1971,1,7,USA
Richard Craig,1962-11-21,13,1983,1996,11,21,USA
Otto H.,1864-11-14,2,1886,1888,11,14,USA
Jerald Lee,1933-12-14,2,1955,1957,12,14,USA
Jonathan Rufino Jezus,1991-10-16,6,2013,2019,10,16,Curacao
Michael Ralph,1962-08-10,5,1988,1993,8,10,USA
Edward Walter,1892-02-16,0,1915,1915,2,16,USA
Arthur Eugene,1913-07-14,4,1935,1939,7,14,USA
Peter Alan,1969-05-10,10,1991,2001,5,10,USA
Paul Edward,1928-03-22,0,1953,1953,3,22,USA
David Henry,1882-05-08,0,1911,1911,5,8,USA
Henry Walter,1891-07-12,12,1914,1926,7,12,USA
John Robert,1994-03-05,0,2019,2019,3,5,USA
Freeman Osee,1875-04-11,11,1897,1908,4,11,USA
Paul Frederick,1902-10-08,23,1922,1945,10,8,USA
Steven Wayne,1968-11-20,1,1999,2000,11,20,USA
Theodore Henry,1938-07-11,0,1963,1963,7,11,USA
William Frederick,1865-07-11,15,1886,1901,7,11,USA
Albert Bringhurst,1932-03-22,3,1958,1961,3,22,USA
Alfred William,1958-09-07,7,1983,1990,9,7,USA
Robert James,1944-12-30,3,1965,1968,12,30,USA
Christopher Keith,1978-08-20,2,2006,2008,8,20,USA
Kenneth Marvin,1954-11-23,7,1980,1987,11,23,USA
Henry George,1906-11-01,9,1927,1936,11,1,USA
Ronald Richard,1948-04-14,7,1972,1979,4,14,USA
Andrew Jeffrey,1989-06-27,2,2015,2017,6,27,USA
Albert Christopher,1889-05-12,4,1912,1916,5,12,USA
Arthur William,1928-06-20,7,1953,1960,6,20,USA
George Warren,1926-08-15,10,1955,1965,8,15,USA
Robert Duffy,1923-11-27,4,1951,1955,11,27,USA
Patrick Bowen,1985-09-25,2,2014,2016,9,25,USA
Charles Budd,1950-09-19,4,1975,1979,9,19,USA
David Paul,1953-10-04,6,1979,1985,10,4,USA
Donald Arthur,1962-09-27,6,1983,1989,9,27,USA
Erik Paul,1969-03-25,1,1994,1995,3,25,USA
Frank M.,1882-09-17,14,1904,1918,9,17,USA
Fred William,1901-01-13,10,1927,1937,1,13,USA
Herman Joseph,1912-09-01,0,1940,1940,9,1,USA
Howard Henry,1922-07-03,5,1943,1948,7,3,USA
John Herman Frank,1881-11-15,0,1906,1906,11,15,USA
Jaime Matthew,1991-06-20,1,2018,2019,6,20,USA
Jeffrey Alan,1961-06-02,2,1989,1991,6,2,USA
John H.,1866-04-04,0,1891,1891,4,4,USA
Joseph Charles,1893-07-24,13,1912,1925,7,24,USA
John Clement,1896-09-08,9,1923,1932,9,8,USA
Joseph Charles,1918-08-29,9,1939,1948,8,29,USA
Leonard Bernard,1916-12-05,2,1944,1946,12,5,USA
William Michael,1920-12-17,0,1947,1947,12,17,USA
Michael Alan,1979-11-28,0,2007,2007,11,28,USA
Walter Frederick,1900-04-16,0,1920,1920,4,16,USA
Wilbert Carl,1898-01-31,0,1924,1924,1,31,USA
Edward Wesley,1901-08-21,3,1931,1934,8,21,USA
Charles J.,1884-08-13,0,1906,1906,8,13,USA
Harold Henry,1910-11-23,15,1931,1946,11,23,USA
Jared Michael,1980-02-03,10,2005,2015,2,3,USA
Ferdinand Maurice,1891-01-16,9,1913,1922,1,16,USA
Richard Spencer,1962-01-26,12,1984,1996,1,26,USA
John,1940-10-01,NA,NA,NA,10,1,USA
Wayne Allen,1937-08-06,0,1964,1964,8,6,USA
William Charles,1912-08-04,8,1937,1945,8,4,USA
Patrick James,1990-10-30,0,2016,2016,10,30,USA
Carl James,1971-08-22,0,1996,1996,8,22,USA
William August,1864-04-03,1,1883,1884,4,3,USA
William Charles,1884-04-22,0,1904,1904,4,22,USA
Ralph Richard,1926-08-06,0,1948,1948,8,6,USA
Donald Bernard,1936-03-02,6,1961,1967,3,2,USA
Jeffrey William,1964-05-20,1,1993,1994,5,20,USA
Kyle Joseph,1993-03-05,4,2015,2019,3,5,USA
Michael Scott,1964-07-12,1,1989,1990,7,12,USA
Douglas Randall,1944-02-09,1,1965,1966,2,9,USA
Albert Casper,1882-12-23,3,1908,1911,12,23,USA
Harold Edward,1890-08-23,0,1913,1913,8,23,USA
Pius Louis,1892-11-22,1,1914,1915,11,22,USA
Rudolph Christian,1884-04-06,0,1909,1909,4,6,USA
Arthur Edwin,1889-11-04,0,1912,1912,11,4,USA
Christopher Anthony,1986-09-22,1,2011,2012,9,22,USA
Frank J.,1992-06-29,0,2019,2019,6,29,USA
Michael Fredarick,1986-02-19,1,2011,2012,2,19,USA
Gerald Albert,1931-09-16,0,1955,1955,9,16,USA
Michael Lorri,1958-11-27,12,1980,1992,11,27,USA
Louis,1913-05-20,0,1936,1936,5,20,USA
Lynn J.,1891-07-09,0,1913,1913,7,9,USA
Daryl Anthony,1958-10-03,4,1981,1985,10,3,USA
Herbert Jude,1933-06-07,7,1955,1962,6,7,USA
Darryl Nelson,1968-08-06,0,1993,1993,8,6,USA
Amos Richard,1883-02-05,0,1901,1901,2,5,USA
Richard Lewis,1933-03-15,1,1963,1964,3,15,USA
Richard Edward,1962-07-19,0,1989,1989,7,19,USA
Donald Malcolm,1961-08-16,8,1983,1991,8,16,USA
Phillip Edwin,1870-08-12,1,1900,1901,8,12,USA
Lewis Everett,1892-11-19,12,1914,1926,11,19,USA
Gary Thomas,1968-08-22,1,1991,1992,8,22,USA
George Wilson,1895-11-17,0,1920,1920,11,17,USA
George Charles,1944-03-23,13,1966,1979,3,23,USA
John William,1892-04-18,13,1916,1929,4,18,USA
James,1888-04-23,8,1909,1917,4,23,USA
John William,1887-09-03,0,1914,1914,9,3,USA
John Henry,1952-01-24,3,1974,1977,1,24,USA
LeGrant Edward,1910-07-25,0,1939,1939,7,25,USA
Marshall,1915-07-15,0,1945,1945,7,15,USA
Luke Brandon,1978-06-25,8,2005,2013,6,25,USA
Milton Parker,1861-01-17,4,1882,1886,1,17,USA
Ralph Robert,1947-07-25,5,1972,1977,7,25,Germany
Michael Warren,1955-04-26,12,1979,1991,4,26,USA
Floyd John,1897-12-21,2,1926,1928,12,21,USA
Rodney Darrell,1953-10-16,7,1975,1982,10,16,USA
Robert John,1989-08-29,3,2016,2019,8,29,USA
Tanner Alexander,1994-07-22,2,2017,2019,7,22,USA
Tayler James,1992-06-01,0,2019,2019,6,1,South Africa
Timothy Dale,1966-11-16,6,1991,1997,11,16,USA
Anthony,1951-09-18,11,1973,1984,9,18,USA
James Dean,1960-04-05,1,1984,1985,4,5,USA
Evan Lee,1985-07-19,6,2011,2017,7,19,USA
Troy Alex,1991-07-02,1,2017,2018,7,2,USA
Wayne Allison,1947-10-03,2,1975,1977,10,3,USA
Anthony Raymond,1966-03-19,0,1991,1991,3,19,USA
Xavier Ladel,1987-09-23,2,2014,2016,9,23,USA
William Scott,1968-02-14,4,1989,1993,2,14,USA
Rodney Grant,1956-03-17,8,1980,1988,3,17,USA
Marcos,1975-10-30,12,2002,2014,10,30,Venezuela
Scott Anthony,1975-05-17,4,2001,2005,5,17,USA
Corey Drew,1994-04-27,4,2015,2019,4,27,USA
Kyle Duerr,1987-11-03,8,2011,2019,11,3,USA
Johnny Ray,1938-11-14,1,1964,1965,11,14,USA
Kim Michael,1957-05-06,1,1979,1980,5,6,USA
Rudy Caballero,1968-10-20,19,1989,2008,10,20,USA
Raymond Mark,1955-05-01,9,1981,1990,5,1,USA
William Steven,1964-06-04,4,1988,1992,6,4,USA
Kenneth Eugene,1917-07-06,3,1943,1946,7,6,USA
Todd Andrew,1975-10-23,1,2002,2003,10,23,USA
Thomas Gordon,1887-08-30,5,1912,1917,8,30,USA
Thomas Edward,1910-09-24,5,1940,1945,9,24,USA
George Thomas,1944-11-17,19,1967,1986,11,17,USA
Robert Michael,1978-06-20,8,2001,2009,6,20,USA
Robert Bush,1961-12-11,5,1985,1990,12,11,USA
James Dennison,1882-03-25,7,1902,1909,3,25,USA
Theodore O'Hara,1876-02-10,0,1899,1899,2,10,USA
Frank Edward,1912-08-24,6,1940,1946,8,24,USA
Donald Laverne,1944-02-26,1,1969,1970,2,26,USA
Christopher Jon,1983-10-13,5,2007,2012,10,13,USA
Henry Kenneth,1898-06-01,2,1921,1923,6,1,USA
Shawn Patrick,1977-06-29,0,2002,2002,6,29,USA
Charles Henry,1896-10-13,2,1919,1921,10,13,USA
Ira Robert,1907-02-24,10,1930,1940,2,24,USA
Ralph Laurence,1960-06-20,2,1986,1988,6,20,USA
Charles Frederick,1948-03-20,3,1971,1974,3,20,USA
Christopher Don,1972-12-18,1,2000,2001,12,18,USA
James Patrick,1923-03-17,6,1943,1949,3,17,USA
John Emmett,1861-02-13,8,1884,1892,2,13,USA
Kevin John,1971-02-10,6,1995,2001,2,10,USA
Robert Mitchell,1988-11-10,1,2016,2017,11,10,USA
Herman Neils,1958-04-24,0,1982,1982,4,24,USA
Zachary Ernest,1983-04-11,2,2007,2009,4,11,USA
Kal Hill,1931-04-14,3,1952,1955,4,14,USA
David Vincent,1966-07-19,14,1990,2004,7,19,USA
Diego Pablo,1937-08-17,15,1962,1977,8,17,Cuba
Fernando Alfredo,1975-01-19,5,1998,2003,1,19,Panama
Jean Carlos Enrique,1990-03-17,7,2012,2019,3,17,D.R.
Jose Altagracia,1963-01-26,3,1988,1991,1,26,D.R.
Kurt Elliott,1955-10-16,0,1979,1979,10,16,USA
Philip Matthew,1979-01-28,0,2004,2004,1,28,USA
Harry,1896-05-31,18,1915,1933,5,31,USA
Ricky Allen,1960-08-30,0,1980,1980,8,30,USA
Kevin Lee,1962-03-26,11,1986,1997,3,26,USA
Albert Karl,1872-03-24,12,1894,1906,3,24,USA
William Frank,1970-06-11,7,1996,2003,6,11,USA
Aaron Helmer,1970-06-25,14,1993,2007,6,25,USA
Frank Gibson,1859-10-26,NA,NA,NA,10,26,USA
Todd Douglas,1978-11-09,0,2005,2005,11,9,USA
Allan H.,1934-07-30,NA,NA,NA,7,30,USA
George Alexander,1908-01-04,8,1934,1942,1,4,CAN
Jeffrey Doyle,1964-05-11,3,1985,1988,5,11,USA
Justin Ryan,1986-02-01,3,2011,2014,2,1,USA
Lester Elwood,1897-04-26,1,1922,1923,4,26,USA
Oliver,1881-03-07,0,1910,1910,3,7,USA
David Wayne,1946-09-18,3,1972,1975,9,18,USA
Richard Jay,1943-11-04,9,1965,1974,11,4,USA
Charles Francis,1851-01-21,4,1871,1875,1,21,USA
Samuel Ayres,1990-11-14,0,2019,2019,11,14,USA
Carey Isom,1901-12-05,3,1929,1932,12,5,USA
Steven Garth,1989-07-20,1,2016,2017,7,20,USA
Carroll William,1941-07-26,5,1965,1970,7,26,USA
Michael David,1953-02-24,1,1977,1978,2,24,USA
Marcus Andrew,1990-09-17,6,2013,2019,9,17,USA
Andrew Wasal,1920-09-12,14,1943,1957,9,12,USA
Frank Peter,1967-05-16,2,1992,1994,5,16,USA
Roman Anthony,1931-01-07,3,1958,1961,1,7,USA
Emanuel Robert,1931-04-06,0,1952,1952,4,6,USA
John Phillips Jenkins,1847-12-28,3,1871,1874,12,28,USA
Leopold Theodore,1879-08-27,1,1906,1907,8,27,USA
Stephen Leonard,1955-08-07,0,1982,1982,8,7,USA
Antonio,1995-01-21,2,2017,2019,1,21,Venezuela
Nicholas Peter,1995-06-29,0,2019,2019,6,29,USA
Manuel Modesto,1955-06-26,1,1977,1978,6,26,USA
Jae Weong,1977-05-24,5,2002,2007,5,24,South Korea
Theodore Walter,1923-11-09,5,1942,1947,11,9,USA
Leyson,1985-07-07,0,2012,2012,7,7,D.R.
Daniel Joseph,1974-01-25,11,1996,2007,1,25,USA
William Robert,1924-10-02,5,1949,1954,10,2,USA
Paul David,1958-11-16,1,1981,1982,11,16,USA
Alex Eleazar,1981-02-18,0,2008,2008,2,18,Venezuela
James,1976-05-09,0,2004,2004,5,9,USA
Wascar Radames,1978-06-02,0,2001,2001,6,2,D.R.
Gary Wayne,1956-10-24,2,1977,1979,10,24,USA
Scott Daniel,1967-06-04,10,1991,2001,6,4,USA
Scott David,1967-02-26,16,1988,2004,2,26,USA
Walter Anthony,1918-07-23,5,1941,1946,7,23,USA
Edgar Merle,1903-01-19,0,1928,1928,1,19,USA
John Joseph,1942-07-11,0,1965,1965,7,11,USA
Albert Henry,1944-11-09,3,1969,1972,11,9,USA
Atahualpa O.,1984-11-06,0,2011,2011,11,6,D.R.
Henry Levai,1891-06-01,15,1911,1926,6,1,USA
Luis,1994-02-20,4,2015,2019,2,20,D.R.
Pedro,1993-07-20,4,2015,2019,7,20,D.R.
Richard Allen,1945-01-18,1,1970,1971,1,18,USA
Paul Stanton,1990-05-26,2,2017,2019,5,26,USA
Edward William,1867-06-29,6,1885,1891,6,29,USA
Frank Martin,1921-04-07,1,1943,1944,4,7,USA
Joseph Wheeler,1898-10-09,13,1920,1933,10,9,USA
James Luther,1901-01-05,21,1921,1942,1,5,USA
Truett Banks,1907-05-11,17,1932,1949,5,11,USA
Thomas Wesley,1906-04-16,0,1927,1927,4,16,USA
Elmer George,1926-05-21,0,1948,1948,5,21,USA
Richmond Lockwood,1974-12-29,11,1997,2008,12,29,USA
Christopher Philip,1971-08-03,1,1999,2000,8,3,USA
Frank Joseph,1872-07-08,0,1895,1895,7,8,USA
Jimmy Dale,1951-12-15,6,1977,1983,12,15,USA
Thomas William,1865-03-14,0,1884,1884,3,14,USA
Ralph Orlando,1870-11-23,9,1899,1908,11,23,USA
Gordon Clay,1937-07-04,1,1963,1964,7,4,USA
James Bentley,1872-12-09,17,1896,1913,12,9,USA
Adam Jason,1978-02-06,0,2005,2005,2,6,USA
Brian Wesley,1976-08-30,1,2005,2006,8,30,USA
Kevin Russell,1989-04-07,1,2017,2018,4,7,USA
Justin Healy,1992-09-18,1,2018,2019,9,18,USA
Ralph Newton,1894-03-17,0,1914,1914,3,17,USA
Arthur Joseph,1889-03-22,4,1909,1913,3,22,USA
Francis X.,1859-12-06,0,1884,1884,12,6,USA
John W.,1864-02-18,1,1886,1887,2,18,USA
George W.,1851-10-04,16,1874,1890,10,4,USA
Richard Michael,1991-03-15,1,2015,2016,3,15,USA
Zachary Taylor,1866-07-13,6,1884,1890,7,13,USA
August,1858-03-29,1,1884,1885,3,29,Germany
Arthur Louis,1941-10-14,7,1965,1972,10,14,USA
Paul Gregory,1947-12-11,1,1973,1974,12,11,USA
James Henry,1854-05-04,0,1876,1876,5,4,USA
Walter Dedaker,1900-05-24,6,1923,1929,5,24,USA
Harvey Tillman,1946-07-29,0,1970,1970,7,29,CAN
Howard Samuel,1890-07-21,13,1912,1925,7,21,USA
Harry Root,1889-01-30,0,1912,1912,1,30,USA
Wilfred William,1894-11-04,0,1920,1920,11,4,USA
Daniel Webster,1865-03-23,2,1889,1891,3,23,USA
John Francis,1873-12-03,4,1892,1896,12,3,USA
Joseph Aloysius,1897-02-11,0,1915,1915,2,11,USA
Thomas Michael,1939-07-15,8,1962,1970,7,15,USA
Owen Dennis Ignatius,1879-12-22,4,1903,1907,12,22,USA
Maurice Joseph,1897-02-11,11,1915,1926,2,11,USA
William Porter,1875-02-07,4,1904,1908,2,7,USA
Warren Hilton,1880-11-30,0,1906,1906,11,30,USA
Walter Charles,1933-01-23,1,1959,1960,1,23,USA
Wilmer Ebert,1927-07-31,6,1954,1960,7,31,USA
Robert Clayton,1925-09-26,15,1949,1964,9,26,USA
Ralph Edward,1895-04-11,0,1917,1917,4,11,USA
Richard Louis,1950-04-15,2,1973,1975,4,15,USA
William Howard,1950-01-18,3,1973,1976,1,18,USA
Bayard Heston,1881-08-06,5,1905,1910,8,6,USA
Joshua David,1981-01-26,1,2006,2007,1,26,USA
Michael Tyrone,1961-10-04,8,1987,1995,10,4,USA
George Oscar,1869-11-02,1,1893,1894,11,2,USA
John Henry,1869-08-13,3,1890,1893,8,13,USA
William A.,1855-01-01,NA,NA,NA,1,1,USA
Francis Joseph,1883-04-08,3,1905,1908,4,8,USA
Joseph Benjamin,1899-08-01,12,1922,1934,8,1,USA
Jeffrey Thomas,1963-07-30,0,1988,1988,7,30,USA
Jonathan Taylor,1967-11-04,6,1993,1999,11,4,USA
Alfred Louis,1873-05-22,8,1901,1909,5,22,United Kingdom
Albert Simpson,1881-03-01,8,1907,1915,3,1,USA
Michael Thomas,1994-09-17,0,2019,2019,9,17,USA
Benjamin Nathaniel,1893-06-18,1,1917,1918,6,18,USA
Robert John,1933-06-29,10,1957,1967,6,29,USA
Bryan Anthony,1987-11-08,8,2011,2019,11,8,USA
Christopher James,1993-10-20,1,2018,2019,10,20,USA
Donald Wellington,1944-02-23,5,1967,1972,2,23,USA
Frederick Lander,1859-05-31,5,1883,1888,5,31,USA
Royal N.,1884-09-29,0,1908,1908,9,29,USA
Jeffrey Lee,1966-07-07,11,1990,2001,7,7,USA
James Aloysius,1893-08-13,8,1913,1921,8,13,USA
James Robert,1890-12-04,14,1913,1927,12,4,USA
Samuel Elmer,1863-05-07,5,1888,1893,5,7,USA
Travis R.,1990-04-16,4,2015,2019,4,16,USA
Daniel Charles,1876-11-08,6,1901,1907,11,8,USA
Arthur Joseph,1896-04-25,8,1916,1924,4,25,USA
Danny Todd,1961-08-02,10,1987,1997,8,2,USA
Gerald Joseph,1881-10-26,0,1905,1905,10,26,USA
John Michael Joseph,1904-12-27,0,1928,1928,12,27,USA
Albert Berley,1900-05-24,2,1928,1930,5,24,USA
Ryan Nelson,1979-08-29,5,2005,2010,8,29,USA
Mervyn John,1900-09-05,17,1927,1944,9,5,USA
Michael Joseph,1867-03-10,0,1887,1887,3,10,USA
John Edward,1874-05-23,0,1902,1902,5,23,USA
David William,1883-07-09,13,1906,1919,7,9,USA
Patrick Henry,1898-11-29,4,1918,1922,11,29,USA
George Penfield,1890-04-13,0,1912,1912,4,13,USA
Ray Solomon,1929-09-19,0,1957,1957,9,19,USA
Thomas Aaron,1977-08-28,0,2007,2007,8,28,USA
Francis Joseph,1920-10-02,8,1947,1955,10,2,USA
Steven Francis,1942-12-05,1,1968,1969,12,5,USA
Samuel James Tilden,1878-11-23,16,1897,1913,11,23,USA
Timothy James,1868-02-13,1,1895,1896,2,13,USA
John Thomas,1893-04-15,1,1920,1921,4,15,USA
James Thomas,1913-06-03,0,1936,1936,6,3,USA
Thomas Patrick,1877-11-05,8,1900,1908,11,5,USA
Thomas Clancy,1894-03-31,11,1915,1926,3,31,USA
Hollis Kimball,1920-11-26,2,1951,1953,11,26,USA
Earl Homer,1893-02-12,10,1921,1931,2,12,USA
Charles Joseph,1909-04-17,0,1936,1936,4,17,USA
Andrew Mark,1971-11-19,6,1996,2002,11,19,USA
Ben M.,1978-07-18,11,2001,2012,7,18,USA
Larry Kent,1959-12-06,9,1984,1993,12,6,USA
Gary Antonian,1968-11-18,21,1988,2009,11,18,USA
Justus Kane,1996-05-13,1,2018,2019,5,13,USA
John T.,1958-02-23,10,1981,1991,2,23,USA
Bob Mitchell,1950-11-27,3,1974,1977,11,27,USA
Roland Frank,1936-12-17,5,1961,1966,12,17,USA
Scott Patrick,1968-11-28,4,1997,2001,11,28,USA
Frank Victor,1898-12-16,1,1918,1919,12,16,USA
Hubert Leneirre,1910-10-26,0,1935,1935,10,26,USA
James Philip,1943-11-18,11,1966,1977,11,18,USA
Steven Daniel,1983-03-10,1,2008,2009,3,10,USA
Benjamin Davis,1969-09-21,0,1993,1993,9,21,USA
Christopher Bob,1980-06-26,5,2004,2009,6,26,USA
Andrew Kemper,1888-06-29,0,1915,1915,6,29,USA
Stephen Michael,1915-04-09,1,1944,1945,4,9,USA
Bert Robert,1920-06-28,0,1945,1945,6,28,USA
Jack Leroy,1931-05-13,3,1953,1956,5,13,USA
Lawrence William,1919-04-03,NA,NA,NA,4,3,USA
Raymond Francis,1897-05-03,0,1924,1924,5,3,USA
James Chandler,1992-08-25,0,2019,2019,8,25,USA
Keith Wayne,1968-01-21,4,1992,1996,1,21,USA
Ronald Wayne,1960-10-27,2,1984,1986,10,27,USA
William Henry,1896-08-15,14,1918,1932,8,15,USA
James Harold,1991-12-27,2,2017,2019,12,27,USA
Neill Rawlins,1921-11-20,0,1948,1948,11,20,USA
Patrick Arthur,1957-12-04,10,1981,1991,12,4,USA
Eugene Anthony,1896-11-14,2,1918,1920,11,14,USA
Royden Richard,1907-01-25,2,1929,1931,1,25,USA
Edward Creech,1897-07-18,0,1924,1924,7,18,USA
John Clinton,1904-10-26,0,1930,1930,10,26,USA
Vincent Thomas,1910-03-27,0,1935,1935,3,27,USA
Lester Daniel,1890-11-26,0,1914,1914,11,26,USA
Darrell Edward,1966-12-04,0,1993,1993,12,4,USA
Joel Powers,1890-11-04,0,1915,1915,11,4,USA
Dennis Lee,1956-05-03,2,1978,1980,5,3,USA
Fred Peter,1889-06-13,0,1911,1911,6,13,USA
George Friederich,1977-04-19,8,2004,2012,4,19,USA
Lawrence,1935-07-25,10,1958,1968,7,25,USA
Norman Burt,1931-07-16,4,1959,1963,7,16,USA
Ryan Sebastian,1990-05-25,1,2017,2018,5,25,USA
Timothy Shawn,1965-09-10,1,1990,1991,9,10,USA
Barry Steven,1938-07-06,4,1959,1963,7,6,USA
William Joseph,1863-10-25,NA,NA,NA,10,25,USA
James Cornelius,1909-07-09,4,1930,1934,7,9,USA
Benjamin Cowan,1903-06-17,7,1924,1931,6,17,USA
Charles Jessamine,1879-12-10,5,1902,1907,12,10,USA
Jason Alexander,1976-10-19,4,2002,2006,10,19,USA
James Anthony,1981-12-20,12,2006,2018,12,20,USA
Francis Leroy,1891-09-21,0,1915,1915,9,21,USA
Robert Scot,1975-07-22,9,2001,2010,7,22,USA
Stephen Mack,1958-11-30,4,1985,1989,11,30,USA
Thomas Charles,1964-08-14,1,1992,1993,8,14,USA
Vincent William,1900-11-18,0,1924,1924,11,18,CAN
Garland Jessie,1935-03-28,7,1957,1964,3,28,USA
Stephen Earl,1966-01-05,0,1992,1992,1,5,USA
Mike,1968-08-09,NA,NA,NA,8,9,NA
James Robert,1914-05-14,0,1939,1939,5,14,USA
Enoch Erskine,1892-09-07,1,1921,1922,9,7,USA
Zakary Sebastien,1968-10-14,0,1993,1993,10,14,USA
William D.,1860-12-05,12,1886,1898,12,5,USA
Anthony Razor,1956-07-18,4,1983,1987,7,18,USA
Tsuyoshi,1972-01-28,2,2001,2003,1,28,Japan
Ralph Peter,1895-10-04,3,1922,1925,10,4,USA
Timothy James,1867-11-06,1,1890,1891,11,6,USA
David Noel,1959-11-13,0,1985,1985,11,13,CAN
William Martin,1882-11-18,3,1906,1909,11,18,USA
Braden Alec,1992-02-22,2,2016,2018,2,22,USA
Craig Barry,1963-01-07,12,1986,1998,1,7,Australia
Joseph Clark,1935-05-09,5,1958,1963,5,9,USA
Charles Arthur,1906-08-13,4,1928,1932,8,13,USA
Clair Lee,1898-06-20,0,1920,1920,6,20,USA
Barton Arvin,1940-01-04,4,1964,1968,1,4,USA
Robert Charles,1954-06-25,10,1977,1987,6,25,USA
Ernest Raeford,1901-05-24,1,1924,1925,5,24,USA
Steven Brian,1956-10-12,0,1982,1982,10,12,USA
Alvis Newman,1918-04-25,5,1941,1946,4,25,USA
Ivey Merwin,1907-01-22,3,1931,1934,1,22,USA
George Quintus,1859-01-06,11,1886,1897,1,6,USA
John Costen,1942-02-08,1,1964,1965,2,8,USA
Urban James,1890-09-22,12,1916,1928,9,22,USA
Charles Landis,1939-08-10,3,1961,1964,8,10,USA
Matthew David,1986-09-27,6,2013,2019,9,27,USA
Milburn James,1905-11-13,11,1929,1940,11,13,USA
Frank Strickland,1919-07-23,0,1947,1947,7,23,USA
Edward Christopher,1920-01-27,5,1941,1946,1,27,USA
Raymond Curtis,1889-11-18,0,1916,1916,11,18,USA
Ronald Lee,1931-09-19,0,1959,1959,9,19,USA
Thomas Michael,1945-02-21,10,1967,1977,2,21,USA
Kelly Brian,1980-04-29,8,2005,2013,4,29,USA
William David,1904-05-26,8,1928,1936,5,26,USA
Ernest Grady,1891-03-24,8,1912,1920,3,24,USA
Raymond Everett,1921-06-09,3,1946,1949,6,9,USA
William Ross,1937-11-27,9,1960,1969,11,27,USA
Charles Henry,1892-04-19,9,1915,1924,4,19,USA
J Christopher,1937-09-19,14,1959,1973,9,19,USA
David Orvis,1917-05-11,1,1940,1941,5,11,USA
Richard Ryan,1972-12-06,0,2005,2005,12,6,USA
Burton Edwin,1884-10-18,14,1909,1923,10,18,USA
Clyde Mitchell,1912-03-20,14,1935,1949,3,20,USA
John H.,1851-09-30,5,1879,1884,9,30,USA
Brian Douglas,1968-09-26,16,1993,2009,9,26,USA
John Joseph,1891-01-14,9,1911,1920,1,14,USA
William Nathaniel,1956-05-23,NA,NA,NA,5,23,USA
Eric Vaughn,1956-05-19,10,1981,1991,5,19,USA
Chasen Dean,1990-07-12,5,2014,2019,7,12,USA
Leven Laurence,1866-03-12,2,1887,1889,3,12,USA
Harry Graydon,1896-09-02,1,1922,1923,9,2,USA
George Thomas,1924-12-13,7,1948,1955,12,13,USA
Jack Burdett,1987-06-18,8,2011,2019,6,18,USA
Paul Kenneth,1970-09-16,13,1994,2007,9,16,USA
Frank Harry,1866-12-10,11,1890,1901,12,10,USA
Wallace Luther,1888-10-10,1,1911,1912,10,10,USA
Anthony Warren,1973-05-14,0,1999,1999,5,14,USA
Harry,1915-03-05,2,1942,1944,3,5,USA
Terrance Darnell,1966-08-16,13,1990,2003,8,16,USA
Vincent William,1921-09-05,0,1945,1945,9,5,USA
Edward Joseph,1897-03-30,11,1916,1927,3,30,USA
Joseph Todd,1967-10-25,5,1993,1998,10,25,CAN
Richard Walther,1912-02-19,13,1932,1945,2,19,USA
Norman Leroy,1933-07-26,12,1956,1968,7,26,USA
Paul Edward,1953-06-05,4,1974,1978,6,5,USA
Wilfred Charles,1937-01-14,11,1964,1975,1,14,USA
Dwight Leroy,1937-08-05,4,1963,1967,8,5,USA
Frederick Edwin,1870-03-05,0,1890,1890,3,5,USA
John Herbert,1874-07-08,1,1905,1906,7,8,USA
Kevin Ryan,1989-07-20,4,2013,2017,7,20,USA
Oscar Sylvester,1901-08-14,1,1925,1926,8,14,USA
Ulises,1967-03-27,0,1988,1988,3,27,P.R.
Magneuris,1996-04-07,2,2017,2019,4,7,D.R.
Moises,1988-09-24,6,2012,2018,9,24,D.R.
Ruben Angel,1965-10-06,20,1986,2006,10,6,P.R.
Edward Tilden,1875-04-02,7,1901,1908,4,2,USA
Roy Edward,1926-11-18,16,1949,1965,11,18,USA
Francis Leonard,1904-03-21,5,1926,1931,3,21,USA
Wesley Peter,1891-09-24,2,1914,1916,9,24,USA
Wesley Triplett,1899-01-17,1,1929,1930,1,17,USA
Walter Donald Aloysius,1910-10-12,2,1943,1945,10,12,USA
Seth DeWitt,1874-04-30,0,1893,1893,4,30,USA
Brian Patrick,1974-07-27,6,2000,2006,7,27,USA
Edward James,1914-06-06,2,1937,1939,6,6,USA
Edward,1865-02-22,0,1888,1888,2,22,USA
Carlos,1979-04-23,8,2002,2010,4,23,Venezuela
Daniel James,1896-10-05,0,1919,1919,10,5,USA
Jose Leonel,1973-12-19,6,1996,2002,12,19,Mexico
Walter,1977-01-04,0,2009,2009,1,4,Mexico
Aaron Albert,1935-08-26,1,1955,1956,8,26,USA
Charles Anthony Ryan,1924-10-13,9,1948,1957,10,13,USA
David Joseph,1967-09-29,7,1992,1999,9,29,USA
Kenneth Joseph,1916-05-03,12,1939,1951,5,3,USA
Luis Pascual,1956-10-23,0,1978,1978,10,23,D.R.
Tomas Roberto,1945-10-14,2,1970,1972,10,14,D.R.
Albert,1921-10-07,4,1950,1954,10,7,USA
William Anthony,1971-11-28,5,1995,2000,11,28,USA
Aloysius Harry,1902-05-22,20,1924,1944,5,22,USA
Andrelton A.,1989-09-04,7,2012,2019,9,4,Curacao
Brian Lee,1973-09-04,3,1998,2001,9,4,USA
Curtis Thomas,1929-05-19,20,1947,1967,5,19,USA
George Washington,1885-01-29,5,1910,1915,1,29,USA
Joseph S.,1845-06-13,4,1871,1875,6,13,USA
John Earl,1924-07-07,0,1949,1949,7,7,USA
Lewis,1838-08-27,NA,NA,NA,8,27,USA
Nelson Bernard,1963-06-27,3,1984,1987,6,27,USA
Patrick Clement,1908-11-29,1,1928,1929,11,29,USA
Shae Austin,1990-09-03,3,2014,2017,9,3,USA
Ted Lyle,1949-08-09,20,1968,1988,8,9,USA
Michael Howard,1967-01-12,9,1990,1999,1,12,USA
Alfredo,1981-05-08,8,2008,2016,5,8,D.R.
Douglas Eugene,1966-09-15,1,1991,1992,9,15,USA
Henry Joseph,1862-08-25,3,1887,1890,8,25,USA
Jason William,1973-11-13,5,2002,2007,11,13,USA
Melbern Ellis,1900-07-01,1,1931,1932,7,1,USA
Michael Edward,1883-04-13,6,1909,1915,4,13,USA
Randall Carlito,1975-05-25,9,1997,2006,5,25,Curacao
Sylvester Adam,1897-12-14,1,1923,1924,12,14,USA
Larry Allan,1977-08-26,2,2004,2006,8,26,USA
Richard Charles,1943-07-28,7,1962,1969,7,28,USA
Thomas Leo,1927-09-15,0,1953,1953,9,15,USA
Harry Leon,1925-12-03,8,1951,1959,12,3,USA
Joe Allen,1951-12-31,8,1975,1983,12,31,USA
Steven Edward,1948-08-30,0,1972,1972,8,30,USA
Wayne Kirby,1948-12-02,7,1970,1977,12,2,USA
Duane B.,1941-06-05,10,1964,1974,6,5,USA
Gregory Emmett,1946-06-28,0,1966,1966,6,28,USA
Lucas Sundberg,1994-05-10,2,2017,2019,5,10,USA
Clarence,1891-05-24,0,1915,1915,5,24,USA
Matthew Stephen,1960-03-22,11,1981,1992,3,22,USA
Steven Scott,1971-08-02,1,1998,1999,8,2,CAN
Herbert Sylvester,1887-09-08,0,1908,1908,9,8,CAN
Hosea John,1885-03-20,0,1909,1909,3,20,USA
William Robert,1944-04-24,13,1964,1977,4,24,USA
Christopher Verdell,1972-08-15,6,1999,2005,8,15,USA
Duane Earl,1972-08-06,2,1994,1996,8,6,USA
Bert Elmer,1918-06-26,14,1945,1959,6,26,USA
John Edward,1896-11-27,0,1922,1922,11,27,USA
Jonathan Lee,1991-09-18,1,2014,2015,9,18,USA
Kenneth Wayne,1947-06-10,14,1970,1984,6,10,USA
Frederic William,1910-02-24,5,1934,1939,2,24,USA
Brett Allen,1984-12-26,0,2010,2010,12,26,USA
Richard Francis,1923-01-16,0,1945,1945,1,16,USA
John White,1946-08-29,0,1969,1969,8,29,USA
Tony Marcel,1983-07-12,10,2009,2019,7,12,USA
Michael Robert,1971-05-13,5,1995,2000,5,13,USA
Andrew Frank,1983-01-13,2,2005,2007,1,13,USA
Chance Thomas Leo,1995-02-24,2,2017,2019,2,24,USA
Steven Michael,1969-12-02,0,2000,2000,12,2,USA
Douglas Randall,1957-09-26,9,1982,1991,9,26,USA
Tommie Wayne,1942-04-12,8,1962,1970,4,12,USA
David Michael,1931-10-16,6,1956,1962,10,16,USA
Richard Allan,1920-11-02,7,1946,1953,11,2,USA
George Harold,1893-03-24,15,1915,1930,3,24,USA
Sebastian Daniel,1920-07-26,15,1939,1954,7,26,USA
Charles Vedder,1881-09-22,0,1909,1909,9,22,USA
Peter,1913-09-23,2,1936,1938,9,23,USA
James Gerard,1958-09-20,2,1982,1984,9,20,USA
Edward,1863-02-26,0,1884,1884,2,26,USA
Grady,1982-08-02,11,2004,2015,8,2,USA
Scott Daniel,1985-01-04,4,2010,2014,1,4,USA
Theodore Crawford,1945-04-15,11,1969,1980,4,15,USA
Francis Michael,1910-09-30,8,1935,1943,9,30,USA
David Lindsey,1951-06-12,3,1977,1980,6,12,USA
Tyler Wayne,1991-07-13,7,2012,2019,7,13,USA
Joseph Douglas,1964-09-26,0,1989,1989,9,26,USA
David Wendell,1940-01-10,0,1957,1957,1,10,USA
David L.,1891-12-29,0,1910,1910,12,29,USA
Harry Clement,1919-03-30,0,1942,1942,3,30,CAN
Robert Roe,1945-10-30,0,1970,1970,10,30,USA
William Franklin,1895-10-16,5,1921,1926,10,16,USA
Robert Ralph,1931-10-03,12,1954,1966,10,3,USA
Elisha Harrison,1897-06-25,1,1922,1923,6,25,USA
Joel Patrick,1961-02-21,8,1983,1991,2,21,USA
Kyle Trent,1990-03-01,0,2013,2013,3,1,USA
Louis Peter,1932-06-02,3,1956,1959,6,2,USA
Eric L.,1992-10-26,2,2017,2019,10,26,USA
Craig Richard,1947-09-01,6,1973,1979,9,1,USA
Matthew Thomas,1989-07-30,1,2018,2019,7,30,USA
John S.,1880-05-08,2,1901,1903,5,8,USA
William Joseph,1930-12-18,13,1954,1967,12,18,USA
Matthew Leland,1972-11-06,0,2000,2000,11,6,USA
Robert Jacob,1957-10-08,1,1982,1983,10,8,USA
Arthur W.,1859-10-28,0,1884,1884,10,28,USA
Gordon Leigh,1904-10-09,5,1930,1935,10,9,USA
James Franklin,1873-07-11,9,1899,1908,7,11,USA
Roger Lee,1953-11-04,0,1979,1979,11,4,USA
Walter Jennings,1878-12-15,0,1910,1910,12,15,USA
Anthony Thomas,1984-01-06,1,2010,2011,1,6,USA
Daniel Alexander,1992-05-24,0,2017,2017,5,24,USA
Cyril Charles,1886-03-23,7,1911,1918,3,23,USA
John Henry,1898-08-08,0,1920,1920,8,8,USA
Austin Thomas,1992-12-13,2,2017,2019,12,13,USA
Douglas,1980-02-04,6,2006,2012,2,4,USA
James Michael,1950-06-19,15,1971,1986,6,19,USA
John Thomas,1878-01-06,8,1901,1909,1,6,USA
Michael J.,1866-11-26,7,1884,1891,11,26,USA
Philip Richard,1893-02-25,0,1915,1915,2,25,USA
Byron Atkins,1884-10-06,0,1910,1910,10,6,USA
Donald Martin,1958-09-11,15,1982,1997,9,11,USA
Enos Bradsher,1916-04-27,21,1938,1959,4,27,USA
Sterling Feore,1941-11-18,0,1964,1964,11,18,USA
William Grover,1948-02-21,2,1972,1974,2,21,USA
Elbert,1901-10-05,0,1926,1926,10,5,USA
Foster Herbert,1902-04-26,0,1928,1928,4,26,USA
Louis Mortimer,1926-09-08,8,1950,1958,9,8,USA
Terrmel,1977-03-18,3,2004,2007,3,18,USA
Aaron Allan,1992-09-04,2,2017,2019,9,4,USA
Bruce Adams,1914-10-04,0,1944,1944,10,4,USA
Yale Yeastman,1890-12-24,6,1913,1919,12,24,USA
Dwain Clifford,1918-12-01,1,1948,1949,12,1,USA
Brian John,1981-03-27,2,2006,2008,3,27,USA
Heath,1966-06-07,9,1991,2000,6,7,USA
Ronald Reece,1945-07-02,2,1969,1971,7,2,USA
Kevin Michael,1984-05-04,7,2007,2014,5,4,USA
Joseph Andrew,1966-12-19,10,1991,2001,12,19,USA
Craig Lee,1962-06-19,0,1988,1988,6,19,USA
Aaron James,1971-11-23,12,1994,2006,11,23,USA
Charles Albert,1905-10-24,0,1930,1930,10,24,USA
George Henry,1953-07-31,0,1978,1978,7,31,USA
James Arthur Patrick,1937-03-08,3,1955,1958,3,8,USA
Mark Allan,1967-11-12,0,1996,1996,11,12,USA
Roy Frederick,1926-06-09,10,1948,1958,6,9,USA
Roy Frederick,1952-10-25,12,1975,1987,10,25,USA
Walter Clayton,1893-04-24,2,1917,1919,4,24,USA
William Darwin,1871-06-27,1,1890,1891,6,27,USA
Jon David,1973-11-12,2,1999,2001,11,12,USA
Joseph Paul,1923-07-07,0,1946,1946,7,7,USA
Devin Paul,1995-09-07,0,2019,2019,9,7,USA
John Patrick,1965-03-17,11,1986,1997,3,17,USA
Alfred Kendricks,1903-12-13,0,1926,1926,12,13,USA
Alfred John,1907-10-12,11,1934,1945,10,12,USA
Alphonse Eugene,1928-02-07,11,1953,1964,2,7,USA
Arthur Laird,1906-06-21,0,1932,1932,6,21,USA
Calvin Bernard,1941-09-04,1,1970,1971,9,4,USA
William Garland,1934-06-08,4,1958,1962,6,8,USA
Billy Edward,1953-07-14,6,1975,1981,7,14,USA
Billy Lavern,1954-09-13,0,1981,1981,9,13,USA
Blake Matthew,1987-12-09,0,2016,2016,12,9,USA
Robert Ashley,1890-07-19,2,1913,1915,7,19,USA
Robert Eldridge,1895-04-22,14,1923,1937,4,22,USA
Robert Gilchrist,1930-02-01,4,1955,1959,2,1,USA
Bobby Gene,1934-05-28,8,1957,1965,5,28,USA
Robert Walkup,1928-05-13,1,1958,1959,5,13,USA
Robert Eugene,1974-05-10,4,1998,2002,5,10,USA
Bryn Nelson,1955-08-11,12,1981,1993,8,11,USA
Brick Dudley,1959-05-02,1,1987,1988,5,2,USA
Randall Brian,1972-07-19,0,2000,2000,7,19,USA
Lewis Oscar,1880-08-20,2,1904,1906,8,20,USA
Robert Allan,1979-10-23,1,2001,2002,10,23,USA
Burch Taylor,1990-04-12,6,2013,2019,4,12,USA
Emanuel Carr,1901-04-08,1,1923,1924,4,8,USA
Carson Donald,1989-10-19,4,2014,2018,10,19,USA
Caleb Anthony,1991-07-28,2,2017,2019,7,28,USA
Charles J.,1840-12-11,0,1871,1871,12,11,USA
Charles Edwin,1880-04-20,12,1902,1914,4,20,USA
John William,1892-12-02,0,1913,1913,12,2,USA
Charles William,1937-09-15,9,1960,1969,9,15,USA
Christopher William,1957-07-18,2,1981,1983,7,18,USA
Charles Edward,1969-10-21,1,2000,2001,10,21,USA
Christopher Michael,1981-04-09,9,2008,2017,4,9,USA
Chad Dennis,1989-10-02,1,2014,2015,10,2,USA
Christopher Patrick,1988-08-19,0,2017,2017,8,19,USA
Clay Jamieson,1914-09-11,2,1938,1940,9,11,USA
David Merwin,1914-12-17,1,1938,1939,12,17,USA
David Stanley,1955-01-21,12,1980,1992,1,21,USA
David Wayne,1957-08-30,1,1984,1985,8,30,USA
Daryl Clinton,1960-07-29,0,1990,1990,7,29,USA
Daniel Scott,1969-04-20,2,1992,1994,4,20,USA
Daniel Charles,1975-09-15,4,1999,2003,9,15,USA
Richard Harrison,1927-07-21,4,1951,1955,7,21,USA
Richard Arthur,1939-05-17,2,1963,1965,5,17,USA
Richard Kelly,1944-08-25,0,1969,1969,8,25,USA
Douglass Weldon,1892-05-25,0,1912,1912,5,25,USA
Dominic David Rene,1995-06-15,2,2017,2019,6,15,USA
Andrew David,1993-09-24,0,2018,2018,9,24,USA
John Dwight,1963-11-08,7,1989,1996,11,8,USA
John Dwight,1992-10-26,2,2017,2019,10,26,USA
Earl Leonard,1891-01-20,6,1916,1922,1,20,USA
Earl Sutton,1897-02-14,11,1919,1930,2,14,USA
Earl Calvin,1928-03-14,0,1955,1955,3,14,USA
Edgar Eugene,1862-06-12,7,1883,1890,6,12,USA
Albert Edward,1860-10-15,0,1883,1883,10,15,USA
Rhesa Edward,1879-02-21,0,1906,1906,2,21,USA
Edgar,1913-12-14,11,1936,1947,12,14,USA
Edgar Alexander,1863-11-02,0,1884,1884,11,2,CAN
Elmer Ellsworth,1868-03-23,15,1886,1901,3,23,USA
Elmer John,1892-09-21,11,1914,1925,9,21,USA
Ernest Henry,1899-10-11,0,1930,1930,10,11,USA
Frank L.,1857-11-24,0,1884,1884,11,24,CAN
Frank Elmer,1879-10-28,11,1904,1915,10,28,USA
Frederick,1878-11-24,0,1907,1907,11,24,USA
Fred Vincent,1891-07-29,4,1913,1917,7,29,USA
Frank Thomas,1928-04-04,6,1950,1956,4,4,USA
George J.,1859-04-20,14,1884,1898,4,20,USA
George Allen,1892-05-31,7,1916,1923,5,31,USA
George Selby,1901-10-27,4,1926,1930,10,27,USA
George Cornelius,1937-07-07,3,1963,1966,7,7,USA
Gregory Alan,1967-04-05,2,1989,1991,4,5,USA
Gregory Thomas,1983-12-22,2,2008,2010,12,22,USA
Harry W.,1856-02-05,12,1877,1889,2,5,USA
Harvey Fetterhoff,1871-07-24,0,1896,1896,7,24,USA
Harry Thomas,1874-10-31,9,1901,1910,10,31,United Kingdom
Henry Joseph,1883-07-14,0,1910,1910,7,14,USA
Harrison Morton,1889-08-15,0,1912,1912,8,15,USA
James Harry,1890-05-15,4,1914,1918,5,15,USA
Harold Laverne,1902-06-30,3,1932,1935,6,30,USA
Harold Wayne,1930-12-07,9,1955,1964,12,7,USA
Harold Raymond,1931-06-01,9,1956,1965,6,1,USA
George Henry,1871-10-24,6,1897,1903,10,24,USA
Hilton Lee,1907-02-27,NA,NA,NA,2,27,USA
Jacob John,1887-06-10,0,1911,1911,6,10,USA
John Joseph,1893-08-08,0,1912,1912,8,8,USA
Jack,1895-06-23,14,1915,1929,6,23,USA
Jack Hatfield,1935-11-15,2,1962,1964,11,15,USA
Jason William,1977-07-24,8,2001,2009,7,24,USA
Jacob Matthew,1990-06-02,0,2016,2016,6,2,USA
James Lawrence,1895-05-15,8,1914,1922,5,15,USA
James Lorne,1954-09-08,0,1982,1982,9,8,USA
Salvatore Joseph,1893-12-29,0,1913,1913,12,29,USA
John Marshall,1906-09-27,0,1931,1931,9,27,USA
Joseph Michael,1984-03-22,12,2007,2019,3,22,USA
Jordan L.,1986-02-04,1,2010,2011,2,4,USA
Joshua Allen,1987-08-07,4,2015,2019,8,7,USA
Joshua Dwayne,1989-10-11,0,2019,2019,10,11,USA
Judson Grant,1869-01-13,8,1893,1901,1,13,USA
Keith Lavarne,1953-05-03,3,1977,1980,5,3,USA
Kenneth Earl,1958-02-12,2,1981,1983,2,12,USA
Patrick Keith,1961-10-20,1,1984,1985,10,20,USA
Kevan Alan,1988-06-28,3,2016,2019,6,28,USA
Armstrong Frederick,1887-01-04,0,1912,1912,1,4,United Kingdom
Lionel H.,1859-05-13,0,1890,1890,5,13,USA
Lee Arthur,1957-12-04,17,1980,1997,12,4,USA
Lonnie,1955-12-22,16,1978,1994,12,22,USA
Edward Mayo,1915-01-17,0,1945,1945,1,17,USA
Mark Christopher,1955-11-23,0,1983,1983,11,23,USA
Mark Edward,1970-05-07,9,1994,2003,5,7,USA
Matthew Joel,1979-06-15,1,2006,2007,6,15,USA
Mallex Lydell,1993-05-06,3,2016,2019,5,6,USA
Elwood Hope,1904-11-16,0,1926,1926,11,16,USA
Milton,1929-03-27,0,1955,1955,3,27,USA
Billy Mike,1955-01-21,7,1982,1989,1,21,USA
Michael Anthony,1961-02-23,5,1984,1989,2,23,USA
Michael Anthony,1963-10-31,1,1989,1990,10,31,USA
Michael Anthony,1977-09-19,4,2002,2006,9,19,USA
Murphy,1987-08-25,0,2018,2018,8,25,USA
Nathaniel Beverly,1935-04-26,0,1962,1962,4,26,USA
Orlin Hudson,1865-10-19,0,1894,1894,10,19,USA
Osborne Earl,1954-12-26,18,1978,1996,12,26,USA
Paul Stoner,1888-05-07,0,1916,1916,5,7,USA
Lawrence Patrick,1894-05-16,0,1920,1920,5,16,USA
Paul Leslie,1931-03-19,5,1953,1958,3,19,USA
Peter Luke,1940-03-19,1,1962,1963,3,19,USA
Peter John,1966-02-27,11,1987,1998,2,27,USA
John Francis,1864-12-12,7,1884,1891,12,12,USA
Charles Marvin,1856-10-12,11,1880,1891,10,12,CAN
Clarence Ossie,1892-05-23,4,1913,1917,5,23,USA
Raymond Edward,1955-09-18,2,1981,1983,9,18,USA
Rex,1861-01-04,0,1886,1886,1,4,USA
James Carlisle,1890-04-06,8,1911,1919,4,6,USA
Willard Jehu,1892-04-11,1,1917,1918,4,11,USA
Marvin Harold,1899-07-17,0,1925,1925,7,17,USA
Richard Paul,1904-05-18,0,1927,1927,5,18,USA
Carl Reginald,1945-04-02,16,1966,1982,4,2,USA
LeRoy Purdy,1961-09-06,7,1984,1991,9,6,USA
Roger Craig,1966-03-21,1,1993,1994,3,21,USA
Walter Roy,1976-05-18,1,2001,2002,5,18,USA
Rufus Frazier,1905-01-24,0,1927,1927,1,24,USA
Garry Seth,1982-09-30,10,2007,2017,9,30,USA
Sherrod Malone,1891-02-18,16,1911,1927,2,18,USA
Samuel J.,1868-03-19,0,1888,1888,3,19,USA
James Abner,1873-11-24,0,1898,1898,11,24,USA
Stephen Lydell,1978-09-01,0,2003,2003,9,1,USA
Sydney A.,1883-08-31,7,1908,1915,8,31,USA
Thomas Edward,1871-12-05,4,1894,1898,12,5,USA
Anthony,1884-05-14,4,1907,1911,5,14,USA
Tommy Alexander,1948-08-01,4,1973,1977,8,1,USA
Travis William,1972-11-07,8,1998,2006,11,7,USA
Tyler Douglas,1991-07-01,0,2017,2017,7,1,USA
Vincent Ambrose,1915-12-07,5,1941,1946,12,7,USA
Wallace Henry,1888-03-13,3,1911,1914,3,13,USA
Wilbur Floyd,1886-08-30,0,1909,1909,8,30,USA
Willie,1939-02-11,8,1963,1971,2,11,USA
Willie Everett,1967-08-27,0,1994,1994,8,27,USA
William Michael,1989-07-10,7,2012,2019,7,10,USA
William Dills,1995-03-28,0,2019,2019,3,28,USA
Zane William,1960-12-28,12,1984,1996,12,28,USA
Justin Kyle,1986-12-05,9,2010,2019,12,5,USA
Joshua Michael,1988-11-26,2,2016,2018,11,26,USA
Jacob Michael,1989-02-09,4,2014,2018,2,9,USA
Clyde Hetrick,1914-04-17,0,1940,1940,4,17,USA
John Andrew,1967-05-15,21,1988,2009,5,15,USA
Homer Vernon,1878-03-23,4,1902,1906,3,23,USA
Henry Neitz,1890-04-25,0,1912,1912,4,25,USA
Frank John,1889-10-13,0,1916,1916,10,13,USA
Todd Andrew,1989-06-13,7,2012,2019,6,13,USA
Clarence Melvin,1921-05-24,0,1944,1944,5,24,USA
William Henry,1904-10-24,5,1929,1934,10,24,USA
James Daniel,1891-01-30,3,1915,1918,1,30,USA
Steven Delton,1978-06-03,0,2002,2002,6,3,USA
Ryan Delbert,1979-02-08,0,2004,2004,2,8,USA
Esix,1976-06-07,2,2002,2004,6,7,USA
Cy R.,1992-10-01,0,2019,2019,10,1,USA
Blake Ashton,1992-12-04,3,2016,2019,12,4,USA
Charles Anthony,1893-11-29,0,1912,1912,11,29,USA
Christopher Doyle,1981-12-03,6,2002,2008,12,3,USA
Ian Dante,1981-10-30,6,2004,2010,10,30,USA
Nathaniel,1952-09-02,3,1984,1987,9,2,USA
Walter Henry,1889-05-19,0,1913,1913,5,19,USA
Donald Marek,1992-05-29,0,2018,2018,5,29,USA
Edwin Donald,1926-09-19,17,1947,1964,9,19,USA
Travis James,1988-02-02,7,2008,2015,2,2,USA
Van Voorhees,1963-08-11,1,1988,1989,8,11,USA
Wyatt Eure,1896-10-28,0,1923,1923,10,28,USA
Brian Gerald,1955-10-17,NA,NA,NA,10,17,USA
Amzie Beal,1870-03-18,0,1901,1901,3,18,USA
Frederick Charles,1887-10-19,8,1908,1916,10,19,USA
Scott Andrew,1989-09-20,0,2014,2014,9,20,USA
Frank Walter,1949-03-28,0,1973,1973,3,28,USA
Christopher Charles,1970-09-20,3,1995,1998,9,20,USA
Colonel Lester,1895-05-16,0,1919,1919,5,16,USA
Charles M.,1849-08-03,0,1874,1874,8,3,USA
Jack Thomas,1968-02-26,16,1992,2008,2,26,USA
Bernard Austin,1913-08-25,0,1935,1935,8,25,USA
William Nicholas,1898-01-28,1,1919,1920,1,28,USA
Brian Robert,1958-02-20,4,1985,1989,2,20,USA
Bradley Michael,1982-05-25,4,2010,2014,5,25,USA
Brandon Roger,1986-11-23,8,2010,2018,11,23,USA
Charles F.,1873-02-06,0,1890,1890,2,6,USA
Christopher Ryan,1981-02-12,9,2004,2013,2,12,USA
Alfred Joseph,1890-08-20,0,1914,1914,8,20,USA
Abraham Conrad,1873-05-06,0,1898,1898,5,6,CAN
James Cory,1962-11-11,8,1986,1994,11,11,USA
Earl Clifford,1976-05-06,2,2002,2004,5,6,USA
Frank Elton,1894-05-27,15,1912,1927,5,27,USA
George T.,1848-09-28,0,1882,1882,9,28,USA
Gene Walter,1931-03-31,0,1959,1959,3,31,USA
John William,1886-10-06,0,1917,1917,10,6,USA
Gerald George,1929-07-21,6,1952,1958,7,21,USA
James C. A.,1847-09-15,0,1872,1872,9,15,USA
James Robert,1932-08-15,3,1961,1964,8,15,USA
John Michael,1974-08-16,2,1998,2000,8,16,USA
Kyle Ehren,1977-09-09,5,2003,2008,9,9,USA
Charles N.,1854-10-06,18,1873,1891,10,6,USA
Emanuel Sebastian,1854-12-12,8,1876,1884,12,12,USA
Russell Henry,1934-06-22,11,1959,1970,6,22,USA
Scott,1977-10-26,0,2001,2001,10,26,USA
Chad Nicholas,1993-07-10,1,2018,2019,7,10,USA
Louis Francis,1871-10-24,2,1897,1899,10,24,USA
Miguel Angel,1986-07-24,6,2012,2018,7,24,Venezuela
William,1914-09-18,0,1937,1937,9,18,USA
Eric Thane,1948-09-24,9,1971,1980,9,24,USA
Stephen Andrew,1972-04-03,0,1996,1996,4,3,USA
Clint Rea,1972-07-13,4,1995,1999,7,13,USA
Raymond John,1958-10-31,1,1986,1987,10,31,USA
Richard Michael,1956-12-16,2,1979,1981,12,16,USA
Eric Sidney,1986-05-22,9,2010,2019,5,22,USA
Luis Beltran,1965-01-03,13,1990,2003,1,3,Venezuela
Tolia,1947-01-15,11,1968,1979,1,15,American Samoa
Nicholas Blake,1995-01-11,0,2019,2019,1,11,USA
Donovan,1987-12-17,7,2012,2019,12,17,Colombia
Jhonatan,1985-08-12,3,2012,2015,8,12,Colombia
Julio Cesar,1960-01-08,6,1983,1989,1,8,D.R.
Yangervis Alfredo,1987-07-03,5,2014,2019,7,3,Venezuela
Alain,1979-10-09,0,2006,2006,10,9,Cuba
Jorge Carlos,1992-02-25,5,2014,2019,2,25,Cuba
Roman Ali,1987-09-29,2,2012,2014,9,29,Mexico
Marcelino,1930-07-19,0,1958,1958,7,19,Mexico
Samuel Robert,1988-08-10,3,2015,2018,8,10,USA
Eddie,1951-02-09,9,1973,1982,2,9,USA
Mose Hirsch,1900-12-08,0,1923,1923,12,8,USA
Julius Joseph,1906-03-22,9,1934,1943,3,22,USA
Edward G.,1853-03-01,1,1875,1876,3,1,USA
John Wesley,1882-10-26,1,1910,1911,10,26,USA
Andrew Henry,1876-02-06,0,1894,1894,2,6,USA
William Dunn,1923-02-17,0,1950,1950,2,17,USA
Joseph John,1858-11-20,10,1880,1890,11,20,USA
John Andrew,1865-10-26,3,1887,1890,10,26,USA
Rudolph,1886-10-30,15,1912,1927,10,30,USA
Layne R.,1989-06-05,0,2016,2016,6,5,USA
Donald C.,1899-01-31,3,1924,1927,1,31,USA
Andrew Michael,1983-03-18,4,2007,2011,3,18,USA
Lary Alan,1955-10-04,11,1977,1988,10,4,USA
Zach Hart,1977-01-03,2,2003,2005,1,3,USA
Alfonso Guilleard,1976-01-07,15,1999,2014,1,7,D.R.
Joakim Agustin,1984-05-18,12,2007,2019,5,18,Mexico
Rafael,1979-12-19,13,2002,2015,12,19,D.R.
Michael John Graydon,1997-08-04,1,2018,2019,8,4,CAN
Billy Lee,1940-10-14,5,1965,1970,10,14,USA
Raymond Edwin,1896-07-31,0,1922,1922,7,31,USA
Paul Anthony,1965-11-17,10,1989,1999,11,17,USA
Victor Garland,1901-04-09,9,1928,1937,4,9,USA
Edmundo,1996-03-06,1,2018,2019,3,6,Panama
Elias,1950-06-10,11,1972,1983,6,10,D.R.
Henry,1985-07-28,0,2011,2011,7,28,D.R.
Jose Ynocencio,1952-12-28,1,1975,1976,12,28,D.R.
Jorge Bolivar,1978-04-28,8,2002,2010,4,28,D.R.
Juan Luis,1975-08-19,2,1999,2001,8,19,D.R.
Samuel Peralta,1968-11-12,18,1989,2007,11,12,D.R.
Dennis Elwood,1904-01-20,5,1926,1931,1,20,USA
Allen Sutton,1893-04-27,12,1914,1926,4,27,USA
Geovany,1983-01-20,12,2005,2017,1,20,P.R.
Giovanni Luis,1991-05-18,0,2015,2015,5,18,P.R.
Gregory,1995-02-11,0,2019,2019,2,11,D.R.
Juan Jose,1998-10-25,1,2018,2019,10,25,D.R.
Mario Melvin,1956-07-12,11,1977,1988,7,12,D.R.
Neftali O.,1989-02-28,1,2013,2014,2,28,P.R.
Stephen,1919-03-03,9,1946,1955,3,3,USA
William Harold,1893-03-09,16,1913,1929,3,9,USA
William Frederick,1945-11-10,0,1964,1964,11,10,USA
Clyde Aubra,1886-11-03,0,1911,1911,11,3,USA
Kenneth Mark,1954-02-01,0,1980,1980,2,1,USA
Steven Jeffrey,1989-04-24,4,2014,2018,4,24,USA
William Jefferson,1864-11-29,2,1888,1890,11,29,USA
John,1866-12-10,3,1887,1890,12,10,USA
Leonard,1861-06-29,0,1886,1886,6,29,USA
Jeremy Bryan,1983-05-17,3,2006,2009,5,17,USA
Robert,1877-01-04,3,1907,1910,1,4,USA
Warren Edward,1921-04-23,23,1942,1965,4,23,USA
Albert Goodwill,1850-09-02,7,1871,1878,9,2,USA
Charles Harry,1893-10-13,1,1927,1928,10,13,USA
Keiunta Denard,1984-02-27,10,2008,2018,2,27,USA
Albert Donald,1933-07-08,12,1959,1971,7,8,USA
Cory Joseph,1991-03-16,5,2014,2019,3,16,USA
William Henry,1938-07-08,0,1964,1964,7,8,USA
Glenn Michael,1992-05-11,2,2017,2019,5,11,USA
James Jeffrey,1972-04-04,1,1999,2000,4,4,USA
Steven William,1965-07-02,9,1995,2004,7,2,USA
Stephen Lanier,1975-03-28,0,2000,2000,3,28,USA
Thomas Frank,1874-12-12,13,1897,1910,12,12,USA
Joseph Blase,1942-02-04,6,1964,1970,2,4,USA
Robert Charles,1930-08-22,4,1955,1959,8,22,USA
Tristram E.,1888-04-04,21,1907,1928,4,4,USA
Nathaniel Joseph,1985-05-03,1,2011,2012,5,3,USA
Robert Clifford,1956-08-08,0,1986,1986,8,8,USA
Byron Franklin,1897-01-06,6,1924,1930,1,6,USA
Horace Arthur,1951-10-04,4,1975,1979,10,4,USA
Floyd Vernie,1913-01-27,1,1943,1944,1,27,USA
George Nathan,1886-06-16,0,1909,1909,6,16,USA
Timothy Joseph,1966-07-02,8,1991,1999,7,2,USA
Chris Edward,1950-06-28,18,1971,1989,6,28,USA
Gabriel James,1995-04-12,0,2019,2019,4,12,USA
Justin James,1973-11-06,11,1998,2009,11,6,USA
Ryan Andrew,1979-07-24,4,2005,2009,7,24,USA
Jimmy Levale,1980-09-24,1,2007,2008,9,24,USA
Lloyd Benjamin,1890-05-15,0,1913,1913,5,15,USA
John Robert,1946-02-10,2,1969,1971,2,10,USA
Chester Arthur,1883-03-04,0,1906,1906,3,4,USA
Daryl Dean,1928-07-13,11,1952,1963,7,13,USA
George Elwell,1926-07-07,10,1950,1960,7,7,USA
Glenn Edward,1905-09-11,5,1928,1933,9,11,USA
Fred Calvin,1885-04-25,0,1912,1912,4,25,USA
Harrison Leslie,1853-02-22,NA,NA,NA,2,22,USA
James Lloyd,1947-07-30,14,1968,1982,7,30,USA
Joshua Patrick William,1988-01-22,1,2011,2012,1,22,Australia
Roy Hampton,1900-02-22,13,1925,1938,2,22,USA
Sean James,1975-05-29,1,1999,2000,5,29,USA
Michael Shane,1972-02-20,6,1998,2004,2,20,USA
Stanley Orville,1915-03-20,9,1940,1949,3,20,USA
Stanley Roger,1969-08-07,2,1998,2000,8,7,USA
Hubert Thomas,1951-02-28,0,1978,1978,2,28,USA
Edward Russell,1884-01-26,13,1905,1918,1,26,USA
Vernon Murray,1894-02-04,0,1920,1920,2,4,USA
Paul Bachman,1893-10-05,0,1920,1920,10,5,USA
Edwin George,1895-01-21,1,1924,1925,1,21,USA
Robert Walter,1949-10-10,3,1974,1977,10,10,USA
Stanley Kenneth,1914-02-19,2,1936,1938,2,19,USA
Robert Oberton,1925-04-11,1,1955,1956,4,11,USA
William James,1966-06-05,12,1989,2001,6,5,USA
Henry,1866-06-12,0,1895,1895,6,12,USA
Edward Wayne,1941-10-31,8,1964,1972,10,31,USA
Scott Edward,1972-09-21,11,1996,2007,9,21,USA
Leslie Charles,1951-01-23,8,1972,1980,1,23,USA
Ryan Adam,1979-09-05,6,2005,2011,9,5,USA
Daniel Ray,1951-11-27,11,1974,1985,11,27,USA
William Harry,1954-07-18,11,1978,1989,7,18,USA
Harold Stewart,1913-05-27,7,1939,1946,5,27,USA
Scipio Ronald,1947-07-12,4,1969,1973,7,12,USA
Ernest Lee,1975-01-28,4,2001,2005,1,28,USA
Paul William,1946-10-08,14,1970,1984,10,8,USA
Andrea Ettore,1908-10-18,0,1932,1932,10,18,USA
Alfred Ray,1902-12-03,7,1928,1935,12,3,USA
Paul Nikola,1970-09-24,6,1994,2000,9,24,CAN
Karl Gustave,1884-05-21,0,1908,1908,5,21,USA
Karl Benjamin,1931-06-23,1,1954,1955,6,23,USA
Timothy Floyd,1979-10-21,2,2001,2003,10,21,USA
James Russell,1909-04-10,0,1930,1930,4,10,USA
Jerry Carl,1967-06-14,7,1993,2000,6,14,USA
Charles Wellington,1864-10-10,3,1887,1890,10,10,USA
Edward Nelson,1945-09-16,8,1968,1976,9,16,USA
Edward Nelson,1967-07-25,10,1991,2001,7,25,USA
Homer Franklin,1920-11-09,0,1947,1947,11,9,USA
Henry Lee,1888-07-10,1,1911,1912,7,10,USA
George Herman,1937-05-22,5,1965,1970,5,22,USA
Bradford Louis,1904-05-09,1,1925,1926,5,9,USA
Dennis LeRoy,1965-02-12,7,1995,2002,2,12,USA
George Chelston,1989-09-19,5,2014,2019,9,19,USA
Jack Russell,1933-03-11,10,1955,1965,3,11,USA
Jeffrey Scott,1992-09-20,1,2018,2019,9,20,USA
Joseph Conrad,1902-08-03,3,1930,1933,8,3,USA
Russell Paul,1968-11-07,18,1992,2010,11,7,USA
Steven Michael,1961-02-11,2,1990,1992,2,11,USA
Robert Samuel,1941-12-05,0,1961,1961,12,5,USA
Charles William,1919-01-09,0,1945,1945,1,9,USA
Robert John,1956-04-14,3,1978,1981,4,14,USA
Ezekiel Stephen,1989-09-11,1,2013,2014,9,11,USA
Fred,1901-10-09,3,1924,1927,10,9,USA
Jay Aaron,1976-07-05,0,2000,2000,7,5,USA
Christopher Michael,1977-06-28,4,2003,2007,6,28,USA
Edward Frederick,1872-01-09,0,1891,1891,1,9,USA
Michael Lynn,1952-03-05,10,1975,1985,3,5,USA
George Charles,1957-10-29,0,1980,1980,10,29,USA
William Edward,1887-10-24,4,1910,1914,10,24,USA
Marvin Gustave,1942-03-13,7,1964,1971,3,13,USA
William Charles,1938-08-13,7,1960,1967,8,13,USA
James Joseph,1868-01-30,9,1890,1899,1,30,USA
Henry Alexander,1891-11-01,0,1916,1916,11,1,USA
John Henry,1870-04-08,0,1893,1893,4,8,USA
Stephen Robert,1951-05-06,1,1977,1978,5,6,USA
Charles Sylvester,1873-01-10,9,1897,1906,1,10,USA
Garland,1879-04-13,10,1903,1913,4,13,USA
Larry Floyd,1941-06-29,9,1964,1973,6,29,USA
Scott Edmund,1970-03-06,5,1993,1998,3,6,USA
Roy Joseph,1950-01-06,4,1975,1979,1,6,USA
George Tucker,1911-08-04,12,1934,1946,8,4,USA
Matthew Wade,1968-02-27,19,1992,2011,2,27,CAN
George Gaylord,1899-05-02,0,1925,1925,5,2,USA
Gerald Lee,1920-08-21,14,1947,1961,8,21,USA
Henry Eli,1866-11-03,7,1888,1895,11,3,USA
George Tweedy,1867-11-17,8,1890,1898,11,17,USA
George Walborn,1916-04-01,0,1943,1943,4,1,USA
Jacob Daniel,1989-12-22,3,2016,2019,12,22,USA
Evan Tracy,1937-08-31,6,1960,1966,8,31,USA
Thomas Virgil,1922-01-03,6,1947,1953,1,3,USA
Eric James,1991-09-25,0,2019,2019,9,25,USA
Craig N.,1984-03-09,10,2009,2019,3,9,USA
Oscar Harland,1883-03-17,19,1906,1925,3,17,USA
Charles,1916-01-09,5,1941,1946,1,9,USA
Jason Wayne,1978-11-09,6,2001,2007,11,9,USA
Jerome John,1901-11-02,4,1925,1929,11,2,USA
Alfred Peter,1892-04-25,4,1911,1915,4,25,USA
Albert Wilfred,1943-12-24,0,1963,1963,12,24,USA
Ryne Thomas,1991-07-26,2,2017,2019,7,26,USA
Jason John,1977-01-23,4,2003,2007,1,23,USA
Kevin Bruce,1955-12-19,0,1979,1979,12,19,USA
Daniel Adam,1985-12-22,3,2010,2013,12,22,USA
Albert Lee,1936-10-27,9,1961,1970,10,27,USA
Donald Joseph,1951-02-12,10,1972,1982,2,12,USA
Peter Louis,1963-04-18,1,1987,1988,4,18,USA
Robert Wayne,1972-03-10,3,1997,2000,3,10,USA
Stephen Blair,1961-06-19,2,1987,1989,6,19,USA
Andrew Neal,1964-08-10,6,1992,1998,8,10,USA
Edward Raymond,1915-09-03,10,1943,1953,9,3,USA
Joe Donald,1931-07-23,0,1959,1959,7,23,USA
Thomas Francis,1882-03-20,0,1904,1904,3,20,USA
Robert William,1954-11-10,12,1977,1989,11,10,USA
John Leonard,1889-11-13,0,1911,1911,11,13,USA
Cody Franklin,1988-12-21,0,2015,2015,12,21,USA
Frederick Blair,1947-08-13,13,1969,1982,8,13,USA
James Francis,1887-12-01,0,1914,1914,12,1,USA
Joseph Bernard,1881-04-02,12,1897,1909,4,2,USA
Mitchell Jack,1942-07-20,14,1964,1978,7,20,USA
Robert Michael,1963-06-25,14,1986,2000,6,25,USA
Craig Leo,1982-03-08,2,2007,2009,3,8,Saudi Arabia
John James,1885-12-06,0,1918,1918,12,6,USA
George Washington,1906-06-19,0,1931,1931,6,19,USA
Henry Edward,1869-09-22,0,1900,1900,9,22,USA
Leroy Bobby,1946-04-10,8,1970,1978,4,10,USA
Michael Thomas,1952-09-25,10,1975,1985,9,25,USA
William Michael,1967-06-02,18,1989,2007,6,2,USA
Giancarlo Cruz-Michael,1989-11-08,9,2010,2019,11,8,USA
Thomas Patrick,1874-10-25,0,1904,1904,10,25,USA
David Leslie,1954-01-16,6,1980,1986,1,16,USA
David Earl,1961-10-16,1,1987,1988,10,16,USA
Wilver Dornel,1940-03-06,20,1962,1982,3,6,USA
Conrad,1880-11-16,0,1906,1906,11,16,Russia
Dennis,1974-10-27,10,1999,2009,10,27,USA
Monroe Randolph,1885-01-19,3,1909,1912,1,19,USA
Matthew Scott,1965-01-21,3,1987,1990,1,21,USA
Derek,1992-08-03,0,2019,2019,8,3,USA
George Henry,1873-10-06,0,1902,1902,10,6,USA
William,1911-02-16,1,1935,1936,2,16,USA
Charles Watkin,1878-08-30,4,1905,1909,8,30,USA
Richard Eugene,1921-03-02,4,1947,1951,3,2,USA
Herman Paul,1936-11-20,2,1963,1965,11,20,USA
Raymond Francis,1906-04-23,13,1932,1945,4,23,USA
Joseph,1842-10-14,15,1871,1886,10,14,USA
Cody William,1994-06-04,0,2019,2019,6,4,USA
Brock James,1989-08-07,0,2017,2017,8,7,USA
Max Robert,1991-03-15,6,2013,2019,3,15,USA
David Alan,1968-04-12,1,1993,1994,4,12,USA
Joseph,1948-03-08,1,1972,1973,3,8,USA
Arnold John,1897-10-20,9,1919,1928,10,20,USA
Daniel Joseph,1944-04-01,22,1963,1985,4,1,USA
Charles Edward,1898-01-10,2,1923,1925,1,10,USA
Timothy James,1982-06-02,10,2005,2015,6,2,USA
Joshua Tyler,1993-12-21,0,2019,2019,12,21,USA
Nicholas Lee,1982-05-03,2,2008,2010,5,3,USA
Edward Joseph,1921-08-05,3,1951,1954,8,5,USA
Randy Anthony,1960-08-23,10,1984,1994,8,23,USA
William Eckloof,1853-03-20,4,1871,1875,3,20,USA
Daniel Eckford,1861-10-17,9,1880,1889,10,17,USA
John Hardin,1951-08-21,10,1974,1984,8,21,USA
Norman Thomas,1901-05-08,NA,NA,NA,5,8,USA
William Theodore,1869-10-20,0,1890,1890,10,20,USA
Gene Urban,1973-08-12,2,2000,2002,8,12,USA
Andrew Paul,1991-01-10,2,2017,2019,1,10,USA
John C.,1850-06-12,0,1879,1879,6,12,Czech Republic
William Mitchell,1886-10-05,4,1910,1914,10,5,USA
Robert Wesley,1894-03-29,3,1916,1919,3,29,CAN
Elmer Rae,1884-05-17,4,1907,1911,5,17,USA
Morris James,1875-06-29,3,1899,1902,6,29,USA
James Earl,1961-05-30,2,1987,1989,5,30,USA
William John,1887-11-11,3,1912,1915,11,11,USA
Kenneth Gregory,1970-10-13,0,1998,1998,10,13,USA
Milton Henry,1898-05-26,2,1924,1926,5,26,USA
Frederick Eugene,1872-08-16,0,1894,1894,8,16,USA
Morris Dale,1940-10-07,3,1962,1965,10,7,USA
John Robert,1959-09-22,4,1983,1987,9,22,USA
David William,1954-01-30,6,1978,1984,1,30,USA
Benjamin Saunders,1921-07-28,2,1945,1947,7,28,USA
William Robert,1907-02-07,0,1931,1931,2,7,USA
William Allen,1947-01-21,13,1972,1985,1,21,USA
William Blake,1973-08-03,4,1998,2002,8,3,USA
Edward F.,1869-09-05,8,1890,1898,9,5,USA
Eugene Gass,1892-11-17,0,1912,1912,11,17,USA
Harry M.,1875-09-29,13,1898,1911,9,29,USA
Henry John,1913-03-22,2,1937,1939,3,22,USA
Irvin Michael,1911-05-21,0,1932,1932,5,21,USA
Justin Marion,1911-08-09,0,1938,1938,8,9,USA
Raymond,1894-11-13,1,1923,1924,11,13,USA
William Randolph,1953-03-07,4,1978,1982,3,7,USA
James Harry,1915-01-07,0,1945,1945,1,7,USA
Terry Lee,1962-03-02,13,1986,1999,3,2,USA
Ricky Francis,1956-08-27,2,1982,1984,8,27,USA
William F.,1865-04-22,0,1885,1885,4,22,USA
William Jennings,1894-03-20,0,1916,1916,3,20,USA
Richard Francis,1948-10-08,3,1971,1974,10,8,USA
Jeffrey Alan,1958-03-02,0,1980,1980,3,2,USA
Frederick Boothe,1885-09-22,1,1908,1909,9,22,USA
Stephen Joseph,1977-05-20,1,2005,2006,5,20,USA
William,1865-05-06,3,1885,1888,5,6,USA
Charles Dillon,1890-07-30,13,1912,1925,7,30,USA
David Rotchford,1933-09-12,2,1962,1964,9,12,USA
Michael Steven,1958-05-29,4,1982,1986,5,29,USA
Renaldo Antonio,1951-04-05,10,1971,1981,4,5,Panama
Dernell Renauld,1978-06-17,0,2003,2003,6,17,USA
Jacob Charles,1867-06-24,9,1890,1899,6,24,USA
George Benjamin,1867-09-28,2,1892,1894,9,28,USA
Robert Lloyd,1928-08-11,0,1955,1955,8,11,USA
Bryan Maris,1920-07-14,1,1947,1948,7,14,USA
Louis Roberts,1944-07-13,0,1968,1968,7,13,USA
Clarence Wright,1863-08-19,5,1886,1891,8,19,USA
Reuben Crandol,1869-09-22,0,1892,1892,9,22,USA
Chester Earl,1947-07-31,7,1971,1978,7,31,USA
Garrett Charles,1972-01-02,7,1996,2003,1,2,USA
Glen Eugene,1933-01-20,12,1952,1964,1,20,USA
Jackson Tanner,1994-05-11,1,2017,2018,5,11,USA
Jerry Joseph,1943-10-06,7,1963,1970,10,6,USA
James Walter,1883-12-10,5,1907,1912,12,10,USA
Joseph Chester,1921-06-30,4,1943,1947,6,30,USA
John Herman,1941-04-13,9,1964,1973,4,13,USA
John M.,1979-11-15,0,2002,2002,11,15,Australia
Phillip Raymond,1960-09-19,3,1989,1992,9,19,USA
Carl Ray,1962-09-22,2,1990,1992,9,22,USA
Jackson Riggs,1898-01-05,13,1921,1934,1,5,USA
Robert William,1993-02-24,3,2016,2019,2,24,USA
Vernon Decatur,1920-10-23,14,1941,1955,10,23,USA
Walter McQueen,1911-03-27,2,1935,1937,3,27,USA
Randall Wayne,1951-04-21,0,1974,1974,4,21,USA
Adam James,1980-02-12,5,2005,2010,2,12,CAN
Charles Hurlbut,1889-10-01,1,1912,1913,10,1,USA
Mitchel Blake,1981-01-16,4,2007,2011,1,16,USA
Andrew Patrick,1994-06-01,2,2017,2019,6,1,USA
Robert Jordan,1907-04-17,0,1931,1931,4,17,USA
Charles Augustus,1918-07-10,7,1941,1948,7,10,USA
David James,1970-03-04,6,1994,2000,3,4,USA
Edward Lee,1925-01-12,5,1945,1950,1,12,USA
Jeffrey Allen,1983-09-05,2,2009,2011,9,5,USA
James Arthur,1889-08-25,0,1914,1914,8,25,USA
DeWain Lee,1967-07-10,12,1990,2002,7,10,USA
R C,1934-07-22,3,1958,1961,7,22,USA
Robert Edward,1855-01-01,0,1875,1875,1,1,USA
Todd Anthony,1971-11-15,1,1995,1996,11,15,USA
Asa,1869-02-14,0,1895,1895,2,14,USA
Andrew David,1970-12-05,0,1997,1997,12,5,CAN
William Wayne,1928-04-12,0,1955,1955,4,12,USA
Brock Allen,1991-10-03,3,2016,2019,10,3,USA
Edward Perry,1916-06-15,13,1941,1954,6,15,USA
Veston Goff,1931-01-07,4,1952,1956,1,7,USA
Christopher David,1982-02-19,12,2006,2018,2,19,USA
Christin Gaylin Harris,1993-12-10,1,2018,2019,12,10,USA
David Keith,1957-02-19,17,1978,1995,2,19,USA
Demetrius Jerome,1993-11-30,1,2018,2019,11,30,USA
Frank,1906-09-08,0,1927,1927,9,8,USA
Glen Weldon,1912-09-29,4,1940,1944,9,29,USA
Ian Kenneth,1985-04-05,7,2007,2014,4,5,USA
James Franklin,1939-06-11,10,1963,1973,6,11,USA
Joseph Lawrence,1879-03-11,0,1904,1904,3,11,USA
Joshua Craig,1978-12-05,1,2003,2004,12,5,USA
Kohl Robert,1994-10-07,1,2018,2019,10,7,USA
Walter Cleveland,1900-09-23,14,1921,1935,9,23,USA
Mark,1889-10-14,0,1913,1913,10,14,USA
William Macklin,1914-09-23,1,1944,1945,9,23,USA
Walter Nesbitt,1918-05-21,0,1940,1940,5,21,USA
Samuel Lee,1954-10-28,9,1978,1987,10,28,USA
Scott Edward,1975-08-14,3,2001,2004,8,14,USA
Shannon Harold,1974-02-25,13,1995,2008,2,25,USA
John Franklin,1894-01-31,13,1916,1929,1,31,USA
Charles Parnell,1890-11-16,1,1913,1914,11,16,USA
Zachary Robert,1986-09-28,1,2011,2012,9,28,USA
Phillip Wayne,1968-11-18,0,1994,1994,11,18,USA
David Andrew,1957-07-22,19,1979,1998,7,22,USA
Fred Warren,1901-06-01,2,1929,1931,6,1,USA
Richard Lewis,1936-01-24,6,1960,1966,1,24,USA
Rolland Mays,1906-11-17,3,1930,1933,11,17,USA
Kurt Andrew,1965-06-04,10,1986,1996,6,4,USA
Ronald Roy,1939-12-03,1,1961,1962,12,3,USA
Royle Eldon,1951-01-02,2,1975,1977,1,2,USA
Craig Steven,1954-11-18,1,1980,1981,11,18,USA
Archibald Ray,1873-05-30,2,1900,1902,5,30,USA
Carl Remus,1894-07-18,0,1923,1923,7,18,USA
Lee Elbert,1913-11-17,4,1934,1938,11,17,USA
Kelly Lee,1970-02-14,13,1994,2007,2,14,USA
Gorrell Robert,1945-10-11,11,1969,1980,10,11,USA
Joshua Randall,1988-03-14,3,2011,2014,3,14,USA
Garret C.,1849-10-13,0,1871,1871,10,13,USA
George Henry,1918-10-26,9,1943,1952,10,26,USA
Matthew Steven,1990-05-28,1,2014,2015,5,28,USA
John Elmer,1868-03-31,10,1889,1899,3,31,USA
Kenton Locke,1993-01-31,0,2019,2019,1,31,USA
Charles Klein,1929-07-02,14,1947,1961,7,2,USA
Kevin Douglas,1970-02-13,7,1993,2000,2,13,USA
Leonard Clark,1859-08-25,11,1879,1890,8,25,USA
Myreon Romel,1980-08-15,0,2007,2007,8,15,USA
Milton Joseph,1893-07-11,13,1913,1926,7,11,USA
Otis Hinkley,1871-08-07,3,1893,1896,8,7,USA
Phillip Matthew,1980-01-25,2,2006,2008,1,25,United Kingdom
Robert Anthony,1989-11-21,1,2018,2019,11,21,USA
Wesley Gay,1934-04-10,8,1959,1967,4,10,USA
Robert Lyle,1957-03-08,6,1981,1987,3,8,USA
Timothy Paul,1953-01-24,14,1975,1989,1,24,USA
Albert John,1900-01-01,1,1925,1926,1,1,USA
Arthur Milton,1896-09-13,0,1925,1925,9,13,USA
Brian Alexander,1979-09-07,4,2006,2010,9,7,USA
Edwin Arnold,1892-10-09,1,1923,1924,10,9,USA
William Hambly,1944-04-07,7,1967,1974,4,7,USA
Darragh Dean,1930-09-01,10,1953,1963,9,1,USA
Charles Richard,1911-12-05,0,1945,1945,12,5,USA
Dwight Ely,1886-08-02,1,1913,1914,8,2,USA
George Robert,1876-09-03,7,1903,1910,9,3,USA
George Heard,1946-07-09,8,1967,1975,7,9,USA
Eugene Daniel,1944-01-16,0,1969,1969,1,16,USA
Jeffrey Glen,1960-12-26,7,1983,1990,12,26,USA
John Thomas,1905-10-10,10,1928,1938,10,10,USA
John Andrew,1908-11-08,0,1933,1933,11,8,USA
Ulysses Simpson Grant,1899-02-28,9,1922,1931,2,28,USA
Ricky L.,1975-02-28,6,2001,2007,2,28,USA
John Vernon,1918-08-23,0,1943,1943,8,23,USA
Harry Ronald,1942-09-09,6,1966,1972,9,9,USA
Steven Michael,1947-07-14,10,1971,1981,7,14,USA
William Arthur,1901-09-18,0,1923,1923,9,18,USA
Tobi Neal,1984-12-03,1,2009,2010,12,3,Germany
James Wellington,1972-06-30,0,1998,1998,6,30,USA
Drew Patrick,1987-08-11,7,2010,2017,8,11,USA
Mickey Charles,1986-03-16,1,2012,2013,3,16,USA
Howard Edward,1911-05-15,1,1931,1932,5,15,USA
Alan Marshall,1884-09-27,3,1906,1909,9,27,USA
Lindo Ivan,1906-12-05,3,1930,1933,12,5,USA
Trevor John,1992-11-15,3,2016,2019,11,15,USA
Melvin Leon,1941-11-13,10,1964,1974,11,13,USA
Melvin Leon,1963-12-28,0,1990,1990,12,28,USA
Todd Vernon,1965-05-20,14,1988,2002,5,20,USA
Thomas Carl,1869-12-02,0,1898,1898,12,2,USA
Allyn McClelland,1904-10-31,12,1931,1943,10,31,USA
Eric Joseph,1993-03-27,0,2018,2018,3,27,USA
DaRond Tyrone,1973-01-03,0,1998,1998,1,3,USA
George Thomas,1877-11-23,11,1904,1915,11,23,USA
Jesse Cramer,1875-07-24,1,1903,1904,7,24,USA
Harry Duffield,1856-12-20,13,1880,1893,12,20,USA
Raymond Thomas,1915-06-06,0,1938,1938,6,6,USA
Christopher James,1974-08-18,0,1999,1999,8,18,USA
Harold Rudolph,1937-08-29,0,1960,1960,8,29,USA
Maxim Joseph,1980-04-17,0,2010,2010,4,17,CAN
Richard Bernard,1923-12-04,0,1954,1954,12,4,USA
Matthew Scott,1991-11-12,3,2016,2019,11,12,USA
Michael Wayne,1947-03-14,3,1970,1973,3,14,USA
Daniel Steven,1988-12-01,7,2012,2019,12,1,USA
Joseph Allan,1954-04-30,2,1979,1981,4,30,USA
Lester Paul,1959-10-10,1,1987,1988,10,10,Venezuela
Robert Edwin,1950-06-13,0,1972,1972,6,13,USA
Alan Cochrane,1906-11-07,8,1934,1942,11,7,USA
Joseph Douglas,1964-04-13,9,1989,1998,4,13,USA
John Lawrence,1885-12-05,0,1915,1915,12,5,USA
Paul Oscar Edward,1893-12-19,11,1913,1924,12,19,USA
Patrick Martin,1980-08-23,1,2002,2003,8,23,USA
Samuel Nicklin,1876-12-16,12,1896,1908,12,16,USA
Stephen James,1988-07-20,9,2010,2019,7,20,USA
Asa Evans,1853-02-10,0,1881,1881,2,10,USA
Christopher Lee,1990-08-22,3,2016,2019,8,22,USA
Monty Franklin Pierce,1912-05-21,4,1934,1938,5,21,USA
Chilton Scott,1869-10-02,7,1888,1895,10,2,USA
Joseph J.,1858-01-19,3,1880,1883,1,19,USA
Joseph,1858-11-16,2,1884,1886,11,16,USA
Ryan Lee,1988-03-04,0,2015,2015,3,4,USA
Darryl Eugene,1962-03-12,16,1983,1999,3,12,USA
Myles James Noble,1994-10-17,1,2018,2019,10,17,USA
Charles Evard,1882-09-30,27,1904,1931,9,30,USA
Huston Lowell,1983-08-02,12,2005,2017,8,2,USA
Oscar William,1873-07-07,3,1899,1902,7,7,USA
Edward Harold,1905-04-10,3,1928,1931,4,10,USA
Philip,1880-04-16,1,1909,1910,4,16,USA
Walter Herbert,1935-09-26,2,1954,1956,9,26,USA
William Goss,1908-03-29,0,1937,1937,3,29,USA
John A.,1859-06-08,11,1882,1893,6,8,USA
Elmer Griffin,1876-08-29,3,1904,1907,8,29,USA
George Bevan,1926-01-10,10,1950,1960,1,10,USA
Hunter Drew,1988-09-24,5,2014,2019,9,24,USA
James Michael,1946-06-12,4,1971,1975,6,12,USA
Charles Ernest,1858-09-15,0,1882,1882,9,15,USA
Scott Michael,1976-04-26,11,1999,2010,4,26,USA
George Andrew,1856-10-16,6,1879,1885,10,16,USA
Wilbur Scott,1933-10-23,1,1959,1960,10,23,USA
Louis Bernard,1917-05-13,9,1941,1950,5,13,USA
Nicholas,1915-03-01,8,1940,1948,3,1,USA
Joseph Valentine,1903-02-03,10,1928,1938,2,3,USA
Thomas Ross,1989-11-23,3,2016,2019,11,23,USA
Mark Arthur,1969-04-04,0,1998,1998,4,4,USA
Albert Irving,1884-06-11,1,1905,1906,6,11,USA
John Emery,1946-10-13,4,1970,1974,10,13,USA
Brent Terry,1948-10-14,5,1972,1977,10,14,USA
Floyd Marvin,1916-08-01,0,1939,1939,8,1,USA
Marcus Earl,1991-05-01,5,2014,2019,5,1,USA
Jamal Najar,1978-08-05,2,2003,2005,8,5,USA
James Melvin,1901-05-29,0,1929,1929,5,29,USA
Joseph Benjamin,1962-09-09,1,2000,2001,9,9,USA
Pedro Angel,1985-06-13,10,2009,2019,6,13,D.R.
Edwin Marvin,1939-10-31,5,1966,1971,10,31,USA
Ralph Vivian,1885-03-15,6,1910,1916,3,15,USA
Stephen Lewis,1952-03-15,0,1982,1982,3,15,USA
Amos Aaron,1889-01-22,16,1908,1924,1,22,USA
Clarence Herbert,1909-02-24,0,1934,1934,2,24,USA
Albert Frederick,1860-06-26,0,1884,1884,6,26,USA
Sterling Alpa,1895-07-29,2,1924,1926,7,29,USA
William Alexander,1873-08-28,4,1895,1899,8,28,USA
Richard Lee,1932-11-07,11,1958,1969,11,7,USA
John Davis,1901-04-27,3,1922,1925,4,27,USA
Luther Lane,1892-05-23,0,1921,1921,5,23,USA
Marlin Henry,1918-08-08,5,1949,1954,8,8,USA
Robert Andrew,1984-10-04,8,2009,2017,10,4,USA
Franklin Lee,1960-10-21,11,1984,1995,10,21,USA
Garrett Patrick,1993-05-26,0,2019,2019,5,26,USA
Lawrence George,1938-03-31,0,1967,1967,3,31,USA
George Anton,1899-03-02,4,1921,1925,3,2,USA
Paul Harrington,1927-03-22,3,1950,1953,3,22,USA
Everett James,1971-08-24,5,1997,2002,8,24,USA
Eric William,1979-12-09,9,2006,2015,12,9,USA
George Irvin,1873-06-30,0,1894,1894,6,30,USA
William Frederick,1892-03-21,1,1912,1913,3,21,USA
Daniel Arthur,1991-01-04,3,2016,2019,1,4,USA
George Frederick,1910-12-15,5,1931,1936,12,15,USA
James Gilbert,1932-02-10,2,1957,1959,2,10,USA
John Anton,1957-05-09,3,1982,1985,5,9,USA
Guy,1899-08-07,1,1927,1928,8,7,USA
Thomas Virgil,1930-04-28,9,1955,1964,4,28,USA
Tyler James,1985-12-20,0,2016,2016,12,20,USA
Robert Harwood,1919-08-06,8,1940,1948,8,6,USA
Dean Donnell,1892-12-01,0,1914,1914,12,1,USA
John Peter Joseph,1916-01-23,0,1941,1941,1,23,USA
Tanyon James,1970-10-12,13,1995,2008,10,12,USA
Michael Christopher,1986-09-04,2,2011,2013,9,4,USA
George Washington,1889-02-13,0,1926,1926,2,13,USA
James Marcellin,1871-06-06,0,1902,1902,6,6,USA
William Graves,1899-11-27,12,1919,1931,11,27,USA
Christopher Desmond,1973-01-19,9,1995,2004,1,19,USA
Cornelius William,1868-12-10,0,1890,1890,12,10,USA
Albert Joe,1989-10-08,1,2016,2017,10,8,Venezuela
Andrew Jose,1992-09-11,1,2018,2019,9,11,USA
Eugenio Alejandro,1991-07-18,5,2014,2019,7,18,Venezuela
Jose Rances,1998-01-03,0,2019,2019,1,3,Venezuela
Kenneth Raymond,1943-04-12,7,1966,1973,4,12,USA
Luis Abelardo,1916-08-24,0,1944,1944,8,24,Cuba
Ranger,1995-08-26,1,2018,2019,8,26,Venezuela
Richard Stanley,1944-10-15,0,1970,1970,10,15,USA
Charles Morris,1915-08-15,0,1938,1938,8,15,USA
James Joseph,1927-08-25,2,1950,1952,8,25,USA
Charles Anthony,1858-11-11,1,1883,1884,11,11,USA
Jesus Marcelo,1988-04-30,6,2013,2019,4,30,Venezuela
William Paul,1946-03-27,7,1968,1975,3,27,USA
Peter,1916-04-16,14,1941,1955,4,16,USA
John William,1874-09-17,9,1897,1906,9,17,USA
Wander,1991-09-15,1,2018,2019,9,15,D.R.
Williams,1966-11-07,1,1992,1993,11,7,D.R.
Joseph,1870-07-31,19,1893,1912,7,31,USA
George Franklin,1882-07-07,7,1908,1915,7,7,USA
August Richard,1906-01-03,10,1930,1940,1,3,USA
Clyde Leroy,1901-11-30,19,1926,1945,11,30,USA
Edward Anthony,1943-03-03,2,1964,1966,3,3,USA
Guy Patrick,1955-11-07,3,1980,1983,11,7,USA
Ernest Richard,1910-07-07,0,1936,1936,7,7,USA
Andrew Raymond,1884-08-30,0,1904,1904,8,30,USA
William,1853-07-04,0,1878,1878,7,4,Ireland
William Joseph,1875-02-01,17,1899,1916,2,1,USA
William Joseph,1910-10-23,16,1931,1947,10,23,USA
John Frank,1856-01-12,3,1877,1880,1,12,USA
Charles Edward,1903-05-23,3,1928,1931,5,23,USA
Cory,1979-08-20,5,2005,2010,8,20,USA
Daniel C.,1857-05-09,4,1882,1886,5,9,USA
Dennis J.,1858-06-26,1,1879,1880,6,26,USA
Dennis William,1882-09-28,4,1905,1909,9,28,USA
Franklin Leal,1930-01-23,10,1953,1963,1,23,USA
Harry Andrew,1888-04-12,0,1909,1909,4,12,USA
Haywood Cooper,1930-12-15,8,1955,1963,12,15,USA
Carl Mancel,1918-02-22,0,1944,1944,2,22,USA
Daniel James,1867-04-25,7,1891,1898,4,25,USA
James Richard,1894-04-05,2,1921,1923,4,5,USA
Joseph Daniel,1870-01-06,3,1893,1896,1,6,USA
John Eugene,1873-02-16,3,1905,1908,2,16,USA
John Jeremiah,1894-05-31,0,1919,1919,5,31,USA
John Lawrence,1890-03-21,1,1920,1921,3,21,USA
Joe,1910-09-26,6,1935,1941,9,26,USA
John Paul,1920-11-02,7,1942,1949,11,2,USA
John Peter,1941-01-03,5,1963,1968,1,3,USA
Paul Thomas,1916-09-07,0,1939,1939,9,7,USA
Martin C.,1862-10-20,4,1887,1891,10,20,USA
Marc Cooper,1958-07-25,5,1982,1987,7,25,USA
Michael Joseph,1860-03-10,0,1888,1888,3,10,USA
Michael Joseph,1866-10-23,10,1889,1899,10,23,USA
Patrick B.,1861-08-18,0,1884,1884,8,18,USA
Patrick Joseph,1854-03-24,NA,NA,NA,3,24,USA
Russell Guy,1923-02-19,2,1951,1953,2,19,USA
William Scott,1971-03-13,9,1995,2004,3,13,USA
Suter Grant,1872-10-14,1,1898,1899,10,14,USA
Thomas,1860-03-01,5,1884,1889,3,1,USA
Thomas Augustin,1895-10-18,0,1922,1922,10,18,USA
Thomas Brandon,1906-12-19,0,1925,1925,12,19,USA
William F.,1864-03-12,NA,NA,NA,3,12,USA
Cole Young,1990-03-12,0,2019,2019,3,12,USA
Homer Wayne,1898-11-03,10,1920,1930,11,3,USA
John Junior,1946-06-15,10,1974,1984,6,15,USA
Oren Edgar,1884-12-05,4,1908,1912,12,5,USA
Carl Ringdahl,1908-09-28,0,1928,1928,9,28,USA
Arthur J.,1862-01-21,0,1890,1890,1,21,USA
William Ashley,1862-11-19,7,1883,1890,11,19,USA
James Howard,1951-05-18,15,1974,1989,5,18,USA
Gordon Vincent,1937-10-10,0,1956,1956,10,10,USA
Steven Richard,1910-03-27,10,1936,1946,3,27,USA
Thomas Jacob,1912-08-09,7,1937,1944,8,9,USA
Jeffrey Scot,1975-01-02,17,1995,2012,1,2,USA
William James,1964-08-04,18,1987,2005,8,4,USA
Richard Clifford,1962-10-03,0,1985,1985,10,3,USA
Eric Michael,1987-07-16,5,2011,2016,7,16,USA
Matthew Constantine,1922-06-16,8,1949,1957,6,16,USA
Andrew John,1990-03-22,4,2014,2018,3,22,USA
George Cyril Methodius,1907-08-13,15,1929,1944,8,13,USA
George Daniel,1930-09-13,4,1955,1959,9,13,USA
Stephen James,1986-03-28,0,2013,2013,3,28,USA
Peter John,1904-07-02,0,1934,1934,7,2,USA
Charles Inigo,1915-07-22,0,1938,1938,7,22,USA
Richard Lee,1956-06-21,18,1976,1994,6,21,USA
Elmer Ellsworth,1862-04-15,8,1884,1892,4,15,USA
Brent Michael,1989-08-29,3,2016,2019,8,29,USA
Harry Richard,1887-09-15,0,1909,1909,9,15,USA
Darrell Wayne,1941-11-14,4,1964,1968,11,14,USA
Howard Alvin,1922-04-09,0,1949,1949,4,9,USA
Gary Lynn,1944-09-27,12,1966,1978,9,27,USA
Leonardo,1958-04-06,1,1980,1981,4,6,Cuba
Harvey Scott,1894-02-20,0,1921,1921,2,20,USA
Glenn Edward,1968-05-09,1,1990,1991,5,9,USA
Howard Bruce,1953-01-08,12,1976,1988,1,8,USA
John Gerhard,1873-06-29,7,1898,1905,6,29,USA
George,1901-03-31,NA,NA,NA,3,31,USA
Donald Howard,1945-04-02,22,1966,1988,4,2,USA
Stephen Drew,1983-06-30,3,2009,2012,6,30,USA
Ezra Ballou,1849-09-17,17,1871,1888,9,17,USA
Johnny Ike,1952-11-13,1,1977,1978,11,13,USA
Larry James,1970-05-14,7,1997,2004,5,14,USA
Ichiro,1973-10-22,18,2001,2019,10,22,Japan
Kurt Kiyoshi,1983-10-04,12,2007,2019,10,4,USA
Makoto,1975-05-31,6,1996,2002,5,31,Japan
Dale Curtis,1963-11-23,13,1986,1999,11,23,USA
William,1867-08-01,0,1887,1887,8,1,USA
Harry Joseph,1881-08-22,8,1907,1915,8,22,USA
William David,1956-12-05,3,1983,1986,12,5,USA
John Hillary,1874-03-11,1,1897,1898,3,11,USA
Craig Steven,1950-11-30,11,1973,1984,11,30,USA
Edward Ottis,1880-07-04,1,1903,1904,7,4,USA
Harry Gordon,1887-08-11,0,1914,1914,8,11,USA
Pedro Maurice,1970-10-27,3,2000,2003,10,27,USA
Russell Howard,1964-01-03,5,1989,1994,1,3,USA
William Andrew,1888-10-12,0,1914,1914,10,12,USA
James Dansby,1994-02-11,3,2016,2019,2,11,USA
Erik,1993-09-04,0,2019,2019,9,4,USA
Ernest Evar,1902-10-15,5,1929,1934,10,15,USA
Karl Edward,1900-12-17,1,1928,1929,12,17,USA
Arthur Leonard,1936-10-15,2,1955,1957,10,15,USA
Stanley Lawrence,1944-05-19,0,1971,1971,5,19,USA
Sherwin Merle,1929-06-13,0,1947,1947,6,13,USA
David Theodore,1968-02-11,2,1995,1997,2,11,USA
Cyrus Edward,1859-01-12,11,1881,1892,1,12,USA
Vernon Monroe,1897-01-01,0,1920,1920,1,1,USA
Park B.,1865-11-21,0,1889,1889,11,21,USA
Anthony Ray,1985-09-10,10,2009,2019,9,10,USA
Charles James,1847-11-02,7,1871,1878,11,2,USA
William John,1886-03-06,7,1907,1914,3,6,USA
William Joseph,1904-12-29,3,1928,1931,12,29,USA
Brian Edward,1974-06-13,7,2003,2010,6,13,USA
Charles Francis,1890-04-15,0,1914,1914,4,15,USA
Charles Joseph,1863-04-13,5,1882,1887,4,13,USA
Daniel J.,1868-01-28,0,1895,1895,1,28,USA
Darnell Thomas,1991-02-01,3,2015,2018,2,1,USA
Edward Francis,1888-07-19,11,1908,1919,7,19,USA
Harry Leon,1915-12-28,0,1944,1944,12,28,USA
Jeremiah James,1857-09-04,0,1884,1884,9,4,USA
Mark Patrick,1969-10-26,13,1995,2008,10,26,USA
Michael John,1973-07-22,15,1995,2010,7,22,USA
Peter John,1863-12-31,2,1888,1890,12,31,USA
John J.,1858-11-01,2,1883,1885,11,1,USA
Ryan Joseph,1985-02-20,8,2006,2014,2,20,USA
Lester Leo,1901-08-15,4,1927,1931,8,15,USA
Ricky Joe,1952-09-07,5,1978,1983,9,7,USA
August William,1899-11-21,0,1922,1922,11,21,USA
Stephen Albert,1903-08-13,6,1929,1935,8,13,USA
William Edward,1870-04-16,0,1890,1890,4,16,USA
William Vincent,1908-06-19,11,1932,1943,6,19,USA
William Charles,1961-10-27,13,1985,1998,10,27,USA
Robert Virgil,1915-03-06,13,1940,1953,3,6,USA
Oadis Vaughn,1915-02-13,1,1939,1940,2,13,USA
Adam William,1895-09-21,0,1917,1917,9,21,USA
Blake Aubry,1992-04-03,4,2015,2019,4,3,USA
Charles Jay,1878-10-26,0,1904,1904,10,26,USA
Forest Gregory,1965-01-02,16,1986,2002,1,2,USA
Joshua Ernest,1885-07-05,2,1911,1913,7,5,USA
Robert Joseph,1983-07-07,1,2008,2009,7,7,CAN
Paul Christopher,1966-12-21,0,1993,1993,12,21,USA
Nicholas Thomas,1980-11-25,11,2004,2015,11,25,USA
Steven Eugene,1951-08-09,8,1974,1982,8,9,USA
Jon Michael,1979-08-13,6,2003,2009,8,13,USA
Ronald Alan,1944-06-30,8,1965,1973,6,30,USA
Leonard Brodbeck,1878-10-06,5,1901,1906,10,6,USA
Robert Joseph,1954-12-11,4,1977,1981,12,11,USA
Louis J.,1855-02-14,3,1884,1887,2,14,USA
Noah Seth,1992-08-29,4,2015,2019,8,29,USA
Matthew,1989-07-20,4,2014,2018,7,20,USA
Joseph,1925-02-02,0,1953,1953,2,2,USA
Kenneth John,1947-02-25,0,1970,1970,2,25,USA
Jason Ernest,1978-12-11,0,2004,2004,12,11,USA
Jeffrey Jon,1964-01-17,7,1994,2001,1,17,USA
Jose Nicolas,1988-08-12,5,2010,2015,8,12,Venezuela
Jerry Lynn,1952-03-17,2,1976,1978,3,17,USA
John Pardon,1868-06-28,0,1890,1890,6,28,USA
Edward Timothy,1900-01-11,1,1926,1927,1,11,USA
Patrick Sean,1958-02-02,11,1981,1992,2,2,USA
Gregory Steven,1961-05-21,0,1987,1987,5,21,USA
James Reubin,1916-11-05,9,1938,1947,11,5,USA
Jeffrey Wilson,1965-12-01,3,1991,1994,12,1,USA
Kazuhito,1980-04-25,1,2004,2005,4,25,Japan
John Gallatin,1890-06-03,0,1913,1913,6,3,USA
So,1969-07-02,7,2002,2009,7,2,Japan
Travis Nathaniel,1989-01-20,0,2017,2017,1,20,USA
Jameson Lee,1991-11-18,3,2016,2019,11,18,USA
Douglas John,1902-08-03,4,1928,1932,8,3,USA
Hisanori,1975-04-02,3,2010,2013,4,2,Japan
Ken,1969-04-16,0,2009,2009,4,16,Japan
Shingo,1968-11-25,1,2004,2005,11,25,Japan
Robert Dale,1928-06-06,1,1953,1954,6,6,USA
Frederick Lealand,1941-06-28,7,1963,1970,6,28,USA
Mitchell R.,1983-10-17,3,2008,2011,10,17,USA
Leroy Everett,1920-01-16,0,1943,1943,1,16,USA
Brian Curtis,1977-09-21,9,2002,2011,9,21,USA
Marion Lee,1939-01-14,1,1966,1967,1,14,USA
John Felix,1951-11-07,4,1976,1980,11,7,USA
Jeffrey Eugene,1970-08-19,5,1998,2003,8,19,USA
Vitautris Casimirus,1911-07-11,7,1934,1941,7,11,USA
Kensuke,1981-05-20,0,2013,2013,5,20,Japan
Masahiro,1988-11-01,5,2014,2019,11,1,Japan
Frank Daryl,1953-07-03,20,1973,1993,7,3,USA
Dennis Lee,1979-02-24,2,2002,2004,2,24,USA
Lawrence William,1901-06-08,0,1925,1925,6,8,USA
Taylor Mark,1983-03-07,4,2006,2010,3,7,USA
Bruce Matthew,1961-12-09,0,1985,1985,12,9,USA
Charles William,1928-07-04,7,1955,1962,7,4,USA
Jesse Niles,1874-07-14,17,1894,1911,7,14,USA
Lee Ford,1880-10-26,9,1903,1912,10,26,USA
Kevin Ray,1964-02-18,12,1989,2001,2,18,USA
Raimel Antonio,1994-02-04,3,2016,2019,2,4,D.R.
Walter Van Dorn,1890-10-08,0,1914,1914,10,8,USA
Elvin Walter,1927-05-21,8,1954,1962,5,21,USA
Theodore Nash,1931-02-02,5,1950,1955,2,2,USA
Anthony Giacinto,1970-12-09,9,1993,2002,12,9,USA
Wilbur Arlington,1904-09-10,1,1927,1928,9,10,USA
Stephen Nicholas,1993-02-17,1,2018,2019,2,17,USA
Danilo,1962-10-30,13,1984,1997,10,30,P.R.
Jose Milages,1938-11-27,8,1962,1970,11,27,Cuba
Travis Scott,1987-12-17,0,2015,2015,12,17,USA
La Schelle,1959-01-30,0,1986,1986,1,30,USA
Willie,1933-01-08,5,1958,1963,1,8,USA
Jack Gerard,1978-04-21,5,2005,2010,4,21,USA
Jordan Arthur,1981-09-20,1,2006,2007,9,20,USA
Walter Alvin,1918-07-01,0,1946,1946,7,1,USA
Henry Bennett,1901-12-03,10,1924,1934,12,3,USA
Dillon Michael,1994-05-01,0,2019,2019,5,1,USA
Hugh Henry,1880-05-19,0,1905,1905,5,19,USA
Lee Willie,1932-03-18,1,1958,1959,3,18,USA
Edward Christopher,1860-12-22,5,1885,1890,12,22,USA
Randall Lee,1952-10-23,0,1975,1975,10,23,USA
Stuart Douglas,1962-06-17,0,1989,1989,6,17,USA
Yoshinori,1975-12-26,1,2011,2012,12,26,Japan
Fernando,1975-01-01,13,1997,2010,1,1,D.R.
Fernando Gabriel,1999-01-02,0,2019,2019,1,2,D.R.
Ramon Francisco,1973-01-05,1,1997,1998,1,5,D.R.
Craig B.,1983-03-18,2,2009,2011,3,18,USA
Jarvis,1946-10-11,2,1968,1970,10,11,USA
James Ray,1967-10-09,6,1992,1998,10,9,USA
Kenneth Ray,1944-04-25,5,1969,1974,4,25,USA
V T,1919-07-16,6,1941,1947,7,16,USA
Edward Kenneth,1968-10-31,10,1991,2001,10,31,USA
Ty Andrew,1982-11-17,2,2006,2008,11,17,USA
Fred Joseph,1906-03-27,2,1935,1937,3,27,USA
Michael Robert,1990-12-03,2,2017,2019,12,3,USA
Walter Edward,1901-11-22,3,1928,1931,11,22,USA
Donald Franklin,1932-02-19,4,1958,1962,2,19,USA
Jesus Rafael,1971-03-26,4,1994,1998,3,26,D.R.
Julian,1973-05-22,16,1993,2009,5,22,D.R.
John Adam,1897-12-27,8,1921,1929,12,27,USA
Alejandro Antonio,1955-10-09,7,1976,1983,10,9,D.R.
Franklin Crisostomo,1949-12-24,11,1971,1982,12,24,D.R.
Oscar Francisco,1992-06-19,0,2014,2014,6,19,D.R.
Willy,1981-12-25,6,2004,2010,12,25,D.R.
Aaron Wade,1977-08-20,2,2002,2004,8,20,USA
Andrew Raymond,1986-08-18,0,2012,2012,8,18,USA
Arlas Walter,1896-03-16,0,1921,1921,3,16,USA
Benjamin Harrison,1889-04-02,0,1912,1912,4,2,USA
Benjamin Eugene,1927-09-30,4,1951,1955,9,30,USA
Benjamin Alan,1992-11-12,1,2017,2018,11,12,USA
Beau Ritchie,1990-02-13,1,2018,2019,2,13,USA
Benjamin Harrison,1888-07-01,NA,NA,NA,7,1,USA
William Michael,1929-12-30,4,1954,1958,12,30,USA
William Howell,1961-10-16,7,1994,2001,10,16,USA
Robert Lee,1944-03-20,0,1970,1970,3,20,USA
Bruce Bell,1953-04-16,2,1977,1979,4,16,USA
Carl Means,1944-01-20,5,1968,1973,1,20,USA
C L,1898-02-09,0,1925,1925,2,9,USA
Charles Gilbert,1942-04-18,7,1969,1976,4,18,USA
Christopher Armand,1990-08-29,5,2014,2019,8,29,USA
Daniel Turney,1900-12-23,10,1926,1936,12,23,USA
Donald Clyde,1958-08-11,3,1987,1990,8,11,USA
Luther Haden,1875-02-21,8,1900,1908,2,21,USA
Dwight Bernard,1960-03-24,0,1986,1986,3,24,USA
Edgar Ruben,1877-03-23,0,1903,1903,3,23,USA
Edward James,1901-11-17,0,1926,1926,11,17,USA
Frederick Rankin,1924-12-03,2,1950,1952,12,3,USA
Gary William,1945-10-19,0,1969,1969,10,19,USA
George J.,1852-11-22,NA,NA,NA,11,22,USA
Graham Michael,1984-05-25,0,2009,2009,5,25,USA
Harry Leonard,1866-04-04,3,1890,1893,4,4,USA
Harry Warren,1907-12-26,0,1932,1932,12,26,USA
James Harry,1919-05-20,6,1946,1952,5,20,USA
Robert Dale,1939-04-03,13,1957,1970,4,3,USA
Harry Evans,1935-12-02,0,1957,1957,12,2,USA
John Besson,1873-05-23,8,1891,1899,5,23,USA
John William,1873-12-13,9,1898,1907,12,13,USA
Joe Cephus,1926-03-02,5,1954,1959,3,2,USA
Josh Earl,1993-03-02,0,2019,2019,3,2,USA
Kerry Thomas,1971-01-25,1,1993,1994,1,25,USA
Leo Thomas,1901-05-13,0,1923,1923,5,13,USA
George Edward,1851-02-03,7,1877,1884,2,3,USA
Michael David,1985-12-19,3,2011,2014,12,19,USA
Michael Anthony,1991-03-26,5,2014,2019,3,26,USA
Vernon Charles,1927-11-26,0,1952,1952,11,26,USA
Reginald Tremain,1977-01-12,5,2000,2005,1,12,USA
Ronald Wesley,1937-12-13,10,1962,1972,12,13,CAN
Samuel Douglas,1933-02-27,5,1958,1963,2,27,USA
Rodney Scott,1967-08-02,1,1992,1993,8,2,USA
Scott Michael,1966-10-03,0,1995,1995,10,3,USA
Terry Derrell,1964-07-28,0,1988,1988,7,28,USA
Thomas Livingstone Carlton,1892-09-17,0,1924,1924,9,17,USA
Antonio Nemesio,1935-12-19,18,1958,1976,12,19,Cuba
Tyrone A.,1994-01-22,0,2019,2019,1,22,USA
Wade Eric,1965-10-19,0,1991,1991,10,19,USA
Philip Wiley,1888-03-18,3,1911,1914,3,18,USA
Zachary Hamner,1850-02-21,0,1874,1874,2,21,USA
James Wren,1898-07-27,15,1920,1935,7,27,USA
Junichi,1986-06-06,9,2009,2018,6,6,Japan
Arthur John,1904-02-27,2,1930,1932,2,27,USA
Everett James,1984-05-15,4,2011,2015,5,15,USA
Taylor Hill,1983-12-21,7,2008,2015,12,21,USA
Mark Thomas,1981-09-06,6,2005,2011,9,6,USA
George Robert,1912-11-10,16,1936,1952,11,10,USA
George,1861-12-26,8,1887,1895,12,26,USA
Oliver Wendell,1864-12-05,13,1887,1900,12,5,USA
Charles Alston,1870-02-22,0,1895,1895,2,22,USA
Allen Seymour,1891-12-14,0,1914,1914,12,14,USA
Richard Leroy,1926-03-08,0,1953,1953,3,8,USA
Julio Alberto,1991-01-27,8,2011,2019,1,27,Colombia
Mark Charles,1980-04-11,13,2003,2016,4,11,USA
Miguel Odalis,1974-05-25,16,1997,2013,5,25,D.R.
Ruben Dario,1989-10-27,9,2010,2019,10,27,Panama
Wilfredo Aristides,1962-11-12,2,1986,1988,11,12,D.R.
Robinson Garcia,1982-03-24,6,2005,2011,3,24,D.R.
Michael,1976-10-18,6,1999,2005,10,18,Cuba
Blake Aaron,1987-05-24,2,2011,2013,5,24,USA
Kenton Charles,1947-03-05,15,1974,1989,3,5,USA
Amaury,1974-01-19,9,1996,2005,1,19,D.R.
Anthony Charles,1966-03-06,12,1990,2002,3,6,USA
David William,1966-11-11,5,1993,1998,11,11,USA
Tomas,1991-06-18,4,2014,2018,6,18,Venezuela
Ryan John,1995-03-16,1,2018,2019,3,16,USA
Thomas John,1954-03-29,6,1979,1985,3,29,USA
Charles Sherman,1932-06-01,1,1955,1956,6,1,USA
Garry Lewis,1956-03-24,15,1976,1991,3,24,USA
John Ellis,1927-08-08,12,1952,1964,8,8,USA
Fury Gene,1946-10-10,14,1969,1983,10,10,USA
John Kinley,1863-07-25,5,1885,1890,7,25,Ireland
James McDonnell,1907-03-03,0,1929,1929,3,3,USA
Thomas Francis,1882-07-03,0,1912,1912,7,3,USA
Fred Clay,1859-07-09,0,1884,1884,7,9,USA
Frederick,1871-11-26,17,1894,1911,11,26,USA
Frank Ronald,1947-11-23,8,1967,1975,11,23,USA
Dennis Ryan,1987-11-03,4,2015,2019,11,3,USA
Nicholas James,1988-10-12,4,2013,2017,10,12,USA
Joseph John,1923-09-18,0,1946,1946,9,18,USA
Joseph Thomas,1988-09-09,2,2013,2015,9,9,USA
Robert Joseph,1945-02-14,0,1972,1972,2,14,USA
Gregory John,1952-03-20,0,1975,1975,3,20,USA
Jeffrey Michael,1950-10-16,3,1974,1977,10,16,USA
Jerry Wayne,1946-07-13,7,1973,1980,7,13,USA
Luis Enrique,1980-05-18,4,2003,2007,5,18,D.R.
John Thomas,1867-06-29,0,1886,1886,6,29,USA
Charles Walter,1958-05-11,10,1982,1992,5,11,USA
Walter W.,1850-04-07,0,1875,1875,4,7,USA
William H.,1864-08-07,13,1884,1897,8,7,USA
William Harold,1898-10-30,13,1923,1936,10,30,USA
John Baxter,1877-09-04,1,1902,1903,9,4,USA
Ralph Willard,1936-01-09,11,1956,1967,1,9,USA
Scott Ray,1959-11-21,5,1986,1991,11,21,USA
Lancelot,1911-02-11,5,1940,1945,2,11,USA
Zebulon Alexander,1891-06-17,6,1916,1922,6,17,USA
Richard Martin,1906-06-27,0,1932,1932,6,27,USA
Willard Wayne,1925-06-27,11,1949,1960,6,27,USA
Albert John,1891-01-27,0,1915,1915,1,27,USA
Charles Monroe,1888-03-05,6,1912,1918,3,5,USA
Jay Weldon,1971-12-26,4,1998,2002,12,26,USA
Nicholas,1928-06-29,0,1958,1958,6,29,USA
Richard Morley,1929-06-26,2,1955,1957,6,26,USA
Mickey Lee,1960-09-16,13,1984,1997,9,16,USA
Timothy Shawn,1958-07-07,10,1983,1993,7,7,USA
Nathan Mark,1976-03-11,0,2002,2002,3,11,USA
Robert Alan,1960-11-30,12,1986,1998,11,30,USA
Kanekoa Jacob,1986-02-06,1,2010,2011,2,6,USA
George Bernhardt,1886-12-27,1,1914,1915,12,27,USA
Morris Benton,1934-05-21,5,1958,1963,5,21,USA
Matthew Kevin,1995-05-06,0,2019,2019,5,6,USA
Albert,1849-09-21,0,1872,1872,9,21,United Kingdom
Eric Allyn,1986-11-10,8,2011,2019,11,10,USA
Marcus Markley,1977-03-06,9,2002,2011,3,6,USA
Ulysses Grant,1877-02-23,1,1903,1904,2,23,USA
Joseph,1981-10-04,8,2007,2015,10,4,USA
Dale Scott,1980-12-17,6,2009,2015,12,17,USA
Gregory Allen,1949-10-23,0,1978,1978,10,23,USA
Duane Charles,1953-11-20,1,1977,1978,11,20,USA
John Louis,1891-07-23,0,1920,1920,7,23,USA
Ronald Merrill,1943-07-28,1,1971,1972,7,28,USA
George Basil,1946-11-13,1,1973,1974,11,13,USA
Ryan Stewart,1979-12-07,7,2005,2012,12,7,USA
Jesen,1993-03-18,0,2017,2017,3,18,CAN
Arnold Joseph,1914-04-27,0,1944,1944,4,27,USA
Thomas Joseph,1903-09-06,14,1924,1938,9,6,USA
Maynard Bert,1926-05-04,0,1952,1952,5,4,USA
Caleb John,1987-01-31,2,2013,2015,1,31,USA
Henry Joseph,1880-10-03,1,1902,1903,10,3,USA
John Peter,1879-05-20,3,1905,1908,5,20,USA
David Robert,1937-03-21,0,1963,1963,3,21,USA
Vernon Arthur,1926-04-01,1,1954,1955,4,1,USA
Robert Thomas,1963-07-17,8,1986,1994,7,17,USA
Curtis Barnard,1983-04-19,1,2007,2008,4,19,USA
John Joseph,1970-11-19,0,1995,1995,11,19,USA
Thomas Neal,1969-09-03,1,1995,1996,9,3,USA
Richard Crispin,1944-01-09,0,1967,1967,1,9,USA
Joshua Michael,1986-10-28,7,2009,2016,10,28,USA
Andres Perez,1963-11-10,5,1985,1990,11,10,D.R.
Arthur Wilson,1889-02-12,0,1910,1910,2,12,USA
William Miskey,1877-12-08,0,1902,1902,12,8,USA
Bradley Richard,1977-10-22,10,2001,2011,10,22,Australia
Luther Baxter,1910-09-09,9,1932,1941,9,9,USA
John Tillman,1929-03-10,0,1951,1951,3,10,USA
Carl Leslie,1932-05-28,0,1960,1960,5,28,USA
Charles Wesley,1978-12-26,1,2004,2005,12,26,USA
Claude Alfred,1890-05-15,0,1916,1916,5,15,USA
Michael Clete,1983-11-14,5,2008,2013,11,14,USA
Danny Lee,1951-05-09,1,1976,1977,5,9,USA
Derrel Osborn,1951-01-14,14,1971,1985,1,14,USA
Melvin Erskine,1948-08-13,0,1974,1974,8,13,USA
Fay Wesley,1903-10-10,8,1927,1935,10,10,USA
Forrest,1881-05-23,0,1905,1905,5,23,USA
Frederick Harvey,1892-12-19,2,1918,1920,12,19,USA
Frank Joseph,1929-06-11,15,1951,1966,6,11,USA
Frank Edward,1968-05-27,18,1990,2008,5,27,USA
Gary Leah,1951-07-29,8,1972,1980,7,29,USA
George Edward,1937-11-29,14,1957,1971,11,29,USA
James Gorman,1950-12-12,13,1973,1986,12,12,USA
Herbert Mark,1902-05-26,3,1924,1927,5,26,USA
Ian Drew,1987-04-20,1,2014,2015,4,20,USA
Ira Felix,1881-01-22,9,1906,1915,1,22,USA
Justin Joseph,1984-01-18,4,2008,2012,1,18,USA
Keith Marshall,1923-04-27,1,1952,1953,4,27,USA
Larry Wayne,1969-10-25,2,1995,1997,10,25,USA
Lane Michael,1995-08-23,0,2019,2019,8,23,USA
Clarence Fletcher,1903-10-04,1,1925,1926,10,4,USA
Leo Raymond,1923-07-26,2,1950,1952,7,26,USA
James Leroy,1936-02-05,7,1961,1968,2,5,USA
Michael Steven,1969-09-02,0,1995,1995,9,2,USA
Myles Lewis,1897-10-22,4,1926,1930,10,22,USA
Chester David,1888-01-24,9,1912,1921,1,24,USA
Raymond Joseph,1910-07-09,0,1938,1938,7,9,USA
Robert William,1898-04-25,0,1921,1921,4,25,USA
Roy Allen,1874-03-24,12,1899,1911,3,24,USA
Roy Justin,1953-06-22,10,1977,1987,6,22,USA
Stanley Brown,1949-07-11,3,1974,1977,7,11,USA
Thomas Robert,1873-12-27,6,1894,1900,12,27,USA
Alphonse,1899-12-23,11,1926,1937,12,23,USA
Valmy,1925-10-21,4,1957,1961,10,21,P.R.
William Walter,1884-04-28,0,1908,1908,4,28,USA
James Howard,1970-08-27,21,1991,2012,8,27,USA
Aaron Marshall,1987-02-28,4,2011,2015,2,28,USA
Andrew M.,1846-11-09,NA,NA,NA,11,9,USA
Andrew John,1975-10-08,0,2000,2000,10,8,USA
Bobby LaRue,1953-11-03,0,1978,1978,11,3,USA
Bradley Joseph,1982-01-31,5,2005,2010,1,31,USA
Danny Leon,1947-02-01,6,1970,1976,2,1,USA
Daryl Marcelus,1985-11-02,3,2008,2011,11,2,USA
Derek Ryan,1981-01-08,0,2005,2005,1,8,USA
Donald Newlin,1923-12-28,5,1949,1954,12,28,USA
David Forrest,1918-03-03,1,1948,1949,3,3,USA
Frank E.,1895-07-02,0,1920,1920,7,2,USA
Lafayette Fresco,1902-06-06,9,1925,1934,6,6,USA
Fuller Weidner,1889-06-01,0,1911,1911,6,1,USA
John Gustav,1877-06-22,3,1903,1906,6,22,USA
Harold,1889-09-09,0,1919,1919,9,9,USA
Henry Curtis,1925-12-08,9,1947,1956,12,8,USA
Homer Thomas,1891-06-01,0,1912,1912,6,1,USA
Jason Dolph,1954-07-06,10,1976,1986,7,6,USA
Jason Michael,1971-06-13,0,1996,1996,6,13,USA
Jacob Keith,1994-01-31,2,2016,2018,1,31,USA
John Samuel,1917-01-17,3,1948,1951,1,17,USA
Eugene Earl,1917-06-07,8,1939,1947,6,7,USA
Justin Willard,1973-03-08,9,1996,2005,3,8,USA
Kevin Deshawn,1979-09-18,1,2006,2007,9,18,USA
John Dudley,1898-02-26,0,1921,1921,2,26,USA
Mark Radford,1971-04-07,6,1994,2000,4,7,USA
Michael Wayne,1949-09-06,4,1971,1975,9,6,USA
Milton Bernard,1959-01-05,12,1984,1996,1,5,USA
Michael Paul,1980-11-06,1,2006,2007,11,6,USA
Richard Neil,1958-11-01,5,1985,1990,11,1,USA
Richard Charles,1979-04-23,8,2004,2012,4,23,USA
Richard Graeme,1984-07-01,5,2007,2012,7,1,Australia
Robert Randall,1962-05-10,10,1986,1996,5,10,USA
Ryan Orlando,1967-11-04,10,1992,2002,11,4,USA
Samuel Luther,1860-03-05,21,1885,1906,3,5,USA
Vernon Scot,1955-12-07,7,1978,1985,12,7,USA
James Alfred,1893-04-29,2,1914,1916,4,29,USA
Taylor F.,1987-06-18,0,2014,2014,6,18,USA
Charles Lemoine,1924-03-01,4,1954,1958,3,1,USA
Thomas Carl,1889-11-07,0,1912,1912,11,7,USA
Rupert Lockhart,1910-05-19,6,1933,1939,5,19,USA
Trayce Nikolas,1991-03-15,3,2015,2018,3,15,USA
John Parkinson,1856-09-05,2,1882,1884,9,5,CAN
Will McLain,1870-08-30,0,1892,1892,8,30,USA
Robert Brown,1923-10-25,14,1946,1960,10,25,United Kingdom
John Carl,1973-10-01,10,1997,2007,10,1,USA
Richard William,1958-06-20,14,1979,1993,6,20,USA
John,1879-12-08,9,1902,1911,12,8,USA
Herbert Ehler,1896-07-05,8,1917,1925,7,5,USA
Paul Gayton,1953-11-10,2,1977,1979,11,10,USA
Scott Robert,1982-01-06,1,2006,2007,1,6,CAN
Andre,1949-08-13,14,1973,1987,8,13,USA
John James,1869-05-22,3,1889,1892,5,22,USA
Louis,1963-04-26,5,1985,1990,4,26,USA
Matthew J.,1976-09-15,12,2004,2016,9,15,USA
Otis Benjamin,1945-06-30,0,1973,1973,6,30,USA
Trent Edward,1993-09-30,0,2019,2019,9,30,USA
Tyler Michael,1988-09-29,7,2012,2019,9,29,USA
Walter Miller,1875-02-18,3,1895,1898,2,18,USA
Benjamin Robert,1926-11-19,2,1951,1953,11,19,USA
Robert Joseph,1935-06-12,0,1955,1955,6,12,USA
James Francis,1887-05-28,6,1913,1919,5,28,USA
Lewis,1995-11-23,0,2019,2019,11,23,Australia
Frank Edward,1889-08-06,1,1916,1917,8,6,USA
Erick Morgan,1981-11-04,3,2007,2010,11,4,USA
Maynard Faye,1931-06-22,9,1952,1961,6,22,USA
Marvin Eugene,1933-09-02,8,1955,1963,9,2,USA
George Lynford,1950-11-24,4,1975,1979,11,24,USA
Louis Charles Frank,1916-12-13,1,1939,1940,12,13,USA
Robert Burns,1917-05-14,4,1955,1959,5,14,USA
Corey Lamar,1978-11-05,1,2002,2003,11,5,USA
Gary Montez,1964-11-12,10,1987,1997,11,12,USA
Mark Anthony,1956-09-12,7,1983,1990,9,12,USA
Michael Richard,1973-07-22,5,1997,2002,7,22,USA
Joseph William,1979-09-29,9,2002,2011,9,29,USA
Hollis John,1899-06-02,10,1923,1933,6,2,USA
Luis Clemente,1940-11-23,18,1964,1982,11,23,Cuba
Jay Lindsey,1962-01-04,6,1984,1990,1,4,USA
Richard William,1947-05-14,12,1972,1984,5,14,USA
Bobby Gene,1929-10-10,16,1952,1968,10,10,USA
Verle Matthew,1937-07-11,0,1962,1962,7,11,USA
Edward Carl,1885-05-09,3,1906,1909,5,9,USA
William J.,1858-05-14,2,1882,1884,5,14,USA
James Arthur,1894-02-10,5,1920,1925,2,10,USA
Michael Joseph,1867-01-21,12,1887,1899,1,21,USA
Leslie William,1910-09-11,5,1933,1938,9,11,USA
Terry R.,1979-04-21,4,2004,2008,4,21,USA
Raymond Frank,1884-06-21,0,1907,1907,6,21,USA
John Thomas,1913-08-09,NA,NA,NA,8,9,USA
John Robert,1937-03-24,8,1962,1970,3,24,USA
Christopher Steven,1988-04-15,9,2009,2018,4,15,USA
John Lawrence,1893-10-06,0,1915,1915,10,6,USA
Kerry Jerome,1960-08-29,6,1982,1988,8,29,USA
Thaddious Asa,1940-12-20,1,1967,1968,12,20,USA
Charles Everett,1992-12-02,3,2016,2019,12,2,USA
Gary Dale,1948-08-09,0,1969,1969,8,9,USA
Michael August,1966-03-10,17,1991,2008,3,10,USA
Thomas Henry,1940-05-12,5,1969,1974,5,12,USA
Osborne Llewellyn,1970-09-18,5,1995,2000,9,18,USA
Clay W.,1983-05-13,0,2008,2008,5,13,USA
Austin Ben,1893-04-14,14,1914,1928,4,14,USA
Ronald Irvin,1959-05-27,13,1982,1995,5,27,USA
Joseph Bert,1880-07-27,14,1902,1916,7,27,USA
Lyle Forest,1906-03-12,3,1932,1935,3,12,USA
Jesus Rafael,1995-04-30,0,2019,2019,4,30,Venezuela
Lee Owen,1969-03-04,4,1993,1997,3,4,USA
James,1849-06-18,3,1872,1875,6,18,USA
Daniel Slaughter,1890-02-13,0,1915,1915,2,13,USA
Eric Gordon,1915-04-20,6,1939,1945,4,20,USA
Joe Hicks,1922-02-18,6,1948,1954,2,18,USA
Thomas Arthur,1944-07-12,2,1969,1971,7,12,USA
Johnnie Joseph,1903-10-09,0,1936,1936,10,9,USA
Ledell N.,1866-08-21,4,1886,1890,8,21,USA
John Franklin,1876-02-21,10,1903,1913,2,21,USA
David Vance,1953-03-02,7,1978,1985,3,2,USA
William F.,1854-10-10,0,1880,1880,10,10,USA
John Thomas,1892-05-04,13,1914,1927,5,4,USA
James Anthony,1912-12-27,8,1937,1945,12,27,USA
John Martin,1906-09-15,0,1932,1932,9,15,USA
John Patrick,1921-01-08,0,1945,1945,1,8,USA
Mason Reed,1987-07-08,0,2011,2011,7,8,USA
Marion Brooks,1916-01-28,0,1941,1941,1,28,USA
Jorge Luis,1971-01-07,2,1999,2001,1,7,Cuba
Carlos Daniel,1995-08-23,0,2018,2018,8,23,Venezuela
Alfred Chester,1902-01-07,11,1932,1943,1,7,USA
George Franklin,1869-10-18,0,1898,1898,10,18,USA
Jackson A.,1951-11-20,4,1977,1981,11,20,USA
Jesse Ray,1986-04-20,1,2009,2010,4,20,USA
James Richard,1947-09-21,5,1974,1979,9,21,USA
Philip Julius,1901-08-09,7,1924,1931,8,9,USA
William Harrel,1917-10-08,0,1947,1947,10,8,USA
Robert,1945-11-19,14,1965,1979,11,19,USA
Kevin Anthony,1971-01-28,3,2000,2003,1,28,USA
Christopher Matthew,1982-05-04,3,2008,2011,5,4,USA
Jose,1961-06-03,0,1991,1991,6,3,Mexico
Alvin Andrew,1992-05-24,2,2016,2018,5,24,USA
Freddie Lee,1961-02-03,9,1984,1993,2,3,USA
Brian Patrick,1972-09-16,3,2000,2003,9,16,USA
Shawn Mark,1988-01-19,4,2012,2016,1,19,USA
Steven Wayne,1983-11-01,5,2010,2015,11,1,USA
Jimmy Wayne,1955-11-22,9,1981,1990,11,22,USA
Ashur Jordan,1988-01-24,1,2016,2017,1,24,USA
Timothy Lee,1956-04-20,6,1981,1987,4,20,USA
Charles Julius,1898-11-06,5,1925,1930,11,6,USA
Richard Carl,1931-01-06,6,1953,1959,1,6,USA
Andrew John,1917-12-10,0,1949,1949,12,10,USA
Yasmany,1990-11-14,4,2015,2019,11,14,Cuba
Andy Lee,1966-11-07,5,1993,1998,11,7,USA
George Clarence,1895-11-26,0,1913,1913,11,26,USA
Brett Daniel,1973-04-07,14,1997,2011,4,7,USA
David Allen,1949-06-22,14,1972,1986,6,22,USA
Joshua Aubry,1984-10-19,9,2010,2019,10,19,USA
Kelby Aaron,1990-06-16,3,2015,2018,6,16,USA
Randy Leon,1966-06-14,4,1990,1994,6,14,USA
Philip H.,1863-06-17,2,1888,1890,6,17,USA
Charles Herbert,1889-09-01,0,1912,1912,9,1,USA
Ronald Everett,1944-11-27,6,1965,1971,11,27,USA
Thomas Howard,1951-10-15,2,1975,1977,10,15,USA
Fred Alexandra,1888-12-11,12,1911,1923,12,11,USA
Michael Timothy,1979-02-09,0,2004,2004,2,9,USA
Harry Glenville,1881-08-11,0,1907,1907,8,11,USA
Michael Harvey,1989-11-19,4,2013,2017,11,19,USA
Charles Richard,1881-09-10,0,1911,1911,9,10,USA
Albert R.,1886-08-30,1,1911,1912,8,30,USA
Stephen John,1859-04-09,4,1886,1890,4,9,USA
George,1899-02-09,7,1921,1928,2,9,USA
Ruperto,1941-12-07,0,1962,1962,12,7,Panama
Jeffrey Allen,1941-11-26,9,1964,1973,11,26,USA
Anthony Dale,1979-10-25,3,2002,2005,10,25,USA
Wyatt Reeder,1982-12-02,2,2009,2011,12,2,USA
Clifford Earl,1924-01-01,14,1947,1961,1,1,USA
Chester Leroy,1894-03-19,0,1917,1917,3,19,USA
Abraham Josue,1996-12-20,0,2019,2019,12,20,CAN
Walter Anthony,1891-11-06,0,1920,1920,11,6,USA
Alexander Jesus,1987-12-08,4,2011,2015,12,8,Venezuela
Angel Rafael,1952-10-24,0,1977,1977,10,24,D.R.
Andres Yungo,1978-01-26,11,2002,2013,1,26,USA
Carlos Ephriam,1982-10-22,10,2009,2019,10,22,USA
Dilson Dario,1970-05-31,0,1995,1995,5,31,Venezuela
Eider Lenina,1983-01-16,0,2008,2008,1,16,Venezuela
Felix,1932-05-01,2,1962,1964,5,1,P.R.
Frank Joseph,1931-12-30,7,1956,1963,12,30,USA
Don Gilberto,1915-08-23,6,1940,1946,8,23,Cuba
Gleyber David,1996-12-13,1,2018,2019,12,13,Venezuela
Hector Epitacio,1945-09-16,9,1968,1977,9,16,Mexico
Joseph Paul,1940-07-18,17,1960,1977,7,18,USA
Jose Marcos,1993-09-24,1,2016,2017,9,24,Venezuela
Luis Alfonso,1996-05-02,2,2017,2019,5,2,Venezuela
Michael Augustine,1946-08-28,17,1967,1984,8,28,USA
Pablo Arnoldo,1948-04-28,4,1975,1979,4,28,Venezuela
Ramon Alexander,1993-01-22,1,2017,2018,1,22,D.R.
Ricardo J.,1891-04-16,2,1920,1922,4,16,Cuba
Ronald Alcides,1992-09-02,4,2015,2019,9,2,Venezuela
Rosendo,1948-09-30,9,1971,1980,9,30,P.R.
Salomon,1972-03-11,15,1993,2008,3,11,D.R.
Steven Alexander,1978-02-24,1,2001,2002,2,24,Venezuela
Yorvit Adolfo,1978-07-19,12,2001,2013,7,19,Venezuela
Cristobal,1893-11-16,NA,NA,NA,11,16,Cuba
Kelvin Curtis,1960-01-10,3,1988,1991,1,10,USA
Carlos,1953-09-29,NA,NA,NA,9,29,Cuba
Rene Michael,1986-07-02,0,2011,2011,7,2,CAN
Louis Eugene,1911-06-01,5,1942,1947,6,1,USA
Paul Louis,1935-06-30,2,1962,1964,6,30,USA
Clayland Maffitt,1903-01-24,17,1928,1945,1,24,USA
Dany Gilbert Kiti,1996-06-20,1,2018,2019,6,20,USA
Cesar Leonardo,1940-07-03,11,1965,1976,7,3,Venezuela
Wilfredo Jose,1991-08-11,6,2013,2019,8,11,Venezuela
Joshua Eric,1977-02-26,8,2001,2009,2,26,USA
Justin Richard,1984-02-11,4,2007,2011,2,11,USA
Jay King,1880-03-12,0,1906,1906,3,12,USA
George Hodgson,1867-06-04,4,1887,1891,6,4,USA
John,1879-04-09,5,1901,1906,4,9,USA
Ira Dance,1894-01-09,1,1920,1921,1,9,USA
Leo Alphonse,1891-01-15,1,1920,1921,1,15,USA
James Madison,1858-02-20,3,1887,1890,2,20,USA
William Louis,1882-07-03,0,1908,1908,7,3,USA
William Henry,1979-09-18,6,2003,2009,9,18,USA
James Joseph,1961-12-26,5,1984,1989,12,26,USA
Richard Joseph,1935-02-03,7,1962,1969,2,3,USA
Sean Patrick,1980-11-14,0,2006,2006,11,14,USA
Stephen Christopher,1970-10-31,15,1993,2008,10,31,USA
Andrew Michael,1973-12-11,9,2000,2009,12,11,USA
Chad Austin,1980-05-22,9,2004,2013,5,22,USA
James Edwin,1955-12-31,1,1980,1981,12,31,USA
Matthew J.,1988-11-26,0,2015,2015,11,26,USA
William Franklin,1859-12-21,8,1878,1886,12,21,USA
Walter Joseph,1887-06-14,7,1913,1920,6,14,USA
Blake Matthew,1993-09-05,0,2018,2018,9,5,USA
Stephen Joseph,1915-10-01,0,1940,1940,10,1,USA
Alan Stuart,1958-02-21,19,1977,1996,2,21,USA
Thomas Bubba,1971-11-06,6,1997,2003,11,6,USA
Frederick Orlando,1892-03-24,0,1915,1915,3,24,USA
John Howard,1962-08-07,0,1988,1988,8,7,USA
Aloysius Joseph,1892-05-07,0,1912,1912,5,7,USA
William Edward,1952-10-27,9,1974,1983,10,27,USA
Cecil Howell,1913-08-08,14,1933,1947,8,8,USA
Devon Anthony,1991-02-21,3,2015,2018,2,21,USA
Samuel John,1993-08-27,2,2017,2019,8,27,USA
Brian Lee,1967-09-26,0,1990,1990,9,26,USA
James,1860-02-14,0,1884,1884,2,14,USA
Harold Joseph,1898-11-11,17,1920,1937,11,11,USA
George B.,1866-11-11,3,1893,1896,11,11,USA
Hugh Jeffery,1963-01-22,8,1987,1995,1,22,USA
Edgar Raymond,1907-10-31,0,1930,1930,10,31,USA
Thadford Leon,1920-04-28,1,1944,1945,4,28,USA
Matthew Aaron,1976-03-03,8,2004,2012,3,3,USA
Thomas Lynn,1948-01-27,NA,NA,NA,1,27,USA
Frank Adam,1915-12-24,0,1937,1937,12,24,USA
Blake M.,1988-06-30,5,2014,2019,6,30,USA
Harry Roy,1892-11-18,0,1913,1913,11,18,USA
Nicholas Joseph,1912-10-15,2,1934,1936,10,15,USA
David Michael,1951-10-31,NA,NA,NA,10,31,USA
William Leonard,1929-07-04,2,1954,1956,7,4,USA
Christopher James,1969-10-17,9,1995,2004,10,17,USA
Carlton Overton,1906-03-22,1,1927,1928,3,22,USA
Michael,1914-02-23,11,1938,1949,2,23,USA
Thomas Michael,1938-09-20,8,1961,1969,9,20,USA
Alejandro,1957-08-26,12,1978,1990,8,26,Mexico
Carlos,1945-08-15,0,1968,1968,8,15,Mexico
Jose,1992-11-28,1,2018,2019,11,28,USA
Gus,1930-07-30,12,1953,1965,7,30,USA
Robert Lee,1926-08-28,2,1953,1955,8,28,USA
Andrew Austin,1989-03-16,2,2016,2018,3,16,USA
Jesus Manuel Marcano,1950-12-25,16,1973,1989,12,25,Venezuela
Joseph Gerard,1930-10-12,2,1955,1957,10,12,USA
Kenneth Wayne,1919-12-15,6,1943,1949,12,15,USA
Herman Coaker,1911-12-18,7,1938,1945,12,18,USA
Carlos Manuel,1990-02-27,2,2012,2014,2,27,D.R.
Lou Albert,1991-10-01,1,2018,2019,10,1,USA
Richard Alan,1969-04-26,5,1992,1997,4,26,USA
Richard LaMonte,1950-05-01,1,1973,1974,5,1,USA
Michael Scott,1967-04-14,10,1992,2002,4,14,USA
Ramon Jose,1983-02-16,5,2008,2013,2,16,D.R.
Nicholas Paul,1990-08-27,5,2014,2019,8,27,USA
Harold Arthur,1912-11-11,13,1933,1946,11,11,USA
Harold Arthur,1936-09-29,0,1958,1958,9,29,USA
William Felix,1908-08-10,7,1937,1944,8,10,USA
Samuel W.,1857-03-03,8,1880,1888,3,3,USA
Quincy Thomas,1912-12-25,0,1952,1952,12,25,USA
Paul Howard,1915-06-29,18,1939,1957,6,29,USA
Michael Nelson,1991-08-07,8,2011,2019,8,7,USA
Steven Russell,1957-07-30,11,1978,1989,7,30,USA
Robert,1930-06-27,4,1956,1960,6,27,USA
Robert Gustave,1888-08-27,0,1912,1912,8,27,Germany
John Joseph,1856-05-08,4,1881,1885,5,8,USA
Christopher John,1973-12-09,3,2000,2003,12,9,USA
Harry Garvin,1868-05-12,1,1895,1896,5,12,USA
Virgil Oliver,1917-04-26,17,1941,1958,4,26,USA
Frank Day,1884-03-31,8,1910,1918,3,31,USA
John,1975-10-09,0,2002,2002,10,9,USA
Michael Andrew,1960-01-12,4,1985,1989,1,12,USA
Edward J.,1860-11-03,0,1884,1884,11,3,USA
Mark Daniel,1986-01-16,9,2010,2019,1,16,USA
George Alex,1967-06-14,0,1993,1993,6,14,USA
Chin-hui,1981-06-02,13,2003,2016,6,2,Taiwan
Jen-Ho,1994-10-03,1,2017,2018,10,3,Taiwan
John Philip,1936-05-04,11,1957,1968,5,4,USA
Gregory Alan,1962-08-31,0,1993,1993,8,31,USA
Cole Bryson,1996-07-03,0,2019,2019,7,3,USA
Eddie Jack,1966-11-18,3,1992,1995,11,18,USA
Kyle Daniel,1997-01-17,1,2018,2019,1,17,USA
Michael Anthony,1971-06-25,11,1995,2006,6,25,USA
Oliver Dinwiddie,1902-01-27,1,1927,1928,1,27,USA
Preston M.,1990-07-06,3,2015,2018,7,6,USA
Ryan Christopher,1986-12-06,3,2008,2011,12,6,USA
Thurman Lowell,1917-09-26,9,1942,1951,9,26,USA
Thomas John,1978-08-20,5,2000,2005,8,20,USA
Thomas Joseph,1863-10-28,12,1887,1899,10,28,USA
Thomas Henry,1884-10-07,1,1908,1909,10,7,USA
John Thomas,1954-02-02,11,1979,1990,2,2,USA
Oscar Monzon,1893-12-17,2,1918,1920,12,17,Cuba
Robert Malcolm,1955-11-02,2,1981,1983,11,2,USA
Matthew Petelu,1986-05-10,8,2008,2016,5,10,USA
Samuel Johnathan,1992-10-19,5,2014,2019,10,19,USA
Troy Trever,1984-10-10,13,2006,2019,10,10,USA
Byron Lee,1960-10-30,7,1982,1989,10,30,USA
Matthew David,1979-11-25,0,2008,2008,11,25,USA
Brian Craig,1967-06-14,1,1993,1994,6,14,USA
George Elkins,1914-08-24,2,1935,1937,8,24,USA
Jeremiah,1852-07-04,0,1884,1884,7,4,USA
Edward Lawrence,1917-02-10,0,1943,1943,2,10,USA
Eugene Joseph,1897-01-03,0,1923,1923,1,3,USA
Lucas Newton,1898-05-02,0,1922,1922,5,2,USA
Robert Lee,1930-09-19,12,1951,1963,9,19,USA
Nikolas Carlyle,1989-09-11,0,2017,2017,9,11,USA
Thomas Derrick,1978-01-25,8,2000,2008,1,25,USA
Spencer Ketcham,1992-09-18,1,2018,2019,9,18,USA
Christopher Wan,1969-03-23,7,1993,2000,3,23,USA
Earl Edwin,1923-05-06,2,1948,1950,5,6,USA
Jacob Edward,1991-05-21,7,2011,2018,5,21,USA
John Webber,1954-01-17,9,1974,1983,1,17,USA
James Riley,1903-08-06,8,1937,1945,8,6,USA
Justin Matthew,1984-11-23,10,2009,2019,11,23,USA
Kenneth Charles,1943-08-17,0,1967,1967,8,17,USA
William Matthew,1967-02-18,1,1993,1994,2,18,USA
Shane Lee,1963-01-08,4,1988,1992,1,8,USA
Randy Stuart,1991-12-27,0,2017,2017,12,27,USA
Terrance Lamont,1881-02-28,18,1901,1919,2,28,USA
Theodore Holtop,1892-05-04,0,1920,1920,5,4,USA
Robert Edward,1938-11-19,NA,NA,NA,11,19,USA
Thomas Lovatt,1890-02-20,0,1915,1915,2,20,USA
Thomas Richard,1916-09-08,4,1940,1944,9,8,USA
Trea Vance,1993-06-30,4,2015,2019,6,30,USA
George A.,1867-02-13,5,1893,1898,2,13,USA
William Robert,1929-07-04,11,1952,1963,7,4,USA
Elmer Strange,1904-11-19,0,1928,1928,11,19,USA
Guy Isbel,1888-07-17,2,1911,1913,7,17,USA
Arthur S.,1866-11-26,1,1893,1894,11,26,USA
Howard Earle,1894-05-30,0,1916,1916,5,30,USA
Lawrence Grant,1864-02-18,8,1886,1894,2,18,USA
Wayne Lee,1948-03-10,9,1970,1979,3,10,USA
Jeffrey Dean,1957-11-10,0,1980,1980,11,10,USA
Clarence Edward,1896-01-18,1,1920,1921,1,18,USA
Edwin Parker,1897-06-15,0,1921,1921,6,15,USA
George Frederick,1892-06-04,5,1914,1919,6,4,USA
James Frederick,1911-01-09,0,1943,1943,1,9,USA
Frederick Franklin,1891-12-16,0,1914,1914,12,16,USA
John Anthony,1906-07-30,1,1934,1935,7,30,USA
George Albert,1889-12-14,11,1910,1921,12,14,USA
Jason Renyt,1977-04-23,8,2000,2008,4,23,USA
James Alexander,1856-05-27,9,1879,1888,5,27,USA
Earl Carlton,1890-03-04,0,1914,1914,3,4,USA
David Burton,1937-10-31,0,1962,1962,10,31,USA
James Vernon,1949-01-29,5,1972,1977,1,29,USA
Oscar Wayne,1950-08-01,0,1976,1976,8,1,USA
Michael Ray,1950-01-13,9,1972,1981,1,13,USA
Cecil Washington,1914-12-06,0,1944,1944,12,6,USA
Albert Thomas,1892-06-01,2,1926,1928,6,1,USA
James Emerson,1900-10-20,0,1926,1926,10,20,USA
Robert George,1934-01-26,5,1962,1967,1,26,USA
Koji,1975-04-03,8,2009,2017,4,3,Japan
Daniel Cooley,1980-03-11,9,2006,2015,3,11,USA
Luis Enrique,1979-02-15,1,2002,2003,2,15,Venezuela
Bernard Bartholomew,1910-04-27,0,1934,1934,4,27,USA
Theodore Otto,1939-10-21,7,1965,1972,10,21,USA
Robert Ellwood,1913-09-17,2,1938,1940,9,17,USA
George Ernest,1898-09-18,17,1919,1936,9,18,USA
Maurice William,1886-12-14,0,1914,1914,12,14,USA
Charles Karel,1912-07-30,0,1934,1934,7,30,USA
Gerald Raymond,1957-03-05,4,1980,1984,3,5,USA
Michael Edward,1917-09-28,0,1945,1945,9,28,USA
Scott Matthew,1955-06-10,0,1983,1983,6,10,USA
Carlos Santiago,1921-07-25,1,1944,1945,7,25,Cuba
Frank W.,1899-11-18,2,1925,1927,11,18,Austria
George F.,1869-06-05,4,1892,1896,6,5,USA
Arnold William,1942-12-06,2,1964,1966,12,6,USA
James Harold,1953-02-17,3,1975,1978,2,17,USA
James,1930-09-17,4,1959,1963,9,17,USA
Thomas Mullen,1931-05-12,2,1953,1955,5,12,USA
Duane Lee,1994-07-20,1,2018,2019,7,20,USA
Frederick Theodore,1868-10-14,0,1894,1894,10,14,USA
Patrick John,1957-02-09,4,1979,1983,2,9,USA
Thomas Gerald,1953-12-22,10,1974,1984,12,22,USA
Willie Vernon,1904-09-06,1,1927,1928,9,6,USA
Robert Alexander,1880-07-31,6,1904,1910,7,31,USA
Timothy Brian,1970-10-07,5,1995,2000,10,7,USA
Albert Bernard,1912-10-12,3,1942,1945,10,12,USA
Delbert Bernard,1944-12-09,14,1968,1982,12,9,USA
Jefferson Woodrow,1911-04-13,1,1935,1936,4,13,USA
William Lawrence,1888-04-04,3,1915,1918,4,4,USA
John Leslie,1941-12-29,1,1967,1968,12,29,CAN
George Henry,1883-12-10,0,1909,1909,12,10,USA
R T,1926-05-30,0,1953,1953,5,30,USA
Cecil Lee,1942-10-22,9,1966,1975,10,22,USA
Willie Clay,1957-04-27,10,1978,1988,4,27,USA
William Ray,1929-06-18,0,1954,1954,6,18,USA
Melvin Emanuel,1984-08-21,12,2004,2016,8,21,USA
Justin Irvin,1987-08-25,12,2007,2019,8,25,USA
Thomas Herbert,1926-12-29,2,1950,1952,12,29,USA
William Michael,1903-06-05,6,1931,1937,6,5,USA
Jack Elmer,1928-12-05,2,1957,1959,12,5,USA
Louis John,1887-03-22,1,1927,1928,3,22,USA
Thomas James,1968-01-21,3,1993,1996,1,21,USA
Ugueth Urtain,1974-02-15,10,1995,2005,2,15,Venezuela
Lino,1979-11-20,3,2004,2007,11,20,Venezuela
Jose Miguel,1991-09-12,4,2015,2019,9,12,D.R.
Richard,1996-02-26,2,2017,2019,2,26,D.R.
Julio Cesar,1996-08-12,3,2016,2019,8,12,Mexico
Luis Fernando,1997-06-03,1,2018,2019,6,3,Mexico
Jose Altagracia,1959-01-21,9,1984,1993,1,21,D.R.
Juan C.,1979-03-22,15,2001,2016,3,22,D.R.
Jose Luis,1995-05-01,0,2019,2019,5,1,Mexico
John Goody,1955-02-09,4,1977,1981,2,9,USA
Henry Alexander,1987-02-13,2,2013,2015,2,13,Cuba
Giovanny,1991-10-11,4,2015,2019,10,11,Colombia
Robert Royce,1925-03-01,11,1946,1957,3,1,USA
William August,1904-04-11,2,1925,1927,4,11,USA
Chase Cameron,1978-12-17,15,2003,2018,12,17,USA
Ernest Lewis,1889-11-17,0,1925,1925,11,17,USA
Onesime Eugene,1859-09-05,0,1884,1884,9,5,CAN
Harry Henry,1885-02-13,0,1904,1904,2,13,USA
Robert Garfield,1881-09-24,0,1908,1908,9,24,USA
Michael Lewis,1951-11-10,9,1975,1984,11,10,USA
Christopher Andrew,1985-08-14,4,2010,2014,8,14,USA
Patrick Ryne,1992-09-09,3,2016,2019,9,9,USA
Luis Adan,1985-11-30,10,2008,2018,11,30,Venezuela
Carlos Luis,1971-12-26,3,1995,1998,12,26,D.R.
Carlos Alberto,1977-11-30,0,2003,2003,11,30,Venezuela
Cesar Miguel,1985-03-17,7,2010,2017,3,17,D.R.
Efrain Antonio,1966-07-11,8,1990,1998,7,11,D.R.
Framber,1993-11-19,1,2018,2019,11,19,D.R.
Ismael,1973-08-21,11,1994,2005,8,21,Mexico
Jose,1983-01-22,1,2011,2012,1,22,D.R.
Jordany V.,1987-12-23,3,2012,2015,12,23,D.R.
Jose Alfredo,1990-03-01,3,2015,2018,3,1,D.R.
Julio Julian Castillo,1956-06-03,3,1980,1983,6,3,D.R.
Jairo Manuel,1983-05-30,4,2009,2013,5,30,D.R.
Marc Christopher,1971-12-20,6,1995,2001,12,20,USA
Mario A.,1974-11-19,4,1997,2001,11,19,Mexico
Merkin R.,1981-11-05,7,2004,2011,11,5,D.R.
Pedro Jose,1973-06-29,4,1996,2000,6,29,P.R.
Phillips,1991-11-16,0,2019,2019,11,16,D.R.
Rafael Emilio,1967-12-17,0,1990,1990,12,17,D.R.
Raul,1977-11-27,4,2010,2014,11,27,Cuba
Rene,1929-06-02,0,1957,1957,6,2,Cuba
Rogelio Lazaro,1920-02-23,0,1944,1944,2,23,Cuba
Hilario,1939-01-24,6,1965,1971,1,24,Cuba
Sergio Sanchez,1964-09-07,9,1986,1995,9,7,D.R.
Wilson Antonio,1978-05-20,8,2004,2012,5,20,D.R.
Jose Lopez,1934-05-22,6,1955,1961,5,22,Cuba
Benjamin Beltran,1933-06-02,0,1958,1958,6,2,Mexico
Robert John,1950-05-13,10,1969,1979,5,13,USA
Harold Lewis,1929-01-04,1,1954,1955,1,4,USA
Daniel Paul,1984-09-19,8,2010,2018,9,19,USA
Ellis Clarence,1954-07-30,10,1975,1985,7,30,USA
Eric Christian,1977-04-04,4,2001,2005,4,4,USA
Fernando,1960-11-01,17,1980,1997,11,1,Mexico
Fred Lee,1935-01-19,9,1959,1968,1,19,USA
Jose Javier,1975-09-19,11,1997,2008,9,19,P.R.
Jesmuel Jose,1994-05-12,0,2018,2018,5,12,P.R.
John Gill,1855-11-21,0,1883,1883,11,21,USA
John William,1967-02-18,10,1992,2002,2,18,USA
Jose Antonio,1969-10-12,15,1992,2007,10,12,P.R.
Joseph John,1979-12-24,2,2003,2005,12,24,USA
Vito John,1928-09-16,5,1954,1959,9,16,USA
Breyvic Jose,1992-01-08,2,2017,2019,1,8,Venezuela
Julio Enrique,1968-10-13,6,1990,1996,10,13,P.R.
Yohanny,1976-08-17,0,2000,2000,8,17,D.R.
David,1960-10-30,12,1984,1996,10,30,USA
Hector Jose,1940-10-27,0,1965,1965,10,27,P.R.
Elmer William,1921-03-05,21,1940,1961,3,5,Czech Republic
Jose Rafael,1978-03-24,11,2003,2014,3,24,D.R.
Clayton Emory,1900-05-24,1,1927,1928,5,24,USA
Russell,1906-06-21,6,1933,1939,6,21,USA
John Wesley,1980-04-14,4,2004,2008,4,14,USA
Camille Oscar,1926-09-28,1,1954,1955,9,28,CAN
Edward Eugene,1870-12-14,0,1904,1904,12,14,USA
Jermaine Russell,1980-07-02,1,2005,2006,7,2,USA
Tyler Lee,1963-10-07,1,1993,1994,10,7,USA
Albert Joseph,1903-09-07,4,1928,1932,9,7,USA
Cory Wade,1979-06-20,1,2002,2003,6,20,USA
Charles Arthur,1891-03-04,20,1915,1935,3,4,USA
Joseph Albert,1905-09-16,3,1935,1938,9,16,USA
Gene Covington,1947-01-05,1,1970,1971,1,5,USA
Christian Gerald,1927-01-03,2,1950,1952,1,3,USA
John Henry,1921-07-07,2,1947,1949,7,7,USA
Carl William,1883-04-22,0,1914,1914,4,22,USA
Edward John,1958-10-26,6,1982,1988,10,26,USA
Harold Harris,1906-03-17,10,1935,1945,3,17,USA
John Samuel,1914-11-02,14,1937,1951,11,2,USA
John Henry,1966-04-29,13,1991,2004,4,29,USA
Henricus Nicolas,1985-05-22,5,2007,2012,5,22,Netherlands
Frederick William,1937-07-31,0,1955,1955,7,31,USA
Benjamin Harrison,1888-08-15,3,1909,1912,8,15,USA
William Jennings,1863-12-15,3,1890,1893,12,15,USA
Timothy Layne,1969-05-31,2,1994,1996,5,31,USA
Jonathan Eugene,1979-11-27,2,2008,2010,11,27,USA
Elam Russell,1896-04-23,10,1919,1929,4,23,USA
David Thomas,1957-03-27,5,1982,1987,3,27,USA
George Edward Martin,1866-03-30,16,1887,1903,3,30,USA
Andrew William,1979-07-31,0,2002,2002,7,31,USA
William Joseph,1970-07-16,3,1994,1997,7,16,USA
Josh Michael,1995-03-10,0,2019,2019,3,10,USA
John Silas,1890-06-07,0,1913,1913,6,7,USA
Jay Lowell,1928-11-04,0,1951,1951,11,4,USA
Todd Matthew,1971-12-09,13,1991,2004,12,9,USA
Maurice Rene,1914-11-15,7,1939,1946,11,15,USA
Benjamin Ashley,1971-08-09,2,1996,1998,8,9,USA
Andrew James,1960-12-21,12,1983,1995,12,21,USA
Scott T.,1986-07-24,5,2012,2017,7,24,USA
Andrew William,1930-12-11,1,1950,1951,12,11,USA
Cesar,1991-12-30,0,2016,2016,12,30,Mexico
Claudio,1978-06-19,7,2003,2010,6,19,D.R.
Hediberto,1959-02-23,2,1982,1984,2,23,P.R.
Ildemaro Jose,1991-07-16,2,2017,2019,7,16,Venezuela
Jason Matthew,1983-02-02,14,2005,2019,2,2,USA
Kennys,1990-08-01,3,2014,2017,8,1,P.R.
Roberto Enrique,1929-05-29,0,1955,1955,5,29,P.R.
William Fay,1899-11-11,1,1925,1926,11,11,USA
Jason Andrew,1972-04-11,14,1997,2011,4,11,USA
Glen Gann,1930-08-17,0,1952,1952,8,17,USA
Lawrence Delano,1880-08-09,0,1902,1902,8,9,USA
Richard Fred,1949-04-10,3,1973,1976,4,10,USA
Gary Andrew,1961-06-20,7,1988,1995,6,20,USA
Anthony Michael,1984-10-31,5,2010,2015,10,31,USA
Moses Calhoun,1880-07-19,0,1902,1902,7,19,USA
Anthony Russell,1986-09-19,0,2011,2011,9,19,USA
Andrew Jude,1993-09-14,1,2018,2019,9,14,USA
Esmerling de Jesus,1983-11-07,3,2009,2012,11,7,D.R.
Jorge Luis,1978-07-16,1,2004,2005,7,16,D.R.
Rafael,1958-06-28,0,1979,1979,6,28,D.R.
Virgil Matthew,1982-06-07,2,2007,2009,6,7,USA
Gerard Joseph,1992-02-12,0,2018,2018,2,12,USA
James Ernest,1965-05-27,2,1990,1992,5,27,USA
Joseph Floyd,1912-03-09,16,1932,1948,3,9,USA
Robert,1885-06-04,6,1909,1915,6,4,USA
Charles Wayne,1947-10-06,3,1966,1969,10,6,USA
DeWayne Mathew,1959-07-22,0,1988,1988,7,22,USA
Henry Francis,1864-03-01,13,1886,1899,3,1,USA
Frederick Thomas,1918-10-18,1,1944,1945,10,18,USA
Glenn Edward,1944-02-16,0,1963,1963,2,16,USA
Gregory Lamont,1965-07-03,14,1989,2003,7,3,USA
James Leslie,1888-04-09,13,1908,1921,4,9,USA
Maurice Samuel,1967-12-15,12,1991,2003,12,15,USA
Cecil Porter,1919-05-11,6,1940,1946,5,11,USA
Clarence LeRoy,1911-09-04,0,1934,1934,9,4,USA
Christian Rafael,1990-08-21,5,2014,2019,8,21,P.R.
Javier Carlos,1976-07-25,13,1998,2011,7,25,P.R.
Ramon Luis,1976-08-21,8,2001,2009,8,21,P.R.
Alvis Lindel,1909-08-06,0,1935,1935,8,6,USA
Robert Hayes,1888-06-29,13,1912,1925,6,29,USA
William Walter,1862-06-15,6,1884,1890,6,15,USA
Orville Inman,1932-07-09,5,1958,1963,7,9,USA
Donald Tyrone,1984-09-18,6,2009,2015,9,18,USA
Robert Andrew,1935-10-28,12,1962,1974,10,28,USA
Louis Edward,1897-04-20,0,1920,1920,4,20,USA
William Louis,1914-02-09,NA,NA,NA,2,9,USA
Jesus Anthony,1955-10-14,3,1979,1982,10,14,P.R.
Allen Francis,1917-01-30,0,1939,1939,1,30,USA
Frederick William,1881-08-02,1,1903,1904,8,2,USA
Jorge Luis,1975-01-12,11,1997,2008,1,12,Venezuela
Randy Lee,1962-11-24,15,1987,2002,11,24,USA
Guillermo,1968-04-23,1,1992,1993,4,23,Mexico
Vincent John,1992-06-07,4,2015,2019,6,7,USA
Andrew,1994-07-14,1,2018,2019,7,14,USA
Carlos,1948-03-22,0,1973,1973,3,22,P.R.
Federico Antonio,1937-12-06,4,1969,1973,12,6,D.R.
Gilbert Arnulfo,1979-10-17,5,2008,2013,10,17,USA
Hector,1988-11-26,2,2017,2019,11,26,Mexico
Eugenio,1982-05-16,4,2007,2011,5,16,D.R.
Otoniel,1950-11-29,10,1973,1983,11,29,P.R.
Arthur Patrick,1906-03-24,8,1926,1934,3,24,USA
William McKinley,1957-06-06,12,1979,1991,6,6,USA
William Dion,1982-10-29,8,2008,2016,10,29,USA
Michael Robert,1973-08-02,7,1999,2006,8,2,USA
Patrick Michael,1985-06-30,4,2015,2019,6,30,USA
Jonathan William,1985-03-20,9,2010,2019,3,20,USA
Michael,1978-05-25,1,2005,2006,5,25,USA
Robin Mark,1967-07-14,15,1989,2004,7,14,USA
Vincent,1917-04-18,0,1945,1945,4,18,USA
Yordano,1991-06-03,3,2013,2016,6,3,D.R.
Dario Antonio,1973-03-13,2,1996,1998,3,13,D.R.
Jose Enger,1980-10-20,8,2006,2014,10,20,D.R.
Quilvio Alberto,1971-04-03,6,1995,2001,4,3,D.R.
Wilton Andres,1978-01-19,1,1999,2000,1,19,D.R.
Emil Matthew,1915-08-27,6,1944,1950,8,27,USA
Joseph Michael,1943-04-24,4,1966,1970,4,24,USA
Gene Kermit,1928-06-29,2,1951,1953,6,29,USA
Albert Alfred,1921-06-10,0,1944,1944,6,10,USA
Frank Michael,1926-06-02,0,1953,1953,6,2,USA
Alex Brady,1996-05-15,2,2017,2019,5,15,USA
Ryan Louis,1987-04-10,0,2012,2012,4,10,USA
John James,1893-12-02,0,1915,1915,12,2,USA
David Scott,1966-10-19,9,1994,2003,10,19,USA
Randolph Ruhland,1965-11-25,8,1989,1997,11,25,USA
Jean Louis,1906-07-09,5,1931,1936,7,9,USA
Drew Edward,1990-10-22,5,2014,2019,10,22,USA
John C.,1952-07-03,5,1976,1981,7,3,USA
Justin Brooks,1983-02-20,14,2005,2019,2,20,USA
James Jordan,1982-02-10,0,2007,2007,2,10,USA
Joseph Henry,1889-11-25,2,1912,1914,11,25,USA
James Barton,1918-04-22,21,1939,1960,4,22,USA
Scott Logan,1990-06-19,2,2015,2017,6,19,USA
Zoilo Casanova,1939-12-18,12,1959,1971,12,18,Cuba
Thomas Martin,1953-02-11,11,1973,1984,2,11,USA
Robert Mitchell,1955-09-27,1,1980,1981,9,27,USA
Leon A.,1866-07-05,4,1888,1892,7,5,USA
Dayan,1989-03-10,4,2010,2014,3,10,Cuba
Henry Arthur,1900-07-02,4,1922,1926,7,2,USA
Harry Porter,1879-05-17,7,1902,1909,5,17,USA
Thomas Gill,1867-05-05,3,1890,1893,5,5,USA
Samuel Bruce,1895-04-12,4,1917,1921,4,12,USA
George Steve,1923-08-09,1,1948,1949,8,9,USA
Shane Patrick,1980-11-30,12,2003,2015,11,30,USA
Jose,1940-04-03,3,1966,1969,4,3,D.R.
Jose Angel,1974-08-27,11,1997,2008,8,27,P.R.
Thyago da Silva,1993-07-01,2,2017,2019,7,1,Brazil
Engelb Stalin,1994-06-22,0,2018,2018,6,22,Venezuela
Brandon Paul,1975-12-17,4,2000,2004,12,17,USA
Brayan Rene,1987-05-10,2,2011,2013,5,10,Venezuela
Carlos Manuel,1983-11-28,10,2006,2016,11,28,D.R.
Christian,1991-06-19,1,2017,2018,6,19,Mexico
Eduardo Enrique,1979-08-29,0,2004,2004,8,29,Venezuela
Elih Christopher,1986-07-27,0,2011,2011,7,27,USA
Hector,1964-10-02,3,1990,1993,10,2,P.R.
Henry,1987-05-24,0,2010,2010,5,24,D.R.
Jonathan Rafael,1991-05-02,6,2013,2019,5,2,D.R.
Oscar Eduardo,1981-11-22,5,2003,2008,11,22,Mexico
Pedro A.,1987-12-09,3,2012,2015,12,9,USA
Ismael,1976-08-12,0,2000,2000,8,12,P.R.
Ronald Thomas,1970-01-16,14,1995,2009,1,16,USA
Meibrys John,1997-02-15,1,2018,2019,2,15,Colombia
Fernando,1969-04-16,11,1993,2004,4,16,USA
Nicholas James,1986-07-12,7,2012,2019,7,12,USA
Zachary Laine,1991-05-01,1,2017,2018,5,1,USA
Robert Earl,1897-02-25,1,1924,1925,2,25,USA
David Kent,1941-02-25,0,1964,1964,2,25,USA
Kenneth Edward,1974-12-05,0,2001,2001,12,5,USA
Charles Anthony,1944-01-05,0,1966,1966,1,5,USA
Ernest Augustus,1879-03-20,2,1904,1906,3,20,USA
William Miller,1865-04-27,1,1884,1885,4,27,USA
Frank John,1960-04-19,14,1982,1996,4,19,USA
Pedro,1983-06-29,2,2009,2011,6,29,D.R.
James Henry,1890-12-30,4,1912,1916,12,30,USA
William Charles,1931-06-09,13,1955,1968,6,9,USA
Osvaldo Jose,1932-05-17,13,1956,1969,5,17,D.R.
Osvaldo Jose,1956-12-07,10,1980,1990,12,7,P.R.
Jacob Kitchline,1865-03-02,4,1890,1894,3,2,USA
Joseph Paul,1859-09-27,6,1885,1891,9,27,USA
Antonio Joseph,1908-04-12,1,1944,1945,4,12,USA
Joseph David,1970-04-11,8,1995,2003,4,11,USA
Joseph John,1970-02-01,0,1992,1992,2,1,USA
Joshua Warren,1989-08-27,0,2012,2012,8,27,USA
Oscar Joseph,1890-01-04,9,1912,1921,1,4,USA
Arodys,1990-11-13,8,2011,2019,11,13,D.R.
Jose Luis,1968-03-26,17,1989,2006,3,26,D.R.
Luis,1974-08-06,10,1999,2009,8,6,D.R.
Omar Enrique,1967-04-24,23,1989,2012,4,24,Venezuela
Daniel,1992-12-17,3,2016,2019,12,17,USA
Otto Henry,1899-10-26,1,1923,1924,10,26,USA
Ryan Andrew,1977-07-22,16,2000,2016,7,22,USA
Stephen Guy,1984-11-01,7,2012,2019,11,1,USA
John David,1966-05-17,6,1992,1998,5,17,USA
Olen Edward,1899-01-29,0,1924,1924,1,29,USA
William Symmes,1919-01-29,8,1942,1950,1,29,USA
Louis Linwood,1991-02-13,2,2017,2019,2,13,USA
Clyde Frederick,1921-09-24,12,1942,1954,9,24,USA
Edinson,1983-07-03,14,2005,2019,7,3,D.R.
Christopher Kenneth,1986-09-23,10,2008,2018,9,23,USA
Jacob Phillip,1878-04-04,7,1901,1908,4,4,USA
Christian Frederick Wilhelm,1851-10-07,NA,NA,NA,10,7,Germany
Anthony John,1869-05-30,0,1890,1890,5,30,USA
Bruce Frederick,1943-11-17,2,1965,1967,11,17,USA
Alfred Holmes,1893-05-20,2,1914,1916,5,20,USA
David,1958-10-25,4,1983,1987,10,25,USA
Henry Bert,1874-09-30,0,1902,1902,9,30,USA
Edward John,1961-09-28,16,1986,2002,9,28,USA
Joseph Franklin,1910-04-04,14,1930,1944,4,4,USA
Alexander,1858-05-16,0,1884,1884,5,16,USA
William Edward,1943-10-31,7,1965,1972,10,31,USA
Austin Lee,1992-06-26,1,2018,2019,6,26,USA
Joseph Daniel,1983-09-10,12,2007,2019,9,10,CAN
John Henry,1884-11-18,0,1905,1905,11,18,USA
Bradley Roy,1976-12-30,2,2001,2003,12,30,USA
Philip Vance,1900-05-12,0,1929,1929,5,12,USA
Peter Dennis,1952-10-27,11,1975,1986,10,27,USA
George Stephen,1956-06-24,5,1980,1985,6,24,USA
John Christopher,1947-07-31,11,1970,1981,7,31,USA
Michael Joseph,1991-07-01,6,2013,2019,7,1,USA
Paul Horine,1888-04-30,0,1917,1917,4,30,USA
Charles James,1883-12-08,0,1909,1909,12,8,USA
Tsuyoshi,1981-02-21,1,2014,2015,2,21,Japan
Frank Orum,1905-08-21,0,1931,1931,8,21,USA
Jason Robert,1981-06-11,0,2009,2009,6,11,USA
George Edward,1876-10-13,13,1897,1910,10,13,USA
Thomas David,1958-09-17,3,1984,1987,9,17,United Kingdom
Benjamin Styron,1922-11-25,7,1948,1955,11,25,USA
Cory Nathaniel,1983-05-28,4,2008,2012,5,28,USA
Galeard Lee,1929-01-20,1,1955,1956,1,20,USA
Abraham Lincoln,1879-12-20,0,1907,1907,12,20,USA
Jacob Fields,1912-04-01,10,1936,1946,4,1,USA
LaMonte Aaron,1994-01-01,0,2019,2019,1,1,USA
Richard Frank,1898-01-12,0,1923,1923,1,12,USA
Hawatha Terrell,1973-01-25,3,1995,1998,1,25,USA
Tyler Dean,1994-11-23,2,2017,2019,11,23,USA
John L.,1867-12-17,5,1890,1895,12,17,USA
Douglas Michael,1981-01-28,6,2003,2009,1,28,USA
Ellwood Otto,1863-06-03,0,1888,1888,6,3,USA
William Joseph,1894-01-02,4,1914,1918,1,2,USA
William Edward,1971-07-25,15,1995,2010,7,25,USA
Albert,1871-09-17,0,1898,1898,9,17,USA
William George,1887-12-25,1,1913,1914,12,25,USA
Charles Thomas,1912-12-03,8,1938,1946,12,3,USA
Gary Edward,1940-06-28,5,1965,1970,6,28,USA
Harold Edward,1915-07-02,12,1937,1949,7,2,USA
Charles F.,1880-09-23,16,1902,1918,9,23,USA
Hector Raul Guerrero,1968-11-26,1,1990,1991,11,26,D.R.
John Peter,1874-02-24,20,1897,1917,2,24,USA
Joseph Bernard,1889-04-24,0,1915,1915,4,24,USA
Leon Lamar,1934-05-13,11,1958,1969,5,13,USA
Mark Duane,1954-03-04,8,1976,1984,3,4,USA
Matthew William,1972-04-04,0,1996,1996,4,4,USA
Neil Kannas,1984-01-01,3,2011,2014,1,1,USA
Paul Alan,1967-11-14,7,1992,1999,11,14,USA
Ryan Scott,1982-07-15,4,2003,2007,7,15,USA
Tyler Joseph,1991-01-24,1,2015,2016,1,24,USA
Jacob Daniel,1993-11-05,0,2019,2019,11,5,USA
Robert Martin,1992-03-21,1,2017,2018,3,21,USA
Kermit Emerson,1922-11-18,7,1944,1951,11,18,USA
David Paul,1967-11-07,9,1991,2000,11,7,CAN
Adam Parrish,1981-08-30,14,2005,2019,8,30,USA
Edward Stephen,1919-09-04,14,1941,1955,9,4,USA
Michael Richard,1952-05-15,12,1973,1985,5,15,USA
Charles C.,1849-10-14,8,1875,1883,10,14,USA
Wilbur Donald,1963-02-22,0,1991,1991,2,22,USA
William Sumner,1941-05-24,0,1964,1964,5,24,USA
Richard Cummings,1921-05-06,11,1941,1952,5,6,USA
Howard John,1884-04-02,2,1905,1907,4,2,USA
Timothy Stephen,1966-08-02,19,1992,2011,8,2,USA
Christopher Robert,1974-06-15,0,2001,2001,6,15,USA
Matthew Lovick,1969-10-02,10,1993,2003,10,2,USA
George Elvin,1896-07-27,14,1923,1937,7,27,USA
Edwin Joseph,1915-09-21,0,1945,1945,9,21,USA
Albert Charles,1892-02-22,0,1917,1917,2,22,USA
Thomas Fred,1890-06-25,0,1912,1912,6,25,USA
Jordan Craig,1987-11-16,5,2010,2015,11,16,USA
Marcus Walter,1988-09-13,1,2018,2019,9,13,USA
Mitchell S.,1992-09-10,1,2018,2019,9,10,USA
Irving J.,1872-01-21,0,1901,1901,1,21,USA
Steven Kyle,1985-10-27,1,2011,2012,10,27,USA
Kyle Michael,1991-11-26,1,2015,2016,11,26,USA
James,1962-05-02,6,1987,1993,5,2,USA
Robert Vernon,1956-11-26,13,1980,1993,11,26,USA
William Henry,1903-10-07,9,1927,1936,10,7,USA
Cleotha,1958-11-25,13,1980,1993,11,25,USA
Christian Dickson,1991-03-28,5,2014,2019,3,28,USA
William Curtis,1896-07-03,11,1919,1930,7,3,USA
Ewart Gladstone,1888-06-01,3,1909,1912,6,1,USA
Fred,1910-09-24,18,1931,1949,9,24,USA
Duane Allen,1957-03-13,6,1982,1988,3,13,USA
Edward Harrison,1874-08-11,1,1902,1903,8,11,United Kingdom
Ernest Robert,1890-09-17,2,1913,1915,9,17,USA
Moses Fleetwood,1856-10-07,0,1884,1884,10,7,USA
Charles Franklin,1894-09-22,8,1917,1925,9,22,USA
Gerald Holmes,1908-03-19,14,1931,1945,3,19,USA
Gregory Lee,1959-10-06,8,1982,1990,10,6,USA
Harry William,1918-09-22,15,1940,1955,9,22,USA
Harvey Willos,1906-08-17,14,1931,1945,8,17,USA
James Ross,1971-07-01,12,1997,2009,7,1,USA
Jerry Allen,1939-02-12,7,1957,1964,2,12,USA
Jeremy Price,1995-06-12,0,2019,2019,6,12,USA
John Miles,1896-12-11,2,1919,1921,12,11,USA
Kevin Michael,1976-09-20,5,2000,2005,9,20,USA
Larry Kenneth Robert,1966-12-01,16,1989,2005,12,1,CAN
James Luke,1943-09-02,9,1965,1974,9,2,USA
Martin Van Buren,1899-03-27,0,1928,1928,3,27,USA
Michael Charles,1966-10-04,8,1988,1996,10,4,USA
Michael Aaron,1965-06-23,0,1992,1992,6,23,USA
Frederick Mitchell,1884-03-21,5,1910,1915,3,21,USA
Neil Martin,1985-09-10,10,2009,2019,9,10,USA
Oscar,1854-03-18,10,1875,1885,3,18,USA
Peter Brian,1969-04-08,11,1995,2006,4,8,USA
James Roy,1893-04-13,10,1912,1922,4,13,USA
Albert Bluford,1926-05-16,10,1948,1958,5,16,USA
Joseph Richard,1898-01-23,0,1923,1923,1,23,USA
Taijuan Emmanuel,1992-08-13,6,2013,2019,8,13,USA
Clarence William,1887-09-04,12,1911,1923,9,4,USA
Thomas William,1881-08-01,3,1902,1905,8,1,USA
Robert Thomas,1948-11-07,5,1972,1977,11,7,USA
Anthony Bruce,1959-07-01,0,1986,1986,7,1,USA
Todd Arthur,1973-05-25,11,1996,2007,5,25,USA
Tyler Lanier,1976-05-15,8,2002,2010,5,15,USA
Walter S.,1860-03-12,0,1884,1884,3,12,USA
Welday Wilberforce,1860-07-27,0,1884,1884,7,27,USA
James Huey,1895-11-03,0,1927,1927,11,3,USA
James Elton,1909-12-14,5,1934,1939,12,14,USA
Roderick John,1873-11-04,24,1894,1918,11,4,USA
Brett Alexander,1986-08-26,6,2010,2016,8,26,USA
Chad Arthur,1991-11-04,2,2017,2019,11,4,USA
David William,1947-09-07,5,1973,1978,9,7,USA
Derek Robert,1971-09-01,3,1996,1999,9,1,USA
Frederick Renshaw,1893-09-20,0,1919,1919,9,20,USA
Donald Allen,1940-08-25,0,1967,1967,8,25,USA
Harry Clinton,1882-07-27,0,1912,1912,7,27,USA
Clarence Eugene,1890-08-06,0,1915,1915,8,6,USA
John,1919-08-31,8,1940,1948,8,31,USA
Jeffrey Allen,1976-04-12,4,1997,2001,4,12,USA
James Leo,1881-11-14,0,1905,1905,11,14,USA
James Harold,1921-08-12,4,1942,1946,8,12,USA
Michael Sherman,1951-02-03,4,1973,1977,2,3,USA
Timothy Charles,1957-09-14,16,1980,1996,9,14,USA
Donnell Lee,1967-07-11,7,1995,2002,7,11,USA
Norman Edward,1918-02-13,0,1945,1945,2,13,USA
John Francis,1883-06-16,0,1909,1909,6,16,USA
Elliott Tyrone,1957-03-14,7,1980,1987,3,14,USA
Dennis Martin,1954-04-17,17,1975,1992,4,17,USA
Harold Joseph,1952-01-09,4,1975,1979,1,9,USA
Joseph Francis,1873-07-24,1,1901,1902,7,24,USA
Joshua Michael,1987-01-21,2,2012,2014,1,21,USA
Murray Wesley,1926-09-19,9,1950,1959,9,19,USA
Ray Lee,1933-01-06,12,1952,1964,1,6,USA
Stanley Arthur,1951-06-16,2,1975,1977,6,16,USA
Leslie Dale,1976-11-07,5,2003,2008,11,7,USA
Austin Edward,1891-09-01,0,1914,1914,9,1,USA
August Sothley,1904-08-17,1,1927,1928,8,17,USA
Cornelius Robert,1882-04-23,0,1907,1907,4,23,USA
Colin Patrick,1989-09-26,0,2016,2016,9,26,USA
David Peter,1960-09-25,0,1990,1990,9,25,USA
Leo Thomas,1890-03-28,2,1913,1915,3,28,USA
Edward Augustine,1881-05-14,13,1904,1917,5,14,USA
Edward Arthur,1905-02-11,4,1928,1932,2,11,USA
Jared James,1993-07-30,0,2019,2019,7,30,USA
Michael Timothy,1886-03-25,5,1910,1915,3,25,USA
James Charles,1887-08-24,5,1912,1917,8,24,Ireland
James Thomas,1894-07-10,0,1921,1921,7,10,USA
Joseph R.,1864-11-05,0,1891,1891,11,5,USA
John Gabriel,1879-03-25,0,1903,1903,3,25,USA
Joseph Francis,1886-10-14,1,1910,1911,10,14,USA
Joseph Patrick,1917-03-13,0,1938,1938,3,13,USA
James Gerald,1919-03-07,5,1946,1951,3,7,USA
Michael John,1850-04-29,NA,NA,NA,4,29,Ireland
Thomas Joseph,1885-02-28,0,1906,1906,2,28,USA
Walter William,1897-04-30,0,1920,1920,4,30,USA
James Bernard,1908-08-15,0,1930,1930,8,15,USA
William Henry,1909-04-19,19,1931,1950,4,19,USA
Charles Leonard,1947-02-21,0,1969,1969,2,21,USA
Daniel Gene,1966-08-15,1,1992,1993,8,15,USA
Fred James,1912-09-04,0,1945,1945,9,4,USA
Gene Winston,1960-11-22,3,1985,1988,11,22,USA
Kenneth Rogers,1933-11-11,3,1960,1963,11,11,USA
Michael Charles,1957-10-18,1,1983,1984,10,18,USA
Phillip DeWayne,1985-03-12,4,2009,2013,3,12,USA
Alfred John,1892-11-05,10,1915,1925,11,5,USA
Zachary Butler,1989-09-05,3,2013,2016,9,5,USA
Bruce Kenneth,1962-12-25,3,1991,1994,12,25,USA
Daniel James,1947-07-14,12,1968,1980,7,14,USA
Donovan R.,1994-05-25,0,2019,2019,5,25,USA
Jerome O'Terrell,1965-07-08,9,1989,1998,7,8,USA
Reginald Sherard,1952-10-24,2,1980,1982,10,24,USA
John William,1860-01-12,NA,NA,NA,1,12,USA
William Adolph,1894-03-19,12,1914,1926,3,19,USA
Lloyd James,1906-03-16,18,1927,1945,3,16,USA
Paul Glee,1903-04-16,19,1926,1945,4,16,USA
Chien-Ming,1980-03-31,11,2005,2016,3,31,Taiwan
Wei-Chung,1992-04-25,5,2014,2019,4,25,Taiwan
Clarence Curtis,1885-11-29,0,1909,1909,11,29,USA
Paul Louis,1902-12-12,2,1925,1927,12,12,USA
Richard Carter,1940-04-11,0,1965,1965,4,11,USA
Steven Lee,1965-09-25,1,1990,1991,9,25,USA
Aaron Lee,1896-08-28,11,1917,1928,8,28,USA
Bryan Matthew,1972-01-28,2,1998,2000,1,28,USA
Charles William,1894-07-30,5,1917,1922,7,30,USA
Chris Gilbert,1949-05-18,2,1972,1974,5,18,USA
Colin Norval,1960-11-22,0,1985,1985,11,22,USA
Robert Colby,1964-01-02,0,1990,1990,1,2,USA
Daryle Lamar,1975-06-27,10,1998,2008,6,27,USA
Richard O.,1909-05-21,1,1934,1935,5,21,USA
Roy Duane,1964-05-28,9,1986,1995,5,28,USA
Jonathan Edgar,1946-10-01,0,1968,1968,10,1,USA
Gary Lamell,1953-12-06,11,1979,1990,12,6,USA
Joseph Nichols,1885-11-15,0,1912,1912,11,15,USA
John Francis,1938-09-09,7,1963,1970,9,9,USA
James H. H.,1855-03-02,0,1876,1876,3,2,USA
John Montgomery,1860-03-03,16,1878,1894,3,3,USA
Joseph Aloysius,1884-09-02,4,1906,1910,9,2,USA
Kevin Michael,1961-09-28,1,1991,1992,9,28,USA
Curtis Ray,1960-11-16,1,1984,1985,11,16,USA
Peter Thomas,1937-07-26,8,1962,1970,7,26,CAN
Frank Gray,1867-04-16,11,1883,1894,4,16,USA
Preston Meyer,1927-07-24,11,1948,1959,7,24,USA
John Andrew,1879-02-06,0,1902,1902,2,6,USA
Joseph Taylor,1993-12-14,1,2018,2019,12,14,USA
Turner Max,1965-04-11,11,1990,2001,4,11,USA
Jeffrey Allan,1970-11-11,1,1995,1996,11,11,USA
Clyde Ellsworth,1886-05-23,1,1913,1914,5,23,USA
John Milton,1884-07-04,7,1908,1915,7,4,USA
Wallace Walter,1893-02-02,7,1916,1923,2,2,USA
Edward Emory,1889-06-20,0,1912,1912,6,20,USA
Frederick John Rodney,1855-01-07,9,1875,1884,1,7,USA
Hoke Hayden,1894-05-22,5,1916,1921,5,22,USA
John Ralph,1903-08-29,8,1925,1933,8,29,USA
Jack Dyer,1940-07-12,3,1962,1965,7,12,USA
John Joseph,1943-08-01,0,1966,1966,8,1,USA
John Joseph,1872-08-15,13,1895,1908,8,15,USA
Lonnie,1909-03-28,15,1930,1945,3,28,USA
Harold Charles,1912-01-06,0,1935,1935,1,6,USA
Adam Parrish,1987-08-25,7,2012,2019,8,25,USA
Arthur Frank,1993-03-23,0,2019,2019,3,23,USA
Bennie Louis,1912-03-02,8,1939,1947,3,2,USA
William Hackney,1884-02-11,1,1914,1915,2,11,USA
Michael Bruce,1961-03-26,2,1983,1985,3,26,USA
Thomas Gentry,1917-07-05,0,1944,1944,7,5,USA
Harold Burton,1903-09-13,10,1930,1940,9,13,USA
Daniel Dean,1952-12-01,3,1975,1978,12,1,USA
Firman Newton,1897-11-26,5,1921,1926,11,26,USA
Carl Wayne,1937-02-27,5,1961,1966,2,27,USA
James Charles,1914-05-15,10,1937,1947,5,15,USA
John Truman,1972-08-05,12,1995,2007,8,5,USA
Lincoln William,1911-01-30,0,1937,1937,1,30,USA
George Edward,1914-10-06,0,1941,1941,10,6,USA
Gregory James,1946-12-03,0,1969,1969,12,3,USA
Jarrod Michael,1974-08-13,11,1998,2009,8,13,USA
Libeus,1874-06-16,1,1902,1903,6,16,USA
Ray Clark,1938-05-31,9,1961,1970,5,31,USA
William,1882-10-11,0,1905,1905,10,11,USA
Claudell,1954-08-31,16,1974,1990,8,31,USA
David Edward,1990-11-20,0,2017,2017,11,20,USA
Sloan Vernon,1907-06-04,1,1935,1936,6,4,USA
Herbert Lee,1951-11-16,1,1974,1975,11,16,USA
LaRue,1953-09-07,1,1978,1979,9,7,USA
Enrico Aliceno,1978-05-30,0,2008,2008,5,30,USA
Ronald,1952-04-29,12,1977,1989,4,29,USA
U. L.,1953-10-27,10,1977,1987,10,27,USA
Mark Thomas,1961-08-04,2,1986,1988,8,4,USA
Gary Lee,1941-07-21,5,1967,1972,7,21,USA
Ehren Josef,1980-12-06,1,2007,2008,12,6,USA
Robert Michael,1970-08-24,0,2000,2000,8,24,USA
Christopher Myron,1980-08-17,1,2008,2009,8,17,USA
Fred Warren,1927-02-02,1,1955,1956,2,2,USA
Steven Craig,1952-04-06,0,1976,1976,4,6,USA
Dustin James,1973-08-22,0,2002,2002,8,22,USA
John David,1949-10-04,9,1976,1985,10,4,USA
William Henry,1858-05-05,0,1884,1884,5,5,CAN
Robert Cecil,1948-03-12,0,1969,1969,3,12,USA
David Roger,1944-03-15,0,1969,1969,3,15,USA
James Edward,1877-06-21,0,1902,1902,6,21,USA
George Archibald,1900-06-04,6,1930,1936,6,4,USA
Harvey Lennox,1869-06-14,NA,NA,NA,6,14,USA
Vincent Logan,1989-08-29,1,2013,2014,8,29,USA
William Patrick,1972-09-02,2,1997,1999,9,2,USA
Scott Allen,1970-05-15,0,1995,1995,5,15,USA
Stephen Douglas,1978-07-19,0,2004,2004,7,19,USA
Thomas Gray,1980-06-18,0,2007,2007,6,18,USA
Julius Neal,1922-12-25,0,1953,1953,12,25,USA
Allen Kenneth,1970-11-18,7,1993,2000,11,18,USA
Arthur Stanhope,1884-01-11,1,1914,1915,1,11,USA
Robert Jose,1946-04-10,18,1966,1984,4,10,USA
Brandon Eric,1981-09-30,2,2005,2007,9,30,USA
Charles John,1885-01-30,2,1913,1915,1,30,USA
John Thomas,1908-01-16,0,1930,1930,1,16,USA
Mark Bradford,1974-01-23,3,2000,2003,1,23,USA
Matthew Kyle,1978-09-05,7,2003,2010,9,5,USA
Milton Robert,1890-01-10,3,1916,1919,1,10,USA
Walter L.,1865-01-27,0,1887,1887,1,27,USA
John Reaves,1896-10-15,6,1918,1924,10,15,USA
Anthony Michael,1985-05-30,8,2011,2019,5,30,USA
Albert Bailey,1899-12-12,0,1920,1920,12,12,USA
Eddie Dean,1941-04-04,9,1966,1975,4,4,USA
Frank Marion,1902-12-15,0,1931,1931,12,15,USA
John Clifford,1905-08-17,10,1929,1939,8,17,USA
James Elden,1933-11-25,1,1952,1953,11,25,USA
Robert Clinton,1906-04-02,0,1927,1927,4,2,USA
Frank,1898-08-27,0,1924,1924,8,27,USA
Gary Anthony,1962-11-30,5,1989,1994,11,30,USA
Justin Morgan,1979-04-16,2,2002,2004,4,16,USA
Kenneth Albert,1913-02-06,0,1936,1936,2,6,USA
John David,1969-09-25,18,1991,2009,9,25,USA
Cyril Roy,1915-02-25,14,1936,1950,2,25,USA
Arthur Coggshall,1879-04-07,6,1902,1908,4,7,USA
George Daniel,1890-08-18,8,1912,1920,8,18,USA
Earl Sidney,1930-08-14,NA,NA,NA,8,14,USA
James Eric,1973-08-04,2,1998,2000,8,4,USA
William B.,1865-03-23,6,1888,1894,3,23,USA
David Floyd,1941-05-12,9,1962,1971,5,12,USA
Harry Abraham,1892-02-26,4,1915,1919,2,26,USA
Jeffrey Charles,1976-08-22,11,1999,2010,8,22,USA
Jered David,1982-10-04,11,2006,2017,10,4,USA
James Dement,1903-11-25,11,1928,1939,11,25,USA
James Brian,1939-02-19,1,1967,1968,2,19,USA
James Francis,1959-10-10,4,1985,1989,10,10,USA
Luke Allen,1993-08-21,3,2016,2019,8,21,USA
Montie Morton,1906-06-15,8,1931,1939,6,15,USA
Orville Forest,1886-06-04,1,1910,1911,6,4,USA
Roger Edward,1954-10-06,0,1980,1980,10,6,USA
Samuel H.,1855-07-20,11,1875,1886,7,20,USA
William Joseph,1895-06-25,0,1917,1917,6,25,USA
Willie Fred,1913-12-12,0,1943,1943,12,12,USA
Brandon Tyler,1979-05-09,6,2003,2009,5,9,USA
Robert Wyatt McDaniel,1989-08-18,3,2013,2016,8,18,USA
William Earl,1897-09-17,8,1925,1933,9,17,USA
Lester Elmer,1915-05-06,6,1942,1948,5,6,USA
Henry Gaylon Matthew,1950-05-21,5,1972,1977,5,21,USA
Jacob Lawrence,1993-08-15,0,2019,2019,8,15,USA
John Floyd,1979-05-23,1,2004,2005,5,23,USA
Cleon Earl,1885-03-01,0,1910,1910,3,1,USA
Logan T.,1996-11-18,0,2019,2019,11,18,USA
Samuel Henry,1924-09-25,1,1948,1949,9,25,USA
Ryan Christopher,1986-02-05,7,2009,2016,2,5,USA
James Laverne,1909-11-04,16,1932,1948,11,4,USA
Jon Tyler,1990-07-20,2,2017,2019,7,20,USA
Benjamin Edward,1969-11-17,5,2000,2005,11,17,USA
Charles P.,1868-10-22,0,1898,1898,10,22,USA
Henry J.,1862-02-12,0,1884,1884,2,12,USA
Joseph Edward,1862-02-15,0,1884,1884,2,15,CAN
Neil Aaron,1972-12-06,0,1998,1998,12,6,USA
James Ryan,1990-08-12,4,2015,2019,8,12,USA
Thad G.,1984-09-28,1,2012,2013,9,28,USA
Carl Allen,1990-02-10,6,2013,2019,2,10,USA
Leonard Irell,1965-02-10,11,1989,2000,2,10,USA
Mitchell Dean,1959-05-16,12,1983,1995,5,16,USA
Raymond George,1937-11-15,1,1959,1960,11,15,USA
Ramon Alberto,1942-08-31,4,1967,1971,8,31,Panama
Peter,1864-08-30,1,1889,1890,8,30,USA
Eric Michael,1968-01-27,3,1991,1994,1,27,USA
Charles Albert,1882-12-21,0,1911,1911,12,21,USA
John,1937-06-14,2,1962,1964,6,14,USA
Jemile Nykiwa,1987-01-26,5,2011,2016,1,26,USA
Rickie Darnell,1982-09-13,14,2003,2017,9,13,USA
Michael Denis,1946-10-08,1,1969,1970,10,8,USA
William Edward,1962-12-19,10,1985,1995,12,19,USA
Wilbur,1906-11-23,1,1930,1931,11,23,USA
Herman Ralph,1927-02-18,13,1945,1958,2,18,USA
John Paul,1967-06-29,10,1991,2001,6,29,USA
David Thomas,1952-11-09,9,1976,1985,11,9,USA
Ralph Richard,1921-10-02,3,1946,1949,10,2,USA
John Garibaldi,1862-11-13,1,1883,1884,11,13,USA
Richard Henry,1927-11-17,6,1948,1954,11,17,USA
Robert George,1905-12-14,12,1928,1940,12,14,USA
Edwin Nicholas,1914-11-26,2,1940,1942,11,26,USA
Kyle Edward,1986-09-12,1,2011,2012,9,12,USA
Carl Edward,1889-11-29,8,1912,1920,11,29,USA
Jacob,1873-11-29,6,1903,1909,11,29,USA
Philip Walter,1902-04-21,12,1919,1931,4,21,USA
Elmer William,1918-08-13,0,1945,1945,8,13,USA
Robert D.,1985-12-08,1,2010,2011,12,8,USA
Philip,1907-10-12,12,1933,1945,10,12,USA
William Franklin,1911-02-25,3,1936,1939,2,25,USA
Albert John,1938-04-02,9,1962,1971,4,2,USA
Arthur John,1901-03-02,3,1922,1925,3,2,USA
Harry Budson,1891-01-08,1,1915,1916,1,8,USA
Gary Lee,1955-12-27,1,1980,1981,12,27,USA
George,1894-06-23,NA,NA,NA,6,23,USA
Joseph Harold,1894-01-27,0,1915,1915,1,27,USA
Walter William,1963-11-28,13,1987,2000,11,28,USA
Zachary D.,1992-06-16,0,2018,2018,6,16,USA
John Ludwig,1914-05-27,4,1939,1943,5,27,USA
Robert Lynn,1956-11-03,16,1978,1994,11,3,USA
Curtis Benton,1862-02-10,9,1884,1893,2,10,USA
Donald Ray,1957-02-03,1,1982,1983,2,3,USA
Frank Tiguer,1897-08-10,8,1919,1927,8,10,USA
Harry Monroe,1883-11-20,0,1911,1911,11,20,USA
Herbert,1898-10-19,0,1925,1925,10,19,USA
John Vernon,1906-12-02,10,1926,1936,12,2,USA
Michael Francis,1859-07-04,12,1880,1892,7,4,USA
Milton Edward,1924-07-26,0,1945,1945,7,26,USA
Michael Paul,1972-08-25,0,1998,1998,8,25,USA
Floyd John,1892-10-17,0,1914,1914,10,17,USA
James Thomas,1866-07-23,5,1890,1895,7,23,USA
Lyndon Earl,1878-12-13,2,1907,1909,12,13,USA
Oliver Henry,1889-01-17,0,1916,1916,1,17,USA
Matthew Scott,1986-02-10,0,2013,2013,2,10,USA
Todd Allen,1978-08-30,7,2003,2010,8,30,USA
Robert Joseph,1925-07-15,2,1948,1950,7,15,USA
Brad Eugene,1959-08-17,7,1982,1989,8,17,USA
Robert Lee,1966-11-01,8,1994,2002,11,1,USA
Casper Charles,1984-11-23,3,2010,2013,11,23,USA
David Lee,1963-05-20,20,1987,2007,5,20,USA
Edwin Lee,1900-06-07,11,1923,1934,6,7,USA
Gregory DeWayne,1954-04-25,1,1981,1982,4,25,USA
Jacob,1863-08-09,2,1888,1890,8,9,USA
Jared Linn,1981-10-31,0,2008,2008,10,31,USA
John Frederick,1922-11-25,0,1944,1944,11,25,USA
Robert Kip,1977-04-21,13,1999,2012,4,21,USA
Leo Donald,1917-07-18,4,1942,1946,7,18,USA
Randy David,1982-08-28,4,2008,2012,8,28,USA
Terry,1963-09-10,0,1990,1990,9,10,USA
Vernon M.,1978-12-08,14,1999,2013,12,8,USA
Willie James,1905-08-10,NA,NA,NA,8,10,USA
Christopher Charles,1955-04-14,5,1981,1986,4,14,USA
James Daniel,1902-10-09,5,1925,1930,10,9,USA
Richard John,1927-08-03,2,1948,1950,8,3,USA
Anton Frank,1899-04-05,1,1926,1927,4,5,Germany
Jeffrey Benjamin,1993-03-24,3,2016,2019,3,24,USA
Lewis Charles,1892-03-22,11,1915,1926,3,22,USA
Steven John,1967-05-19,11,1993,2004,5,19,USA
Joseph Patrick,1990-04-26,3,2016,2019,4,26,USA
Donald Paul,1969-11-06,6,1995,2001,11,6,USA
Charles William,1915-12-03,5,1943,1948,12,3,USA
John George,1863-03-04,0,1891,1891,3,4,USA
Stanley Aaron,1917-01-13,0,1945,1945,1,13,USA
Frederick Charles,1941-08-26,2,1968,1970,8,26,USA
Julian Valentine,1902-02-09,2,1927,1929,2,9,USA
William Murray,1908-06-20,12,1930,1942,6,20,USA
Perry Wherritt,1861-07-21,13,1884,1897,7,21,USA
John Charles,1938-02-07,3,1964,1967,2,7,USA
William George,1920-12-21,5,1949,1954,12,21,USA
George William,1938-09-08,0,1956,1956,9,8,USA
Andrew Steven,1987-02-25,0,2012,2012,2,25,USA
Donald Paul,1953-03-08,7,1975,1982,3,8,USA
Joseph Abraham,1861-10-25,4,1884,1888,10,25,USA
Donald Ralph,1938-07-29,8,1963,1971,7,29,USA
Dennis Dean,1952-12-29,3,1979,1982,12,29,USA
Jayson Richard Gowan,1979-05-20,15,2002,2017,5,20,USA
Henry Levi,1898-04-20,3,1926,1929,4,20,USA
William Charles,1967-01-15,1,1993,1994,1,15,USA
Dwight Lyman Moody,1888-10-11,0,1914,1914,10,11,USA
Victor Woodrow,1925-02-09,16,1947,1963,2,9,USA
James Michael,1955-09-25,0,1979,1979,9,25,USA
Barry Jarvis,1977-04-06,1,2002,2003,4,6,USA
William O.,1853-08-15,2,1874,1876,8,15,USA
Jacob Cauthen,1977-09-29,13,2000,2013,9,29,USA
Milton Douglas,1860-08-29,6,1884,1890,8,29,USA
David Lee,1964-09-01,10,1988,1998,9,1,USA
Richard Thomas,1915-11-24,5,1938,1943,11,24,USA
Huyler,1869-10-01,0,1894,1894,10,1,USA
Oscar William,1882-07-08,0,1907,1907,7,8,USA
John Franklin,1873-01-21,0,1894,1894,1,21,USA
James Hiram,1884-08-08,6,1905,1911,8,8,USA
Weldon Edison,1915-09-03,1,1944,1945,9,3,USA
James Patrick,1930-07-03,0,1955,1955,7,3,USA
Waldon Thomas,1920-11-08,9,1947,1956,11,8,USA
Walter Maxwell,1904-07-14,1,1928,1929,7,14,USA
Max Edward,1916-11-28,10,1938,1948,11,28,USA
Matthew Robert O'Neil,1988-11-21,1,2014,2015,11,21,USA
Alfred John,1905-12-11,0,1929,1929,12,11,USA
Michael Lee,1961-03-26,4,1989,1993,3,26,USA
Wesley Noreen,1922-11-28,10,1947,1957,11,28,USA
Samuel Filmore,1904-10-05,15,1927,1942,10,5,USA
Sean Edward,1986-06-15,1,2009,2010,6,15,USA
Jeffrey Barret,1963-10-18,0,1989,1989,10,18,USA
John Karl,1966-08-21,11,1989,2000,8,21,USA
Charles Edward,1894-08-25,0,1927,1927,8,25,USA
Franklin Burton,1893-07-07,1,1920,1921,7,7,USA
Stefan Matthew,1958-04-22,0,1982,1982,4,22,Germany
August,1866-09-29,14,1887,1901,9,29,USA
John,1869-06-24,1,1888,1889,6,24,USA
William Carl,1896-02-10,0,1923,1923,2,10,USA
Robert D.,1994-01-31,2,2016,2018,1,31,USA
Albert James,1888-06-22,2,1913,1915,6,22,USA
Charles D.,1893-06-27,0,1912,1912,6,27,USA
Leroy William,1929-09-15,1,1954,1955,9,15,USA
McKinley Davis,1893-06-09,6,1915,1921,6,9,USA
Elwood Pierce,1914-10-03,1,1943,1944,10,3,USA
Zachariah Davis,1888-05-23,18,1909,1927,5,23,USA
Warren Henry,1864-08-06,4,1887,1891,8,6,USA
Daniel Michael,1977-12-10,13,1999,2012,12,10,USA
Richard,1898-01-14,0,1918,1918,1,14,USA
Donald Wesley,1922-09-29,0,1949,1949,9,29,USA
Edward Leroy,1878-06-15,0,1902,1902,6,15,USA
Edward Raymond,1915-05-24,0,1945,1945,5,24,USA
Gary Richard,1951-11-29,4,1976,1980,11,29,USA
George Louis,1869-07-30,3,1896,1899,7,30,USA
George Harrison,1881-11-10,0,1910,1910,11,10,USA
Harry Eugene,1858-03-03,6,1878,1884,3,3,USA
Jason McDonald,1990-10-27,0,2017,2017,10,27,USA
Floyd Clark,1898-03-02,3,1921,1924,3,2,USA
Ryan Gerard,1988-07-10,2,2012,2014,7,10,USA
Zachary Harrison,1990-05-30,6,2013,2019,5,30,USA
Zelous Lamar,1987-01-16,0,2014,2014,1,16,USA
James Francis,1890-05-11,0,1913,1913,5,11,USA
Kevin Joseph,1984-01-08,3,2011,2014,1,8,USA
Thomas Joseph,1894-01-03,0,1920,1920,1,3,USA
Jack Franklin,1942-11-04,0,1971,1971,11,4,USA
Larry,1956-07-03,5,1977,1982,7,3,USA
Matthew Michael,1971-06-08,3,1997,2000,6,8,USA
Thomas Peter,1929-12-14,9,1952,1961,12,14,USA
Wesley Guy,1983-04-07,0,2009,2009,4,7,USA
Lewis W.,1868-03-10,3,1890,1893,3,10,USA
Louis Rodman,1957-05-12,18,1977,1995,5,12,USA
William H.,1865-12-06,1,1888,1889,12,6,USA
Stephen Edward,1943-05-07,4,1966,1970,5,7,USA
William Edward,1943-07-29,0,1964,1964,7,29,USA
Robert Arthur,1917-04-29,0,1945,1945,4,29,USA
Adel,1904-05-16,0,1937,1937,5,16,USA
Alex Bruce,1988-08-29,1,2011,2012,8,29,USA
William Barney,1923-06-25,0,1945,1945,6,25,USA
William Dighton,1860-05-01,5,1883,1888,5,1,USA
William DeKova,1934-01-28,13,1956,1969,1,28,USA
William Cowart,1978-11-20,1,2007,2008,11,20,USA
Burgess Urquhart,1910-06-29,13,1933,1946,6,29,USA
Charles Evis,1894-01-25,5,1914,1919,1,25,USA
Charles,1927-08-12,1,1954,1955,8,12,USA
James Laurie,1847-12-02,19,1871,1890,12,2,USA
George Frederick,1872-09-08,0,1895,1895,9,8,USA
Devon Markes,1962-12-29,16,1985,2001,12,29,Jamaica
Derrick Ramon,1969-10-12,5,1993,1998,10,12,USA
Guy Harris,1879-04-09,12,1901,1913,4,9,USA
Donald William,1919-01-08,1,1948,1949,1,8,USA
Earl Oliver,1899-02-07,16,1923,1939,2,7,USA
Edward Perry,1926-04-06,0,1955,1955,4,6,USA
Edward Morris,1964-02-09,0,1989,1989,2,9,USA
Willard Elmer,1849-12-07,0,1871,1871,12,7,USA
Elder Lafayette,1933-12-23,0,1962,1962,12,23,USA
Dustin Eli,1979-10-22,9,2005,2014,10,22,USA
Ernest Daniel,1916-09-05,8,1940,1948,9,5,USA
Frank,1950-09-04,17,1973,1990,9,4,USA
Albert Eugene,1916-06-27,7,1940,1947,6,27,USA
Gabriel Allen,1971-11-20,11,1994,2005,11,20,USA
George,1882-12-23,11,1907,1918,12,23,USA
Gilbert Arthur,1893-10-15,3,1912,1915,10,15,USA
Guerdon W.,1859-10-05,1,1884,1885,10,5,USA
Harold George,1919-03-18,13,1941,1954,3,18,USA
John Wallace,1878-01-19,0,1904,1904,1,19,USA
John Peter,1905-08-31,1,1927,1928,8,31,USA
Jerome Cardell,1952-08-23,12,1974,1986,8,23,USA
Joyner Clifford,1909-06-01,12,1932,1944,6,1,USA
John Henderson,1909-04-27,7,1935,1942,4,27,USA
Joshua S.,1982-04-14,1,2008,2009,4,14,USA
Oliver Kirby,1884-01-03,2,1909,1911,1,3,USA
Larry David,1958-09-24,1,1983,1984,9,24,USA
Leonard Joseph,1957-09-10,4,1981,1985,9,10,USA
Mark Anthony,1966-11-25,10,1990,2000,11,25,USA
Matthew Christopher,1967-08-08,13,1992,2005,8,8,USA
Matthew Joseph,1977-08-19,2,2003,2005,8,19,USA
Joyner Michael,1938-12-18,2,1963,1965,12,18,USA
Myron Alan,1957-08-01,0,1978,1978,8,1,USA
Richard Allen,1968-12-23,13,1994,2007,12,23,USA
Roy Hilton,1943-12-27,14,1965,1979,12,27,USA
Rondell Bernard,1972-02-23,14,1993,2007,2,23,USA
Samuel Lambeth,1893-08-23,0,1919,1919,8,23,United Kingdom
Sammy Charles,1927-07-07,11,1951,1962,7,7,USA
David Sean,1971-04-19,0,1995,1995,4,19,USA
Sean Thomas,1981-04-25,3,2007,2010,4,25,USA
King Solomon,1868-06-12,NA,NA,NA,6,12,USA
Stephen Vincent,1884-12-21,0,1912,1912,12,21,USA
Brian Tyler,1990-10-29,3,2016,2019,10,29,USA
Walter Richard,1964-04-11,7,1989,1996,4,11,USA
William Henry,1854-10-11,9,1877,1886,10,11,USA
Fred Dwight,1938-01-07,8,1962,1970,1,7,USA
Terry Bertland,1953-01-12,12,1974,1986,1,12,USA
Jesse Way,1879-05-30,5,1902,1907,5,30,USA
Chase Coleman,1989-06-14,4,2014,2018,6,14,USA
Daniel Charles,1955-11-23,1,1980,1981,11,23,USA
Darrell Lamont,1968-11-18,2,1993,1995,11,18,USA
Dick Corwin,1920-11-09,5,1946,1951,11,9,USA
Walter Franklin,1924-08-15,2,1946,1948,8,15,USA
Arthur Wilson,1858-01-16,11,1880,1891,1,16,USA
Frank Thomas,1856-02-18,0,1876,1876,2,18,USA
James Evans,1857-11-10,9,1881,1890,11,10,USA
Arthur Carter,1905-01-02,11,1928,1939,1,2,USA
William Franklin,1870-03-04,6,1890,1896,3,4,USA
Eddie Lee,1955-05-19,14,1977,1991,5,19,USA
Leo Ernest,1952-06-13,15,1976,1991,6,13,USA
George Bostic,1890-02-04,10,1912,1922,2,4,USA
Walter Elton,1894-06-11,0,1916,1916,6,11,USA
Kevin Dean,1965-01-04,7,1989,1996,1,4,USA
Robert Kitridge,1877-05-25,5,1901,1906,5,25,USA
David Clifford,1935-09-27,9,1960,1969,9,27,USA
Floyd Euliss,1943-09-12,3,1968,1971,9,12,USA
Kemp Caswell,1906-08-13,5,1936,1941,8,13,USA
Albert,1888-01-27,6,1913,1919,1,27,USA
Robert Joe,1969-02-06,15,1992,2007,2,6,USA
Rowan D.,1992-11-09,1,2018,2019,11,9,CAN
Christopher Jon,1971-05-21,11,1995,2006,5,21,USA
Albert Joseph,1925-03-20,5,1947,1952,3,20,USA
William Waterfield,1867-06-03,4,1887,1891,6,3,USA
Franklin Delano Roosevelt,1933-04-04,2,1958,1960,4,4,USA
Bradley Michael,1991-10-14,1,2018,2019,10,14,USA
Charles John,1914-01-31,0,1934,1934,1,31,USA
Thomas John,1958-11-05,0,1979,1979,11,5,USA
George Edward,1861-02-17,8,1880,1888,2,17,USA
Thomas Robert,1957-02-01,3,1981,1984,2,1,USA
Joseph Andrew,1990-01-21,4,2012,2016,1,21,USA
John,1894-03-10,0,1921,1921,3,10,USA
Robert George,1930-08-13,7,1951,1958,8,13,USA
Matthew Richard,1986-05-21,10,2009,2019,5,21,USA
William Frederick,1919-03-15,8,1939,1947,3,15,USA
Alan Anthony,1958-02-17,6,1981,1987,2,17,USA
Scott Joseph,1976-03-24,0,2002,2002,3,24,USA
Ty Allen,1977-10-11,11,2002,2013,10,11,USA
James Alvin,1876-09-01,3,1903,1906,9,1,Norway
William Robert,1922-04-12,12,1946,1958,4,12,USA
Fred Thomas,1897-12-16,0,1923,1923,12,16,USA
Alexander Ames,1955-06-01,3,1979,1982,6,1,USA
Delbert Quentin,1919-02-24,8,1946,1954,2,24,USA
Claude Edward,1912-09-01,0,1940,1940,9,1,USA
Thaddeaus Inglehart,1958-12-16,1,1979,1980,12,16,USA
Milton Edward,1950-04-20,16,1970,1986,4,20,USA
Randall E.,1951-09-10,0,1977,1977,9,10,USA
Joseph,1857-03-14,0,1884,1884,3,14,USA
Mark Eugene,1948-02-28,3,1975,1978,2,28,USA
Robert Daniel,1953-09-01,10,1977,1987,9,1,USA
Harry Lester,1874-04-07,0,1899,1899,4,7,USA
James Hoyt,1922-07-26,20,1952,1972,7,26,USA
James Webster,1952-09-20,1,1978,1979,9,20,USA
Irvin Key,1877-01-26,18,1903,1921,1,26,USA
Charles Ernest,1929-05-23,0,1953,1953,5,23,USA
Thomas Mark,1983-12-16,6,2011,2017,12,16,USA
Joseph William,1885-12-20,3,1916,1919,12,20,USA
Dennis Ernest,1890-09-22,4,1911,1915,9,22,USA
Adam Robert,1987-12-09,6,2011,2017,12,9,USA
Aaron Daniel,1989-05-24,2,2017,2019,5,24,USA
Stephen Bradley,1977-06-01,7,2001,2008,6,1,USA
Curtis Vernon,1961-04-26,10,1983,1993,4,26,USA
Henry Joseph,1900-12-14,0,1927,1927,12,14,USA
Stephen Beaty,1992-01-11,1,2018,2019,1,11,USA
Andrew Robert,1988-09-13,2,2014,2016,9,13,USA
William Carl,1964-08-10,3,1985,1988,8,10,USA
Robert Linwood,1922-08-11,1,1944,1945,8,11,USA
Dean Allan,1966-08-24,2,1989,1991,8,24,USA
Edward Henry,1890-06-20,0,1911,1911,6,20,USA
Eric Lamoine,1956-12-09,0,1979,1979,12,9,USA
James Leslie,1878-05-14,NA,NA,NA,5,14,USA
Aldon Jay,1914-10-30,5,1941,1946,10,30,CAN
Marc Allen,1970-10-21,5,1996,2001,10,21,USA
Richard David,1967-06-04,10,1991,2001,6,4,USA
Roy Hamilton,1893-05-08,4,1918,1922,5,8,USA
Theodore,1915-11-13,9,1944,1953,11,13,USA
Gerald Duane,1960-03-14,10,1984,1994,3,14,USA
Robert Lee,1931-07-15,6,1957,1963,7,15,USA
Carlton Francis,1931-06-06,7,1958,1965,6,6,USA
Robert Edgar,1884-03-07,9,1906,1915,3,7,USA
Jon Nicholas,1941-01-27,4,1963,1967,1,27,USA
Robert Fulton,1917-03-18,6,1940,1946,3,18,USA
Silas Albert,1900-02-20,0,1928,1928,2,20,USA
Almon Edward,1914-05-11,1,1937,1938,5,11,USA
Albert Hamilton,1954-05-06,4,1980,1984,5,6,Nicaragua
Anthony Joseph,1973-07-18,0,1997,1997,7,18,USA
Arthur Frank,1877-08-24,0,1902,1902,8,24,USA
Austen Thomas,1992-12-19,1,2018,2019,12,19,USA
Bernard,1948-10-08,4,1970,1974,10,8,USA
Bernabe,1968-09-13,15,1991,2006,9,13,P.R.
Billy Leo,1938-06-15,17,1959,1976,6,15,USA
William,1932-06-13,0,1969,1969,6,13,USA
Robert Elias,1884-04-27,2,1911,1913,4,27,USA
Brian O'Neal,1969-02-15,9,1991,2000,2,15,USA
Carl Blake,1960-12-28,11,1984,1995,12,28,USA
Charles Prosek,1947-10-11,7,1971,1978,10,11,USA
Fred,1887-12-21,18,1912,1930,12,21,USA
Elisha Alphonso,1855-10-06,0,1876,1876,10,6,USA
David Owen,1881-02-07,0,1902,1902,2,7,USA
David Carlous,1927-11-02,6,1949,1955,11,2,USA
Dale Jerome,1938-05-29,0,1963,1963,5,29,USA
Dallas McKinley,1958-02-28,2,1981,1983,2,28,USA
Dana Lamont,1963-03-20,0,1989,1989,3,20,USA
David Aaron,1979-03-12,6,2001,2007,3,12,USA
Evon Daniel,1896-12-13,7,1921,1928,12,13,USA
Dewey Edgar,1916-02-05,4,1944,1948,2,5,USA
Devin T.,1994-09-21,0,2019,2019,9,21,USA
Edwin Dibrell,1910-01-19,5,1930,1935,1,19,USA
Richard Hirschfeld,1929-05-07,13,1951,1964,5,7,USA
Don Fred,1931-09-14,4,1958,1962,9,14,USA
Donald Reid,1935-09-02,0,1963,1963,9,2,USA
Dontrelle Wayne,1982-01-12,8,2003,2011,1,12,USA
Earl Baxter,1903-01-27,0,1928,1928,1,27,USA
Earl Craig,1948-07-14,7,1970,1977,7,14,USA
Edward Laquan,1964-11-01,12,1986,1998,11,1,USA
Frank Lee,1958-02-13,5,1984,1989,2,13,USA
George,1939-10-23,3,1961,1964,10,23,USA
Gerald Floyd,1966-08-10,13,1992,2005,8,10,USA
George Erik,1969-04-22,5,1995,2000,4,22,USA
Glenn David,1977-07-18,0,2005,2005,7,18,Australia
August Joseph,1888-05-07,4,1911,1915,5,7,USA
Harry Peter,1890-06-23,1,1913,1914,6,23,USA
Nathaniel Howard,1904-12-23,0,1928,1928,12,23,USA
Thomas Hugh,1906-05-30,3,1930,1933,5,30,USA
Jackson Thomas,1986-05-14,1,2014,2015,5,14,USA
Jeffrey F.,1972-06-06,3,1999,2002,6,6,Australia
Jerome Lee,1981-12-04,13,2003,2016,12,4,USA
James Thomas,1876-12-20,10,1899,1909,12,20,USA
James Gladden,1927-03-20,1,1953,1954,3,20,USA
James Francis,1943-10-04,1,1966,1967,10,4,USA
James Alfred,1947-04-29,1,1969,1970,4,29,USA
James Andrew,1847-01-04,NA,NA,NA,1,4,USA
Joseph Dank,1890-04-09,2,1911,1913,4,9,USA
John Brodie,1889-07-16,0,1914,1914,7,16,USA
Joshua David,1979-02-17,10,2004,2014,2,17,USA
Joseph,1885-04-06,NA,NA,NA,4,6,USA
Julius,1857-10-27,0,1882,1882,10,27,USA
Justin Paul,1995-08-20,0,2018,2018,8,20,USA
Kenneth Roy,1890-06-28,14,1915,1929,6,28,USA
Kenneth Royal,1964-04-06,5,1986,1991,4,6,USA
David Keith,1972-04-21,0,1996,1996,4,21,USA
Claude Preston,1893-03-09,7,1913,1920,3,9,USA
Charles William,1905-11-04,2,1925,1927,11,4,USA
Leon Theo,1905-12-02,0,1926,1926,12,2,USA
Lester Evans,1908-01-17,0,1947,1947,1,17,USA
Marshall McDiarmid,1893-02-21,0,1916,1916,2,21,USA
Mark Westley,1953-07-28,0,1977,1977,7,28,USA
Matthew Evan,1959-07-25,2,1983,1985,7,25,USA
Matthew Derrick,1965-11-28,16,1987,2003,11,28,USA
Mark Alan,1959-07-21,7,1987,1994,7,21,USA
Matt Taylor,1971-04-12,0,2000,2000,4,12,USA
Mason,1991-08-21,4,2015,2019,8,21,USA
Johnathan Mackensey,1990-07-15,4,2015,2019,7,15,USA
Michael Henry,1950-12-26,4,1977,1981,12,26,USA
Mitchell Steven,1964-11-17,11,1986,1997,11,17,USA
Michael Darren,1968-07-29,11,1992,2003,7,29,USA
David Carter,1892-07-31,1,1913,1914,7,31,USA
Edward Nagle,1857-10-24,12,1878,1890,10,24,USA
Billy Nicholas,1993-09-08,2,2017,2019,9,8,USA
Otto George,1877-11-02,4,1902,1906,11,2,USA
Fred,1913-07-17,0,1945,1945,7,17,USA
Walter Merrill,1874-05-19,5,1898,1903,5,19,USA
Randall Duane,1975-09-18,7,2004,2011,9,18,USA
Reginald Dewayne,1960-08-29,3,1985,1988,8,29,USA
Reginald Bernard,1966-05-05,7,1992,1999,5,5,USA
Reggie Gene,1981-05-30,5,2006,2011,5,30,USA
Alva Mitchell,1882-01-31,7,1911,1918,1,31,USA
Rinaldo Louis,1893-12-18,0,1914,1914,12,18,USA
Richard Allen,1952-11-09,1,1978,1979,11,9,USA
Ronald Earl,1943-07-12,4,1966,1970,7,12,USA
Scott Ryan,1976-02-17,8,1999,2007,2,17,USA
Shad Clayton,1971-03-10,1,1996,1997,3,10,USA
Rees Gephardt,1892-01-31,2,1914,1916,1,31,USA
Stanley Wilson,1936-09-14,14,1958,1972,9,14,USA
Taylor Grant,1991-07-21,2,2017,2019,7,21,USA
Theodore Samuel,1918-08-30,21,1939,1960,8,30,USA
Thomas C.,1870-08-19,1,1892,1893,8,19,USA
Todd Michael,1971-02-13,12,1995,2007,2,13,USA
Trevor Anthony,1992-04-25,3,2016,2019,4,25,USA
Victor Gazaway,1876-04-12,12,1898,1910,4,12,USA
Walter Allen,1943-12-19,11,1964,1975,12,19,USA
Woodrow Wilson,1912-08-21,7,1938,1945,8,21,USA
Gregory Scott,1966-08-19,14,1993,2007,8,19,USA
Claude William,1898-11-14,6,1925,1931,11,14,USA
James Arthur,1949-01-31,7,1971,1978,1,31,USA
Elliott Taylor,1952-07-27,5,1977,1982,7,27,USA
Davis Bowles,1877-01-26,0,1899,1899,1,26,USA
Frank Lee,1958-10-26,8,1983,1991,10,26,USA
Frank Hoxie,1895-11-03,9,1918,1927,11,3,USA
Maurice Morning,1932-10-02,13,1959,1972,10,2,USA
Theodore Carl,1934-02-09,6,1959,1965,2,9,USA
Paul Richard,1958-11-08,0,1989,1989,11,8,USA
Walter Robert,1863-10-18,10,1888,1898,10,18,USA
Terry Wayne,1949-03-22,0,1973,1973,3,22,USA
Vernon Sprague,1912-08-03,2,1934,1936,8,3,USA
William Alexander,1986-11-03,6,2013,2019,11,3,Saudi Arabia
Arthur Earl,1885-12-11,13,1908,1921,12,11,USA
Arthur Lee,1920-10-28,0,1951,1951,10,28,USA
Archibald Clifton,1923-11-25,1,1951,1952,11,25,USA
William G.,1867-10-28,8,1890,1898,10,28,USA
William Donald,1928-11-06,5,1950,1955,11,6,USA
William Harlan,1942-09-21,4,1969,1973,9,21,USA
Robert,1925-02-22,0,1958,1958,2,22,USA
Robert Louis,1983-04-08,11,2008,2019,4,8,USA
Brian Patrick,1982-03-16,8,2006,2014,3,16,USA
Bryse Everett,1997-12-20,1,2018,2019,12,20,USA
John Owen,1883-08-21,8,1908,1916,8,21,USA
Charles Woodrow,1905-01-13,4,1931,1935,1,13,USA
Christopher John,1980-11-18,10,2005,2015,11,18,USA
Craig,1964-11-28,4,1989,1993,11,28,USA
Craig Franklin,1970-09-03,2,1998,2000,9,3,USA
Craig Alan,1976-11-30,6,2001,2007,11,30,USA
Daniel Allen,1969-03-25,13,1992,2005,3,25,USA
Desi Bernard,1969-05-09,0,1996,1996,5,9,USA
Donald Edward,1945-02-12,8,1966,1974,2,12,USA
Duane Lewis,1934-06-29,0,1958,1958,6,29,USA
Earl Lawrence,1934-10-02,11,1959,1970,10,2,USA
Edward Francis,1909-09-07,1,1936,1937,9,7,USA
Enrique,1973-07-27,8,1997,2005,7,27,D.R.
Finis Elbert,1888-12-09,1,1914,1915,12,9,USA
Francis Edward,1901-04-20,4,1924,1928,4,20,USA
James Garrett,1879-01-12,0,1902,1902,1,12,USA
Gary Steven,1954-11-21,0,1979,1979,11,21,USA
Gary Morris,1970-01-01,0,1995,1995,1,1,USA
George Washington,1924-08-31,4,1952,1956,8,31,USA
Glenn Dwight,1958-12-22,11,1982,1993,12,22,USA
Grady Herbert,1922-11-23,0,1948,1948,11,23,USA
Lewis Robert,1900-04-26,11,1923,1934,4,26,USA
Harry Clayton,1876-01-01,0,1898,1898,1,1,USA
Howard Paul,1878-08-09,5,1899,1904,8,9,USA
George Peacock,1912-09-14,0,1934,1934,9,14,USA
John Francis,1912-04-12,8,1934,1942,4,12,USA
Jack Eugene,1977-12-29,11,2001,2012,12,29,USA
James,1900-07-23,17,1923,1940,7,23,USA
James Alger,1922-02-20,13,1945,1958,2,20,USA
James George,1960-12-29,4,1985,1989,12,29,USA
John Nicodemus,1890-06-15,0,1913,1913,6,15,USA
John Samuel,1903-04-25,1,1927,1928,4,25,USA
Joshua Aaron,1981-03-26,10,2005,2015,3,26,USA
Justin James,1987-08-18,7,2012,2019,8,18,USA
Ernest Judson,1896-02-28,NA,NA,NA,2,28,USA
Kristopher Kyle,1976-08-06,6,2000,2006,8,6,USA
Lester Wilbur,1885-07-17,0,1911,1911,7,17,USA
Max,1916-06-03,6,1940,1946,6,3,USA
Samuel Marshall,1896-12-02,0,1921,1921,12,2,USA
Michael LaDon,1983-06-29,0,2011,2011,6,29,USA
William Hayward,1956-02-09,11,1980,1991,2,9,USA
William Clarence,1896-07-20,0,1920,1920,7,20,USA
Samuel O'Neil,1935-06-14,0,1960,1960,6,14,USA
Nigel Edward,1970-01-12,3,1993,1996,1,12,CAN
Parke Asel,1867-10-26,6,1893,1899,10,26,USA
Paul Anthony,1973-03-28,9,1996,2005,3,28,USA
Alec Peter,1884-10-09,1,1908,1909,10,9,USA
Preston James Richard,1974-07-19,9,1998,2007,7,19,USA
Robert James,1929-03-07,9,1951,1960,3,7,USA
Roy Edward,1896-09-13,0,1928,1928,9,13,USA
George Francis,1889-03-29,3,1911,1914,3,29,USA
Stephen Douglas,1964-12-13,5,1988,1993,12,13,CAN
Michael,1956-05-16,4,1983,1987,5,16,USA
Gomer Russell,1901-07-08,0,1924,1924,7,8,USA
Thomas G.,1890-06-03,0,1914,1914,6,3,USA
Thomas Leroy,1970-12-19,3,2001,2004,12,19,USA
Trevor Kirk,1966-06-07,10,1988,1998,6,7,USA
Philip Tyler,1989-09-25,2,2015,2017,9,25,USA
Vance Allen,1973-03-17,7,1999,2006,3,17,USA
Walter Wood,1913-11-24,0,1945,1945,11,24,USA
William,1885-01-07,0,1906,1906,1,7,USA
Willie James,1955-07-09,18,1976,1994,7,9,USA
Frank Ealton,1869-12-24,4,1895,1899,12,24,USA
Harold James,1903-08-06,5,1926,1931,8,6,USA
George Leroy,1879-09-07,11,1904,1915,9,7,USA
Lewis DeWitt,1871-12-05,2,1901,1903,12,5,USA
Alex Michael,1988-11-01,1,2016,2017,11,1,USA
Edward Joseph,1929-04-16,1,1956,1957,4,16,USA
Frederick Russell,1882-01-23,0,1909,1909,1,23,USA
Scott Joseph,1973-04-20,4,1997,2001,4,20,USA
Gordon Ray,1933-12-19,3,1959,1962,12,19,USA
Willis Brewer,1904-12-13,1,1928,1929,12,13,USA
Jason David,1982-07-16,0,2006,2006,7,16,USA
Edward,1905-08-10,0,1929,1929,8,10,USA
Robert Paul,1938-09-17,12,1960,1972,9,17,USA
Ralph Lee,1909-10-29,19,1930,1949,10,29,USA
Robert Paul,1962-07-13,1,1986,1987,7,13,USA
David Mark,1951-10-03,22,1973,1995,10,3,USA
James Head,1909-10-09,6,1932,1938,10,9,USA
Ernest James,1900-10-17,3,1924,1927,10,17,USA
Anthony James,1994-04-15,1,2018,2019,4,15,USA
Frederick Davis,1899-08-07,4,1923,1927,8,7,USA
Absalom Holbrook,1898-05-06,9,1919,1928,5,6,USA
Edmund Armand,1895-10-08,0,1920,1920,10,8,CAN
Ivey Brown,1890-07-08,18,1911,1929,7,8,USA
Lafayette Sharkey,1881-10-23,1,1902,1903,10,23,USA
George Edward,1865-02-18,0,1886,1886,2,18,USA
Jesse,1993-08-17,2,2017,2019,8,17,USA
Joseph,1973-09-14,7,1999,2006,9,14,USA
Bobby Brooks,1930-03-11,NA,NA,NA,3,11,USA
Daniel Allen,1990-02-02,4,2015,2019,2,2,USA
George Benjamin,1897-10-26,4,1919,1923,10,26,USA
Herman Son,1961-12-01,8,1984,1992,12,1,USA
James Francis,1959-09-23,5,1983,1988,9,23,USA
Dwight Randolph,1974-06-09,12,1998,2010,6,9,USA
John Thomas,1909-11-24,8,1930,1938,11,24,USA
Darrin Alexander,1966-07-06,1,1997,1998,7,6,USA
Henry Rudolph,1904-06-15,3,1933,1936,6,15,USA
Clarence John,1899-09-07,0,1924,1924,9,7,USA
George Lovington,1878-04-27,7,1901,1908,4,27,USA
Jesse Frank,1893-12-22,4,1919,1923,12,22,USA
Matthew Littleton,1960-03-18,0,1989,1989,3,18,USA
Alan Lee,1956-12-08,2,1978,1980,12,8,USA
Elwood Vernon,1897-10-30,3,1921,1924,10,30,USA
Patrick Ian,1991-08-27,1,2018,2019,8,27,USA
Archibald Edwin,1912-07-31,0,1932,1932,7,31,USA
William Ellsworth,1861-03-15,4,1882,1886,3,15,USA
Kendall Cole,1932-09-08,3,1957,1960,9,8,USA
Larry Dewayne,1978-02-24,13,2000,2013,2,24,USA
Hugh Edward,1906-03-09,0,1930,1930,3,9,USA
Matthew John,1975-11-18,8,2000,2008,11,18,USA
Nicholas Joseph,1866-06-15,0,1888,1888,6,15,USA
Richard Charles,1945-09-13,18,1964,1982,9,13,USA
Roy Ogden,1923-11-18,0,1944,1944,11,18,USA
Samuel Washington,1857-08-18,12,1881,1893,8,18,USA
Matthew Robert,1992-09-12,4,2015,2019,9,12,USA
John Henry,1899-11-05,7,1919,1926,11,5,USA
Phillip Newton,1870-07-09,0,1895,1895,7,9,USA
David Alvin,1941-02-17,0,1964,1964,2,17,USA
George John,1888-03-07,1,1914,1915,3,7,USA
Francis Michael,1912-02-20,0,1934,1934,2,20,USA
Gerald Alphonse,1972-08-28,11,1996,2007,8,28,USA
Nicholas Joseph,1915-12-19,9,1940,1949,12,19,USA
Foster Leroy,1886-07-26,3,1906,1909,7,26,USA
Shannon Bolt,1972-09-21,0,1998,1998,9,21,USA
Christopher Michael,1989-04-01,3,2013,2016,4,1,USA
Raymond Wallace,1937-11-28,0,1963,1963,11,28,USA
Frank Blaine,1891-06-14,2,1920,1922,6,14,USA
Ronald Herman,1967-06-28,0,1991,1991,6,28,USA
Robert Andrew,1964-05-11,15,1986,2001,5,11,USA
Jerome Charles,1915-07-30,1,1946,1947,7,30,USA
George Adrian,1931-11-09,5,1957,1962,11,9,USA
Nicholas James,1991-05-29,3,2016,2019,5,29,USA
John Carl,1914-06-16,11,1938,1949,6,16,USA
Kevin Joseph,1976-01-05,8,1998,2006,1,5,USA
Michael Atwater,1960-07-20,12,1981,1993,7,20,USA
Lawton Walter,1895-09-28,10,1916,1926,9,28,USA
Johnny Bilton,1949-02-27,11,1974,1985,2,27,USA
Andrew Emil,1896-02-04,1,1923,1924,2,4,USA
Oscar J.,1871-12-12,0,1895,1895,12,12,USA
Mark Edward,1970-01-23,11,1991,2002,1,23,USA
James Eugene,1951-02-28,14,1972,1986,2,28,USA
Randall Asher,1988-12-21,4,2015,2019,12,21,USA
John Joseph,1942-04-06,2,1962,1964,4,6,USA
Steven Joseph,1970-07-29,2,1995,1997,7,29,USA
Peter Paul,1919-12-01,3,1954,1957,12,1,USA
Edward David,1960-08-20,4,1985,1989,8,20,USA
Robert William,1973-09-08,4,1995,1999,9,8,USA
Wilbert Otto,1876-06-10,3,1903,1906,6,10,USA
William Franklyn,1876-01-14,0,1902,1902,1,14,USA
Brian Thomas,1980-11-29,2,2007,2009,11,29,USA
Charles Hunt,1897-02-15,0,1923,1923,2,15,USA
Edward Anthony,1929-01-02,0,1952,1952,1,2,USA
Harold,1888-11-24,0,1917,1917,11,24,USA
Laurence Marcy,1953-03-02,3,1977,1980,3,2,USA
Roy Chamberlain,1888-09-01,2,1912,1914,9,1,USA
Ernest Adolf,1889-02-02,0,1912,1912,2,2,USA
Roger Francis,1911-04-10,6,1941,1947,4,10,USA
Meldon John,1890-03-20,4,1914,1918,3,20,USA
William Van Winkle,1862-05-12,10,1882,1892,5,12,USA
Walter Francis,1900-06-10,0,1921,1921,6,10,USA
Raymond Bernard,1904-07-15,0,1927,1927,7,15,USA
Randall Christopher,1976-08-22,16,1999,2015,8,22,USA
Ross Garrett,1982-10-18,6,2007,2013,10,18,USA
Walter Beck,1942-01-05,1,1969,1970,1,5,USA
Abraham Lincoln,1861-03-04,0,1883,1883,3,4,USA
Harry Meiggs,1884-07-11,10,1907,1917,7,11,USA
Reinder Albertus,1842-03-17,2,1871,1873,3,17,Netherlands
Anthony John,1992-06-09,3,2016,2019,6,9,USA
Harry Sterling,1873-12-06,14,1898,1912,12,6,USA
Horace Guy,1939-08-25,4,1966,1970,8,25,USA
Sidney Kirk,1896-10-02,0,1926,1926,10,2,USA
Anthony Darrell,1969-09-25,13,1993,2006,9,25,USA
Kean Keanu,1995-04-17,0,2019,2019,4,17,USA
Kolten Kaha,1990-10-10,6,2013,2019,10,10,USA
David Bradley,1969-06-25,5,1994,1999,6,25,USA
Darrell Lee,1956-12-10,0,1978,1978,12,10,USA
Robert Alexander,1991-01-12,6,2013,2019,1,12,USA
Charles Lawrence,1894-07-26,9,1920,1929,7,26,USA
Michael Cary,1960-03-02,3,1985,1988,3,2,USA
Steven Larry,1975-05-15,6,1997,2003,5,15,USA
Eugene Stewart,1886-08-20,1,1911,1912,8,20,USA
Blake Daniel,1985-08-08,8,2010,2018,8,8,USA
Robert Lynn,1865-07-28,7,1898,1905,7,28,USA
Richard Brandon,1985-03-02,4,2007,2011,3,2,USA
Fred Wayland,1868-05-17,0,1892,1892,5,17,USA
Charles Spencer,1900-02-28,0,1923,1923,2,28,USA
George Anthony,1917-12-09,0,1944,1944,12,9,USA
Harold Joseph,1932-08-24,11,1956,1967,8,24,USA
Frederick Llewellyn,1861-07-21,1,1884,1885,7,21,CAN
George Albert,1858-11-09,12,1880,1892,11,9,CAN
Harold Austin,1885-02-10,0,1903,1903,2,10,USA
James,1851-07-09,6,1873,1879,7,9,USA
Hunter Blake,1993-08-12,2,2017,2019,8,12,USA
Jacob,1937-06-22,6,1961,1967,6,22,USA
Jason William,1969-12-16,10,1998,2008,12,16,USA
James Leon,1843-12-01,2,1871,1873,12,1,USA
John B.,1872-05-14,0,1896,1896,5,14,USA
Joe,1889-10-25,14,1908,1922,10,25,USA
Joseph Perry,1919-10-03,0,1943,1943,10,3,USA
Joe Frank,1916-05-20,0,1944,1944,5,20,USA
Kenneth Lanier,1924-07-01,5,1948,1953,7,1,USA
Kerry Lee,1977-06-16,14,1998,2012,6,16,USA
Eugene Richard,1922-08-16,19,1943,1962,8,16,USA
Daniel Courtenay,1893-07-08,1,1914,1915,7,8,USA
Michael Burton,1980-04-26,4,2003,2007,4,26,USA
Peter Burke,1867-02-01,4,1885,1889,2,1,CAN
Brandon Kyle,1993-02-10,2,2017,2019,2,10,USA
Roy Winton,1892-08-29,2,1913,1915,8,29,USA
Peter Francis,1874-04-02,0,1899,1899,4,2,USA
Orville Francis,1876-12-27,6,1904,1910,12,27,USA
Alvis,1953-08-08,9,1977,1986,8,8,USA
Clarence Cofield,1892-06-11,0,1914,1914,6,11,USA
Richard Lee,1945-03-30,5,1969,1974,3,30,USA
Gary Lee,1953-07-20,9,1976,1985,7,20,USA
Jacob Thomas,1981-09-03,3,2005,2008,9,3,USA
James Jerome,1939-09-17,4,1957,1961,9,17,USA
John Fulton,1898-01-18,0,1924,1924,1,18,USA
Walter Browne,1969-05-18,0,1992,1992,5,18,USA
Charles Asher,1909-01-13,1,1930,1931,1,13,USA
George Rowland,1920-05-22,2,1943,1945,5,22,USA
Ronald Lawrence,1943-02-01,5,1969,1974,2,1,USA
Tracy Michael,1962-10-05,6,1987,1993,10,5,USA
Walter Sidney,1875-04-28,2,1898,1900,4,28,USA
Edward Robert,1967-01-04,2,1991,1993,1,4,USA
Timothy Dayle,1982-11-16,2,2009,2011,11,16,USA
Travis A.,1987-02-06,7,2010,2017,2,6,USA
Christopher Michael,1976-06-27,12,1999,2011,6,27,USA
Frank Russell,1894-05-17,5,1918,1923,5,17,USA
Wilbur Forrester,1941-10-22,17,1961,1978,10,22,USA
Robert John,1962-09-28,3,1985,1988,9,28,USA
William Frederick,1942-09-23,8,1963,1971,9,23,USA
Mark Anthony,1978-12-19,0,2005,2005,12,19,USA
Floyd Lewis,1928-08-25,0,1955,1955,8,25,USA
Earl Hazwell,1924-01-16,1,1947,1948,1,16,USA
Robert Davis,1985-07-21,2,2013,2015,7,21,USA
William Shawn,1972-07-24,5,2000,2005,7,24,USA
Frederick Bamford,1894-09-04,0,1914,1914,9,4,USA
Brandon Carlin,1988-08-13,6,2013,2019,8,13,USA
Charles Thomas,1915-01-06,8,1938,1946,1,6,USA
Henry Kilgariff,1926-02-05,0,1950,1950,2,5,USA
Harry Hallworth,1899-09-25,0,1924,1924,9,25,USA
Ralph Talmadge,1888-03-16,4,1909,1913,3,16,USA
Vance Richard,1987-09-25,7,2010,2017,9,25,USA
Mark Robert,1983-03-08,3,2008,2011,3,8,USA
Timothy Howard,1967-07-05,13,1993,2006,7,5,USA
Todd Roland,1959-09-28,12,1985,1997,9,28,USA
Allan Fulton,1929-02-05,16,1953,1969,2,5,USA
Craig Richard,1965-04-17,8,1988,1996,4,17,USA
Daniel Weston,1985-09-30,6,2010,2016,9,30,USA
Herbert,1847-05-02,0,1872,1872,5,2,NA
Robert Lee,1906-04-24,3,1931,1934,4,24,USA
Richard Cooper,1953-10-22,5,1978,1983,10,22,USA
William Lewis,1892-01-05,2,1916,1918,1,5,USA
Matt Mark,1991-10-06,0,2019,2019,10,6,USA
Ronald Allan,1961-03-03,1,1983,1984,3,3,USA
James Joseph,1859-11-25,0,1884,1884,11,25,USA
Albert Owen,1906-11-16,9,1935,1944,11,16,USA
Albert Edgar,1912-11-11,0,1933,1933,11,11,USA
Alfred Hector,1842-03-31,NA,NA,NA,3,31,USA
William Hiram,1864-10-04,0,1887,1887,10,4,USA
Robert Cassius,1891-12-13,0,1915,1915,12,13,USA
Sebern Chase,1983-02-08,0,2007,2007,2,8,USA
Clyde,1941-02-20,9,1966,1975,2,20,USA
Ceylon,1893-08-16,0,1916,1916,8,16,USA
David William,1875-08-27,2,1895,1897,8,27,USA
Jonathan Daniel,1977-12-14,3,2001,2004,12,14,USA
David Allen,1982-12-20,14,2004,2018,12,20,USA
Daniel Paul,1991-04-03,1,2016,2017,4,3,USA
Willard James,1889-05-05,0,1915,1915,5,5,USA
Henderson Edward,1919-05-15,7,1945,1952,5,15,USA
George,1847-01-28,11,1871,1882,1,28,USA
Clarence Eugene,1878-12-11,3,1901,1904,12,11,USA
George DeWitt,1958-12-22,4,1982,1986,12,22,USA
Forest Glenn,1901-02-06,11,1924,1935,2,6,USA
William Henry,1835-01-10,6,1871,1877,1,10,United Kingdom
Jamey Alan,1974-12-24,18,1996,2014,12,24,USA
Jaret Samuel,1975-12-29,10,1997,2007,12,29,USA
James,1900-09-19,1,1927,1928,9,19,United Kingdom
James Clifton,1950-12-21,1,1978,1979,12,21,USA
James Leon,1955-03-03,1,1981,1982,3,3,USA
Kenneth Warren,1946-09-04,4,1970,1974,9,4,USA
Kyle Hardy,1995-10-02,1,2018,2019,10,2,USA
William Simmons,1880-02-21,0,1909,1909,2,21,USA
Melvin James,1928-05-11,7,1954,1961,5,11,USA
Dennis Michael,1990-01-03,4,2015,2019,1,3,USA
Patrick W.,1868-07-05,0,1890,1890,7,5,USA
William Smith,1863-01-31,0,1890,1890,1,31,USA
Wayne Bromley,1895-11-05,6,1917,1923,11,5,USA
James Richard,1958-11-22,4,1982,1986,11,22,USA
Roy Earl,1933-09-26,0,1956,1956,9,26,USA
Ronald Wade,1976-01-21,0,2002,2002,1,21,USA
Russell Guy,1893-03-18,8,1920,1928,3,18,USA
Samuel,1848-11-25,6,1875,1881,11,25,USA
Steven Richard,1984-08-30,6,2013,2019,8,30,USA
Taft Shedron,1911-08-10,11,1938,1949,8,10,USA
Thomas Everette,1923-09-22,8,1948,1956,9,22,USA
Dequam LaWesley,1985-01-28,7,2008,2015,1,28,USA
George Watson,1874-01-18,3,1896,1899,1,18,USA
Richard James,1963-12-10,6,1988,1994,12,10,USA
Michael James,1978-12-15,7,2004,2011,12,15,USA
George,1903-10-18,1,1929,1930,10,18,USA
Kelly Douglas,1972-07-12,5,2000,2005,7,12,USA
Frank James,1924-04-27,0,1944,1944,4,27,USA
Loral John,1900-04-06,0,1924,1924,4,6,USA
John,1935-04-19,8,1961,1969,4,19,USA
John Whitlow,1907-09-27,16,1929,1945,9,27,USA
John Weldon,1891-02-19,5,1913,1918,2,19,USA
James Renwick,1861-12-14,0,1882,1882,12,14,USA
Willis C.,1859-12-19,0,1884,1884,12,19,USA
Harold Delano,1956-03-14,12,1976,1988,3,14,USA
Early,1920-01-06,24,1939,1963,1,6,USA
William Avera,1869-03-27,0,1894,1894,3,27,USA
Billy Vernon,1943-07-31,4,1967,1971,7,31,USA
Marvell,1959-12-17,7,1983,1990,12,17,USA
James Sherman,1942-03-12,14,1963,1977,3,12,USA
Robert Austin,1990-12-10,1,2018,2019,12,10,USA
John Barney,1919-07-12,12,1942,1954,7,12,USA
Henry Washington,1918-03-01,9,1942,1951,3,1,USA
Harlan,1905-04-13,2,1930,1932,4,13,USA
Keiichi,1968-09-28,3,2005,2008,9,28,Japan
Yasuhiko,1973-06-19,1,2008,2009,6,19,Japan
James Allin,1992-03-21,2,2017,2019,3,21,USA
Henry,1864-03-01,0,1888,1888,3,1,USA
William M.,1870-04-17,0,1905,1905,4,17,USA
Jordan,1996-05-11,0,2019,2019,5,11,USA
Hugh,1950-10-16,4,1972,1976,10,16,USA
Esteban Luis,1975-06-22,10,1996,2006,6,22,D.R.
George Edward,1922-11-19,7,1942,1949,11,19,USA
George Webb,1886-07-27,0,1912,1912,7,27,USA
Ryan Christian,1991-12-31,1,2018,2019,12,31,USA
Eric Christian,1990-08-18,0,2019,2019,8,18,USA
Harvey Edward,1975-12-04,1,1999,2000,12,4,USA
Waldo Ward,1902-10-22,0,1926,1926,10,22,USA
Byron Wardsworth,1896-03-09,2,1922,1924,3,9,USA
Clarence Everett,1892-11-05,1,1921,1922,11,5,USA
Carl Michael,1939-08-22,22,1961,1983,8,22,USA
Michael,1990-08-23,0,2019,2019,8,23,USA
Albert Arthur,1945-05-26,0,1971,1971,5,26,USA
Kirby Kali,1987-03-25,5,2014,2019,3,25,USA
Tyler Kali,1977-08-07,5,2004,2009,8,7,USA
Thomas Austin,1903-02-21,NA,NA,NA,2,21,USA
Emil Ogden,1900-01-28,5,1924,1929,1,28,USA
Robert Watkins,1893-12-17,0,1919,1919,12,17,USA
George J.,1873-06-04,6,1896,1902,6,4,USA
Joseph Francis,1875-08-28,10,1898,1908,8,28,USA
Stephen Wayne,1948-11-24,14,1972,1986,11,24,USA
James Almond,1901-10-16,2,1922,1924,10,16,USA
William Suter,1838-03-10,0,1872,1872,3,10,USA
Eric Girard,1965-02-22,4,1989,1993,2,22,USA
Christian Stephen,1991-12-05,6,2013,2019,12,5,USA
Archie Joseph,1892-06-11,2,1917,1919,6,11,USA
Lawrence Alan,1943-01-04,1,1963,1964,1,4,USA
Moses J.,1898-03-28,1,1921,1922,3,28,USA
Charles Carroll,1903-06-13,6,1927,1933,6,13,USA
Stanley Lewis,1874-11-28,2,1901,1903,11,28,USA
Stephen Douglas,1888-05-15,7,1909,1916,5,15,USA
Richard Martin,1962-10-06,5,1985,1990,10,6,USA
Thomas J.,1932-05-09,0,1957,1957,5,9,USA
Edwin Leonard,1862-08-22,0,1884,1884,8,22,USA
Charles Christian,1865-12-07,0,1894,1894,12,7,USA
Earl Hershey,1888-10-29,7,1911,1918,10,29,USA
Joseph,1867-02-28,0,1886,1886,2,28,USA
Gabriel,1993-05-26,3,2016,2019,5,26,D.R.
Huascar Jose,1998-05-28,0,2019,2019,5,28,D.R.
Michael Jose,1991-09-24,1,2016,2017,9,24,D.R.
Argelis Rafael,1987-08-07,2,2014,2016,8,7,D.R.
Leonard Joseph,1928-10-16,3,1951,1954,10,16,USA
Raymond Austin Aloysius,1922-07-19,1,1948,1949,7,19,USA
William Clyde,1878-09-02,0,1909,1909,9,2,USA
James Harlan,1947-08-27,6,1970,1976,8,27,USA
James Edward,1892-11-01,2,1919,1921,11,1,USA
Michael David,1964-09-06,1,1990,1991,9,6,USA
Preston Rudolph,1913-08-17,14,1934,1948,8,17,USA
Thomas Jefferson,1850-07-13,14,1871,1885,7,13,USA
Tony Batton,1912-11-27,0,1944,1944,11,27,USA
Masato,1965-04-20,4,1998,2002,4,20,Japan
Edward Frederick,1926-10-13,18,1944,1962,10,13,USA
Edgar Frederick,1954-08-19,5,1980,1985,8,19,USA
Elmer Ellsworth,1900-06-26,7,1921,1928,6,26,USA
Kevin Edmund,1979-03-15,9,2004,2013,3,15,USA
Floyd Everett,1964-05-11,4,1985,1989,5,11,USA
Shane Demond,1979-10-11,1,2006,2007,10,11,USA
Alexander Edward,1993-09-09,0,2019,2019,9,9,USA
Anthony Wayne,1966-01-19,5,1991,1996,1,19,USA
Norman Robert,1915-07-01,12,1936,1948,7,1,USA
Robert George,1925-01-22,10,1948,1958,1,22,USA
Charles,1893-01-12,0,1915,1915,1,12,USA
Albert Clyde,1900-06-13,0,1922,1922,6,13,USA
Christopher Ryan,1979-05-25,13,2004,2017,5,25,USA
Christopher Brandon,1983-09-05,12,2006,2018,9,5,USA
Clifford Raphael,1964-08-02,3,1990,1993,8,2,USA
Curtis Allen,1960-04-16,10,1983,1993,4,16,USA
Denton True,1867-03-29,21,1890,1911,3,29,USA
Daniel Bracy,1971-11-03,0,2000,2000,11,3,USA
Delmer John,1885-10-24,6,1909,1915,10,24,USA
Delmer Edward,1912-03-11,3,1937,1940,3,11,USA
Delmon Damarcus,1985-09-14,9,2006,2015,9,14,USA
Delwyn Rudy,1982-06-30,4,2006,2010,6,30,USA
Richard Ennis,1928-06-03,1,1951,1952,6,3,USA
Dmitri Dell,1973-10-11,12,1996,2008,10,11,USA
Donald Wayne,1945-10-18,4,1965,1969,10,18,USA
Eric Orlando,1967-05-18,14,1992,2006,5,18,USA
Ernest Wesley,1969-07-08,10,1994,2004,7,8,USA
Eric Orlando,1985-05-25,9,2009,2018,5,25,USA
George Joseph,1890-04-01,0,1913,1913,4,1,USA
Gerald Anthony,1964-10-22,7,1987,1994,10,22,Honduras
Harlan Edward,1883-09-28,0,1908,1908,9,28,USA
Henry Hugo,1865-11-21,0,1890,1890,11,21,Germany
Herman John,1886-04-14,0,1911,1911,4,14,USA
Irving Melrose,1877-07-21,6,1905,1911,7,21,USA
Jason Kariya,1979-09-28,1,2003,2004,9,28,USA
Joseph B.,1857-06-10,0,1892,1892,6,10,USA
John Thomas,1949-02-09,0,1971,1971,2,9,USA
Joel Randolph,1951-08-28,13,1976,1989,8,28,USA
Kevin Stacey,1969-06-16,11,1992,2003,6,16,USA
Kip Lane,1954-10-29,1,1978,1979,10,29,USA
Matthew John,1958-08-09,10,1983,1993,8,9,USA
Matthew Earl,1982-10-03,1,2011,2012,10,3,USA
John Madison,1990-11-03,0,2016,2016,11,3,USA
Michael Darren,1960-03-20,7,1982,1989,3,20,USA
Michael Brian,1976-10-19,13,2000,2013,10,19,USA
Nicholas Ephraim,1840-09-12,NA,NA,NA,9,12,USA
Lemuel Floyd,1907-08-29,12,1933,1945,8,29,USA
Bryan Owen,1968-03-19,1,1992,1993,3,19,USA
Ralph Stuart,1888-09-19,9,1913,1922,9,19,USA
Royce Middlebrook,1897-04-10,9,1917,1926,4,10,USA
Russell Charles,1902-09-15,0,1931,1931,9,15,USA
Timothy R.,1973-10-15,2,1998,2000,10,15,USA
Walter Ernest,1980-02-18,0,2005,2005,2,18,USA
Herbert Macon,1885-12-07,0,1914,1914,12,7,USA
Floyd Edwin,1915-12-19,2,1937,1939,12,19,USA
Lawrence King,1950-02-15,0,1971,1971,2,15,USA
Robin R.,1955-09-16,19,1974,1993,9,16,USA
Carl Columbus,1902-12-20,1,1924,1925,12,20,USA
John Edward,1924-08-05,1,1952,1953,8,5,USA
Jeffrey Lynn,1954-02-26,0,1978,1978,2,26,USA
Salvador Anthony,1924-02-20,7,1947,1954,2,20,USA
Adrian,1916-08-26,4,1945,1949,8,26,Cuba
George Washington,1891-02-18,2,1913,1915,2,18,USA
Albert Myron,1914-05-14,0,1944,1944,5,14,USA
William Christopher,1944-02-19,10,1963,1973,2,19,USA
Jonathan Thompson Walton,1896-05-07,18,1918,1936,5,7,USA
Elmer Henry,1880-09-17,0,1910,1910,9,17,USA
Patrick Paul,1952-04-24,9,1976,1985,4,24,USA
George Carl Harlon,1884-12-24,1,1911,1912,12,24,USA
Mark Raymond,1993-02-05,2,2017,2019,2,5,USA
Michael Justin,1983-01-27,11,2007,2018,1,27,USA
Frederick Joseph,1870-06-05,1,1894,1895,6,5,USA
Geoffrey Clayton,1945-12-19,12,1973,1985,12,19,USA
Paul Vernon,1896-09-06,6,1923,1929,9,6,USA
Frank Thomas,1922-02-22,2,1944,1946,2,22,USA
John Francis,1879-06-22,0,1903,1903,6,22,USA
Carlos Alberto,1981-06-01,11,2001,2012,6,1,Venezuela
Eduardo Jose,1966-02-01,1,1993,1994,2,1,Venezuela
Victor Manuel,1975-08-06,6,2001,2007,8,6,Venezuela
Carl Eugene,1889-10-06,0,1913,1913,10,6,USA
Daniel James,1993-04-15,1,2018,2019,4,15,USA
Oscar Jose,1944-09-23,4,1974,1978,9,23,Cuba
Dominick Thomas,1932-03-01,8,1958,1966,3,1,USA
Joseph John,1907-07-25,0,1933,1933,7,25,Latvia
Mauro Edward,1983-02-08,0,2007,2007,2,8,Venezuela
Jose Antonio,1923-05-20,0,1945,1945,5,20,Cuba
Allen Lee,1919-05-01,10,1943,1953,5,1,USA
Lloyd Jeffrey,1960-10-06,0,1984,1984,10,6,USA
Robert John,1992-03-26,2,2016,2018,3,26,CAN
Norbert Henry,1929-11-17,8,1951,1959,11,17,USA
Gregory Owen,1971-04-14,15,1995,2010,4,14,USA
Clay Pflibson,1984-06-28,0,2009,2009,6,28,USA
Bernardo Sebastian,1993-08-28,0,2019,2019,8,28,USA
Clinton Wayne,1967-01-04,0,1989,1989,1,4,USA
Lance Frederick,1985-05-26,0,2010,2010,5,26,USA
Joseph Edmund,1953-06-27,2,1977,1979,6,27,USA
David William Tilden,1868-01-01,9,1896,1905,1,1,USA
George William,1950-08-29,1,1977,1978,8,29,USA
Rollie Hubert,1883-11-16,8,1910,1918,11,16,USA
Joshua Alexander,1987-03-24,1,2013,2014,3,24,USA
Henry,1862-08-11,NA,NA,NA,8,11,USA
Todd Edward,1965-09-09,15,1989,2004,9,9,USA
Mathias John,1888-09-25,0,1914,1914,9,25,USA
Barton Wallace,1941-07-22,0,1970,1970,7,22,USA
William Clinton,1946-07-22,2,1969,1971,7,22,USA
William Chad,1972-04-27,3,2000,2003,4,27,USA
Gus Edward,1923-06-27,10,1949,1959,6,27,USA
George,1844-07-12,5,1871,1876,7,12,USA
Timothy James,1995-08-01,0,2019,2019,8,1,USA
Robert George,1927-04-26,0,1954,1954,4,26,USA
Brad Gregory,1979-10-10,10,2008,2018,10,10,USA
Charles Wallace,1875-01-13,1,1899,1900,1,13,USA
Stephen Graeling,1961-10-24,0,1987,1987,10,24,USA
Benedict Joseph,1918-02-14,7,1941,1948,2,14,USA
William,1867-06-16,0,1891,1891,6,16,USA
William Frederick,1887-01-20,0,1915,1915,1,20,Germany
Bradley Clarke,1992-11-27,2,2017,2019,11,27,USA
Charles Louis,1860-11-23,19,1884,1903,11,23,USA
Donald William,1931-01-17,11,1954,1965,1,17,USA
Edward Desmond,1883-01-04,5,1906,1911,1,4,USA
Henry,1887-02-09,12,1907,1919,2,9,USA
Gerald Robert,1934-09-21,7,1961,1968,9,21,USA
Jeffrey Ross,1972-08-09,2,1999,2001,8,9,CAN
Jordan William,1975-04-28,0,1999,1999,4,28,CAN
Jordan M.,1986-05-23,10,2009,2019,5,23,USA
Kyle Joseph,1991-09-13,0,2019,2019,9,13,USA
Roy Franklin,1913-09-13,0,1945,1945,9,13,USA
Ryan Wallace,1984-09-28,14,2005,2019,9,28,USA
Charles Tadao,1979-08-26,0,2008,2008,8,26,USA
Walter Noble,1898-11-21,0,1921,1921,11,21,USA
Frank Patrick,1865-12-21,0,1888,1888,12,21,USA
Guy,1887-02-13,4,1911,1915,2,13,USA
James Edward,1895-01-31,10,1919,1929,1,31,USA
William Francis,1918-01-06,0,1944,1944,1,6,USA
Alan Michael,1968-05-19,2,2002,2004,5,19,USA
Marion Sylvester,1938-11-18,1,1961,1962,11,18,USA
Richard Walter,1949-02-06,12,1971,1983,2,6,USA
Barry William,1978-05-13,15,2000,2015,5,13,USA
William Arthur,1895-11-19,10,1919,1929,11,19,USA
Edward Albert,1884-10-01,1,1910,1911,10,1,USA
Benjamin Thomas,1981-05-26,13,2006,2019,5,26,USA
Peter Jude,1977-02-06,0,2003,2003,2,6,USA
Samuel Walter,1918-12-08,8,1944,1952,12,8,USA
Edward James,1968-02-10,9,1991,2000,2,10,USA
William Henry,1913-03-26,11,1936,1947,3,26,USA
Jon Edward,1969-12-10,2,1996,1998,12,10,USA
Julio Ernesto,1975-03-28,1,2000,2001,3,28,Panama
Joel Martin,1984-11-09,4,2006,2010,11,9,USA
Michael Accorsi,1991-03-25,6,2013,2019,3,25,USA
Robert,1966-08-18,3,1991,1994,8,18,USA
Frank Joseph,1939-08-29,4,1957,1961,8,29,USA
Paul,1958-10-31,9,1982,1991,10,31,USA
George,1924-08-20,8,1951,1959,8,20,USA
Edward Harrison,1888-11-02,6,1910,1916,11,2,USA
Anthony Aaron,1990-08-07,2,2015,2017,8,7,USA
