player,birthday,yrs,from,to,team
John Aiken,1932-01-01,0,1958,1958,MTL
Murray Armstrong,1916-01-01,8,1938,1946,"TOR,NYA,BRO,DET"
Ossie Aubuchon,1917-01-01,1,1943,1944,"BOS,NYR"
Gilbert Brule,1987-01-01,8,2006,2014,"CBJ,EDM,PHX"
Jeff Carter,1985-01-01,14,2006,2020,"PHI,CBJ,LAK"
Les Colwill,1935-01-01,0,1959,1959,NYR
Bob Falkenberg,1946-01-01,5,1967,1972,DET
Freddie Hamilton,1992-01-01,4,2014,2018,"SJS,COL,CGY,ARI"
Gerry Hart,1948-01-01,14,1969,1983,"DET,NYI,QUE,STL"
Jayce Hawryluk,1996-01-01,1,2019,2020,"FLA,OTT"
Val Hoffinger,1901-01-01,1,1928,1929,CBH
Bobby Holik,1971-01-01,18,1991,2009,"HAR,NJD,NYR,ATL"
Gary Holt,1952-01-01,4,1974,1978,"CGS,CLE,STL"
Patric Hornqvist,1987-01-01,11,2009,2020,"NSH,PIT"
Dave Hunter,1958-01-01,9,1980,1989,"EDM,PIT,WIN"
Jack Leswick,1910-01-01,0,1934,1934,CBH
Calum MacKay,1927-01-01,8,1947,1955,"DET,MTL"
Cliff McBride,1909-01-01,1,1929,1930,"MTM,TOR"
Terry McDonald,1956-01-01,0,1976,1976,KCS
Mark Olver,1988-01-01,2,2011,2013,COL
Phil Roberto,1949-01-01,7,1970,1977,"MTL,STL,DET,KCS,CLE,CLR"
Doc Romnes,1909-01-01,9,1931,1940,"CBH,TOR,NYA"
Devin Setoguchi,1987-01-01,9,2008,2017,"SJS,MIN,WPG,CGY,LAK"
Dave Silk,1958-01-01,6,1980,1986,"NYR,BOS,DET,WIN"
Jim Stanfield,1947-01-01,2,1970,1972,LAK
Barney Stanley*,1893-01-01,0,1928,1928,CBH
Urho Vaakanainen,1999-01-01,1,2019,2020,BOS
Nick Wasnie,1904-01-01,7,1928,1935,"CBH,MTL,NYA,OTS,STE"
Don Willson,1914-01-01,1,1938,1939,MTL
Ken Yaremchuk,1964-01-01,5,1984,1989,"CBH,TOR"
C.J. Young,1968-01-01,0,1993,1993,"BOS,CGY"
Yuri Babenko,1978-01-02,0,2001,2001,COL
Mike Backman,1955-01-02,2,1982,1984,NYR
Brian Boucher,1977-01-02,13,2000,2013,"PHI,PHX,CGY,CBJ,CHI,SJS,CAR"
Wade Campbell,1961-01-02,5,1983,1988,"WIN,BOS"
Gabriel Carlsson,1997-01-02,3,2017,2020,CBJ
Neal Coulter,1963-01-02,2,1986,1988,NYI
Dave Cressman,1950-01-02,1,1975,1976,MNS
Andrew Ebbett,1983-01-02,7,2008,2015,"ANA,CHI,MIN,PHX,VAN,PIT"
Robbie Ftorek,1952-01-02,12,1973,1985,"DET,QUE,NYR"
Glen Harmon,1921-01-02,8,1943,1951,MTL
Harry Hyland*,1889-01-02,0,1918,1918,"MTW,OTS"
Jimmy Jones,1953-01-02,2,1978,1980,TOR
Lars Jonsson,1982-01-02,0,2007,2007,PHI
Zenon Konopka,1981-01-02,8,2006,2014,"MDA,CBJ,TBL,NYI,OTT,MIN,BUF"
Gord Labossiere,1940-01-02,8,1964,1972,"NYR,LAK,MNS"
Peter Lee,1956-01-02,5,1978,1983,PIT
Juha Lind,1974-01-02,3,1998,2001,"DAL,MTL"
Alexey Marchenko,1992-01-02,3,2014,2017,"DET,TOR"
Jacob Middleton,1996-01-02,1,2019,2020,SJS
Rick Mrozik,1975-01-02,0,2003,2003,CGY
Mattias Norstrom,1972-01-02,14,1994,2008,"NYR,LAK,DAL"
Ales Pisa,1977-01-02,1,2002,2003,"EDM,NYR"
Teemu Pulkkinen,1992-01-02,3,2014,2017,"DET,ARI,MIN"
Blake Speers,1997-01-02,0,2017,2017,NJD
Claude St. Sauveur,1952-01-02,0,1976,1976,ATF
John Stewart,1954-01-02,0,1980,1980,QUE
Robert Svehla,1969-01-02,8,1995,2003,"FLA,TOR"
Rick Tabaracci,1969-01-02,11,1989,2000,"PIT,WIN,WSH,CGY,TBL,ATL,COL"
Miroslav Zalesak,1980-01-02,1,2003,2004,SJS
Andrew Agozzino,1991-01-03,5,2015,2020,"COL,ANA,PIT"
Shawn Belle,1985-01-03,4,2007,2011,"MIN,MTL,COL,EDM"
Drake Berehowsky,1972-01-03,13,1991,2004,"TOR,PIT,EDM,NSH,VAN,PHX"
Reto Berra,1987-01-03,4,2014,2018,"CGY,COL,FLA,ANA"
Jean Bourcier,1911-01-03,0,1936,1936,MTL
Ryan Bourque,1991-01-03,0,2015,2015,NYR
Greg Britz,1961-01-03,3,1984,1987,"TOR,HAR"
Gord Brydson,1907-01-03,0,1930,1930,TOR
Jacques Cloutier,1960-01-03,12,1982,1994,"BUF,CHI,QUE"
Cory Cross,1971-01-03,12,1994,2006,"TBL,TOR,EDM,NYR,DET,PIT"
Ryan Ellis,1991-01-03,8,2012,2020,NSH
Gord Fraser,1902-01-03,4,1927,1931,"CBH,DTC,MTL,PTP,PHQ"
Matt Frattin,1988-01-03,4,2011,2015,"TOR,CBJ,LAK"
Simon Gamache,1981-01-03,5,2003,2008,"ATL,NSH,STL,TOR"
Kerry Huffman,1968-01-03,9,1987,1996,"PHI,QUE,OTT"
Bobby Hull*,1939-01-03,22,1958,1980,"CBH,HAR,WIN"
Raitis Ivanans,1979-01-03,6,2006,2012,"MTL,LAK,CGY"
Rick LaFerriere,1961-01-03,0,1982,1982,CLR
Marc Laforge,1968-01-03,4,1990,1994,"HAR,EDM"
David Latta,1967-01-03,5,1986,1991,QUE
Real Lemieux,1945-01-03,7,1967,1974,"DET,LAK,NYR,BUF"
Barry Long,1949-01-03,9,1973,1982,"LAK,DET,WIN"
Rick MacLeish,1950-01-03,13,1971,1984,"PHI,HAR,PIT,DET"
Bruce Major,1967-01-03,0,1991,1991,QUE
Moe Morris,1921-01-03,5,1944,1949,"TOR,NYR"
Joonas Nattinen,1991-01-03,0,2014,2014,MTL
Dylan Olsen,1991-01-03,4,2012,2016,"CHI,FLA"
Steve Poapst,1969-01-03,10,1996,2006,"WSH,CHI,PIT,STL"
Ryan Poehling,1999-01-03,1,2019,2020,MTL
Mike Posavad,1964-01-03,1,1986,1987,STL
Kevin Primeau,1956-01-03,0,1981,1981,VAN
Rick St. Croix,1955-01-03,7,1978,1985,"PHI,TOR"
Niklas Sundblad,1973-01-03,0,1996,1996,CGY
Norm Tustin,1919-01-03,0,1942,1942,NYR
Stefan Ustorf,1974-01-03,1,1996,1997,WSH
Sergei Vyshedkevich,1975-01-03,1,2000,2001,ATL
Mike Walton,1945-01-03,13,1966,1979,"TOR,BOS,VAN,CBH,STL"
Todd Warriner,1974-01-03,8,1995,2003,"TOR,TBL,PHX,VAN,NSH,PHI"
Mike York,1978-01-03,9,2000,2009,"NYR,EDM,NYI,PHI,PHX,CBJ"
Jergus Baca,1965-01-04,1,1991,1992,HAR
Earl Balfour,1933-01-04,9,1952,1961,"TOR,CBH"
David Broll,1993-01-04,0,2014,2014,TOR
Charles Cahill,1904-01-04,1,1926,1927,BOS
Kevin Colley,1979-01-04,0,2006,2006,NYI
Greg de Vries,1973-01-04,13,1996,2009,"EDM,COL,NSH,NYR,OTT,ATL"
Trevor Fahey,1944-01-04,0,1965,1965,NYR
Seth Griffith,1993-01-04,3,2015,2018,"BOS,FLA,TOR,BUF"
Nico Hischier,1999-01-04,2,2018,2020,NJD
Jiri Hudler,1984-01-04,13,2004,2017,"DET,CGY,FLA,DAL"
Cole Jarrett,1983-01-04,0,2006,2006,NYI
Michael Ker√§nen,1990-01-04,0,2016,2016,MIN
James Latos,1966-01-04,0,1989,1989,NYR
Maxime Macenauer,1989-01-04,0,2012,2012,ANA
Kenndal McArdle,1987-01-04,3,2009,2012,"FLA,WPG"
Robert McDonald,1923-01-04,0,1944,1944,NYR
Freddy Meyer,1981-01-04,7,2004,2011,"PHI,NYI,PHX,ATL"
Herb Mitchell,1896-01-04,1,1925,1926,BOS
Dmitri Nabokov,1977-01-04,2,1998,2000,"CHI,NYI"
Patrick Russell,1993-01-04,1,2019,2020,EDM
Brian Strait,1988-01-04,6,2011,2017,"PIT,NYI,WPG"
Brad Zavisha,1972-01-04,0,1994,1994,EDM
John Brenneman,1943-01-05,4,1965,1969,"CBH,NYR,TOR,DET,OAK"
Kyle Calder,1979-01-05,10,2000,2010,"CHI,DET,PHI,LAK,ANA"
James Camazzola,1964-01-05,3,1984,1987,"CBH,CHI"
Gene Chouinard,1902-01-05,0,1928,1928,OTS
Stan Drulia,1968-01-05,8,1993,2001,TBL
Vitezslav Duris,1954-01-05,2,1981,1983,TOR
Zemgus Girgensons,1994-01-05,6,2014,2020,BUF
Fred Glover,1928-01-05,3,1950,1953,"DET,CBH"
Mike Grier,1975-01-05,14,1997,2011,"EDM,WSH,BUF,SJS"
Matt Grzelcyk,1994-01-05,3,2017,2020,BOS
Ron Homenuke,1952-01-05,0,1973,1973,VAN
Jiri Hrdina,1958-01-05,4,1988,1992,"CGY,PIT"
Joe Juneau,1968-01-05,12,1992,2004,"BOS,WSH,BUF,OTT,PHX,MTL"
Tim Kerr,1960-01-05,12,1981,1993,"PHI,NYR,HAR"
Eddie Lack,1988-01-05,4,2014,2018,"VAN,CAR,CGY,NJD"
Brett MacDonald,1966-01-05,0,1988,1988,VAN
Kevin Maguire,1963-01-05,5,1987,1992,"TOR,BUF,PHI"
Basil McRae,1961-01-05,15,1982,1997,"QUE,TOR,DET,MNS,STL,TBL,CHI"
Brian McReynolds,1965-01-05,4,1990,1994,"WIN,NYR,LAK"
Dakota Mermis,1994-01-05,2,2018,2020,"ARI,NJD"
Mathieu Perreault,1988-01-05,10,2010,2020,"WSH,ANA,WPG"
Gerry Plamondon,1924-01-05,5,1946,1951,MTL
Ray Podloski,1966-01-05,0,1989,1989,BOS
Corey Potter,1984-01-05,7,2009,2016,"NYR,PIT,EDM,BOS,CGY,NSH"
Wayne Rutledge,1942-01-05,2,1968,1970,LAK
Alexander Salak,1987-01-05,0,2010,2010,FLA
Anthony Stewart,1985-01-05,6,2006,2012,"FLA,ATL,CAR"
Alex Tidey,1955-01-05,3,1977,1980,"BUF,EDM"
Zellio Toppazzini,1930-01-05,8,1949,1957,"BOS,NYR,CBH"
Steve Tuttle,1966-01-05,2,1989,1991,STL
Mikhail Vorobyev,1997-01-05,1,2019,2020,PHI
Doug Barkley,1937-01-06,8,1958,1966,"CBH,DET"
Andre Benoit,1984-01-06,5,2011,2016,"OTT,COL,BUF,STL"
David Brine,1985-01-06,0,2008,2008,FLA
Adam Burish,1983-01-06,8,2007,2015,"CHI,DAL,SJS"
Will Butcher,1995-01-06,2,2018,2020,NJD
Bob Cook,1946-01-06,4,1971,1975,"VAN,DET,NYI,MNS"
Ryan Craig,1982-01-06,9,2006,2015,"TBL,PIT,CBJ"
Keith Crowder,1959-01-06,9,1981,1990,"BOS,LAK"
Johan Davidsson,1976-01-06,1,1999,2000,"MDA,NYI"
Nicolas Deschamps,1990-01-06,0,2014,2014,WSH
Scott Ferguson,1973-01-06,8,1998,2006,"EDM,MDA,MIN"
Alex Forsyth,1955-01-06,0,1977,1977,WSH
Guy Gosselin,1964-01-06,0,1988,1988,WIN
Harold Halderson,1900-01-06,0,1927,1927,"DTC,TOR"
Kari Jalonen,1960-01-06,1,1983,1984,"CGY,EDM"
Ryan Keller,1984-01-06,0,2010,2010,OTT
Brett Kulak,1994-01-06,5,2015,2020,"CGY,MTL"
Scott Lehman,1986-01-06,0,2009,2009,ATL
Roman Lyubimov,1992-01-06,0,2017,2017,PHI
Nathan McIver,1985-01-06,2,2007,2009,"VAN,ANA"
Dick Meissner,1940-01-06,5,1960,1965,"BOS,NYR"
Scott Metcalfe,1967-01-06,2,1988,1990,"BUF,EDM"
Dickie Moore*,1931-01-06,16,1952,1968,"MTL,TOR,STL"
Paul Reinhart,1960-01-06,10,1980,1990,"ATF,CGY,VAN"
Rob Valicevic,1971-01-06,5,1999,2004,"NSH,LAK,MDA,DAL"
Leigh Verstraete,1962-01-06,5,1983,1988,TOR
Carl Voss*,1907-01-06,11,1927,1938,"TOR,DET,NYR,OTS,STE,NYA,MTM,CBH"
Richard Zednik,1976-01-06,13,1996,2009,"WSH,MTL,NYI,FLA"
Alex Auld,1981-01-07,10,2002,2012,"VAN,FLA,BOS,PHX,OTT,DAL,NYR,MTL"
Cody Bass,1987-01-07,9,2008,2017,"OTT,CBJ,NSH"
Yves Beaudoin,1965-01-07,2,1986,1988,WSH
Larry Bignell,1950-01-07,0,1974,1974,PIT
Luciano Borsato,1966-01-07,4,1991,1995,WIN
Donald Brashear,1972-01-07,16,1994,2010,"MTL,VAN,PHI,WSH,NYR"
Randy Burridge,1966-01-07,12,1986,1998,"BOS,WSH,LAK,BUF"
Rod Buskas,1961-01-07,10,1983,1993,"PIT,VAN,LAK,CHI"
Noah Dobson,2000-01-07,0,2020,2020,NYI
Bill Fairbairn,1947-01-07,10,1969,1979,"NYR,MNS,STL"
Erik Gudbranson,1992-01-07,8,2012,2020,"FLA,VAN,PIT,ANA"
Guy Hebert,1967-01-07,9,1992,2001,"STL,MDA,NYR"
Patrick Holland,1992-01-07,0,2014,2014,MTL
Jani Hurme,1975-01-07,3,2000,2003,"OTT,FLA"
Lloyd Jackson,1912-01-07,0,1937,1937,NYA
Steve Janaszak,1957-01-07,2,1980,1982,"MNS,CLR"
Doug Keans,1958-01-07,8,1980,1988,"LAK,BOS"
Mikhail Kuleshov,1981-01-07,0,2004,2004,COL
Denny Lambert,1970-01-07,7,1995,2002,"MDA,OTT,NSH,ATL"
Mike Liut,1956-01-07,12,1980,1992,"STL,HAR,WSH"
Zack Mitchell,1993-01-07,1,2017,2018,MIN
Alex Nedeljkovic,1996-01-07,3,2017,2020,CAR
Babe Pratt*,1916-01-07,11,1936,1947,"NYR,TOR,BOS"
Mike Rosati,1968-01-07,0,1999,1999,WSH
Aleksi Saarela,1997-01-07,0,2020,2020,FLA
Barry Salovaara,1948-01-07,1,1975,1976,DET
Brendan Shinnimin,1991-01-07,0,2015,2015,ARI
Hooley Smith*,1903-01-07,16,1925,1941,"OTS,MTM,BOS,NYA"
Brent Sopel,1977-01-07,12,1999,2011,"VAN,LAK,NYI,CHI,ATL,MTL"
Michael Thelven,1961-01-07,4,1986,1990,BOS
Morris Titanic,1953-01-07,1,1975,1976,BUF
MacKenzie Weegar,1994-01-07,3,2017,2020,FLA
Chris Wideman,1990-01-07,3,2016,2019,"OTT,EDM,FLA"
Johan Witehall,1972-01-07,2,1999,2001,"NYR,MTL"
Benny Woit,1928-01-07,6,1951,1957,"DET,CBH"
Garth Butcher,1963-01-08,13,1982,1995,"VAN,STL,QUE,TOR"
Mac Colville,1916-01-08,11,1936,1947,NYR
Max Comtois,1999-01-08,1,2019,2020,ANA
Bill Cupolo,1924-01-08,0,1945,1945,BOS
Ron Ellis,1945-01-08,17,1964,1981,TOR
Wally Hergesheimer,1927-01-08,7,1952,1959,"NYR,CBH"
William Karlsson,1993-01-08,5,2015,2020,"ANA,CBJ,VEG"
Jon Klemm,1970-01-08,16,1992,2008,"QUE,COL,CHI,DAL,LAK"
Jarno Kultanen,1973-01-08,2,2001,2003,BOS
Darren Langdon,1971-01-08,11,1995,2006,"NYR,CAR,VAN,MTL,NJD"
Trevor Lewis,1987-01-08,11,2009,2020,LAK
Dwayne Norris,1970-01-08,2,1994,1996,"QUE,MDA"
Joakim Nygard,1993-01-08,0,2020,2020,EDM
Dan Poliziani,1935-01-08,0,1959,1959,BOS
Marian Stastny,1953-01-08,4,1982,1986,"QUE,TOR"
Alexander Vasilevski,1975-01-08,1,1996,1997,STL
Emanuel Viveiros,1966-01-08,2,1986,1988,MNS
Igor Vyazmikin,1966-01-08,0,1991,1991,EDM
Steve Witiuk,1929-01-08,0,1952,1952,CBH
Vitali Yachmenev,1975-01-08,7,1996,2003,"LAK,NSH"
Radek Bonk,1976-01-09,14,1995,2009,"OTT,MTL,NSH"
Helge Bostrom,1894-01-09,3,1930,1933,CBH
Bruce Boudreau,1955-01-09,9,1977,1986,"TOR,CBH"
Ken Breitenbach,1955-01-09,3,1976,1979,BUF
Fred Burchell,1931-01-09,3,1951,1954,MTL
Jack Campbell,1992-01-09,6,2014,2020,"DAL,LAK,TOR"
Kevin Czuczman,1991-01-09,0,2014,2014,NYI
Raphael Diaz,1986-01-09,3,2012,2015,"MTL,NYR,VAN,CGY"
Anders Eriksson,1975-01-09,14,1996,2010,"DET,CHI,FLA,TOR,CBJ,CGY,NYR,PHX"
Radek Faksa,1994-01-09,4,2016,2020,DAL
Mathieu Garon,1978-01-09,12,2001,2013,"MTL,LAK,EDM,PIT,CBJ,TBL"
Justin Hocking,1974-01-09,0,1994,1994,LAK
Jamie Huscroft,1967-01-09,11,1989,2000,"NJD,BOS,CGY,TBL,VAN,PHX,WSH"
Gaston Leroux,1913-01-09,0,1936,1936,MTL
Rick Lessard,1968-01-09,3,1989,1992,"CGY,SJS"
David Ling,1975-01-09,7,1997,2004,"MTL,CBJ"
Dwayne Lowdermilk,1958-01-09,0,1981,1981,WSH
Ken McAuley,1921-01-09,1,1944,1945,NYR
Rob McClanahan,1958-01-09,4,1980,1984,"BUF,HAR,NYR"
Dave McLlwain,1967-01-09,9,1988,1997,"PIT,WIN,BUF,NYI,TOR,OTT"
Travis Morin,1984-01-09,4,2011,2015,DAL
Dennis Patterson,1950-01-09,5,1975,1980,"KCS,PHI"
Scott Pellerin,1970-01-09,11,1993,2004,"NJD,STL,CAR,MIN,BOS,DAL,PHX"
Brent Thompson,1971-01-09,5,1992,1997,"LAK,WIN,PHX"
Scott Thornton,1971-01-09,17,1991,2008,"TOR,EDM,MTL,DAL,SJS,LAK"
Doug Volmar,1945-01-09,2,1971,1973,"DET,LAK"
Jim Wiemer,1961-01-09,10,1984,1994,"BUF,NYR,EDM,LAK,BOS"
Stephane Beauregard,1968-01-10,4,1990,1994,"WIN,PHI"
Doug Brennan,1905-01-10,2,1932,1934,NYR
Bill Butters,1951-01-10,1,1978,1979,MNS
John Carlson,1990-01-10,10,2010,2020,WSH
Dean Clark,1964-01-10,0,1984,1984,EDM
Danton Cole,1967-01-10,6,1990,1996,"WIN,TBL,NJD,CHI,NYI"
Lloyd Doran,1921-01-10,0,1947,1947,DET
Tom Gilbert,1983-01-10,10,2007,2017,"EDM,MIN,FLA,MTL,LAK"
George Hay*,1898-01-10,6,1927,1933,"CBH,DTC,DTF,DET"
Martin Jones,1990-01-10,6,2014,2020,"LAK,SJS"
Normand Leveille,1963-01-10,1,1982,1983,BOS
Frank Mahovlich*,1938-01-10,17,1957,1974,"TOR,DET,MTL"
Randy Manery,1949-01-10,9,1971,1980,"DET,ATF,LAK"
Don Metz,1916-01-10,9,1940,1949,TOR
Robert Nilsson,1985-01-10,4,2006,2010,"NYI,EDM"
Tobias Rieder,1993-01-10,5,2015,2020,"ARI,LAK,EDM,CGY"
Jeff Serowik,1967-01-10,8,1991,1999,"TOR,BOS,PIT"
Rastislav Stana,1980-01-10,0,2004,2004,WSH
Morris Stefaniw,1948-01-10,0,1973,1973,ATF
Henrik Tallinder,1979-01-10,12,2002,2014,"BUF,NJD"
Vladimir Zharkov,1988-01-10,2,2010,2012,NJD
Marc Behrend,1961-01-11,2,1984,1986,WIN
Yves Bergeron,1952-01-11,2,1975,1977,PIT
Tim Bergland,1965-01-11,4,1990,1994,"WSH,TBL"
Connie Brown,1917-01-11,4,1939,1943,DET
Dave Burrows,1949-01-11,9,1972,1981,"PIT,TOR"
Kent Carlson,1962-01-11,5,1984,1989,"MTL,STL,WSH"
Mike Corrigan,1946-01-11,10,1968,1978,"LAK,VAN,PIT"
Rory Fitzpatrick,1975-01-11,12,1996,2008,"MTL,STL,NSH,BUF,VAN,PHI"
Wade Flaherty,1968-01-11,11,1992,2003,"SJS,NYI,TBL,FLA,NSH"
Red Hamill,1917-01-11,13,1938,1951,"BOS,CBH"
Nicolas Kerdiles,1994-01-11,1,2017,2018,ANA
Dave Kerr,1910-01-11,10,1931,1941,"MTM,NYA,NYR"
Peter LeBoutillier,1975-01-11,1,1997,1998,MDA
Justin Mapletoft,1981-01-11,1,2003,2004,NYI
Ryan Mulhern,1973-01-11,0,1998,1998,WSH
Mark Pysyk,1992-01-11,7,2013,2020,"BUF,FLA"
Rob Ramage,1959-01-11,14,1980,1994,"CLR,STL,CGY,TOR,MNS,MTL,TBL,PHI"
Dave Reid,1934-01-11,3,1953,1956,TOR
Bobby Sheehan,1949-01-11,12,1970,1982,"MTL,CGS,CBH,DET,CLR,LAK"
Ron Stern,1967-01-11,12,1988,2000,"VAN,CGY,SJS"
Fred Thurier,1916-01-11,4,1941,1945,"NYA,BRO,NYR"
Josh Tordjman,1985-01-11,0,2009,2009,PHX
Warren Young,1956-01-11,6,1982,1988,"MNS,PIT,DET"
Richard Bittner,1922-01-12,0,1950,1950,BOS
Nikolai Borschevsky,1965-01-12,3,1993,1996,"TOR,CGY,DAL"
Josef Boumedienne,1978-01-12,2,2002,2004,"NJD,TBL,WSH"
Frank Carson,1902-01-12,8,1926,1934,"MTM,NYA,DTF,DET"
Hap Emms,1905-01-12,11,1927,1938,"MTM,NYA,DTF,DET,BOS"
Daryl Evans,1961-01-12,5,1982,1987,"LAK,WSH,TOR"
Curt Fraser,1958-01-12,11,1979,1990,"VAN,CBH,CHI,MNS"
Claude Giroux,1988-01-12,12,2008,2020,PHI
Ben Harpur,1995-01-12,3,2016,2019,OTT
Frank Heffernan,1892-01-12,0,1920,1920,TRS
Brian Hill,1957-01-12,0,1980,1980,HAR
Tim Horton*,1930-01-12,24,1950,1974,"TOR,NYR,PIT,BUF"
Marian Hossa*,1979-01-12,19,1998,2017,"OTT,ATL,PIT,DET,CHI"
David Kampf,1995-01-12,2,2018,2020,CHI
Espen Knutsen,1972-01-12,6,1998,2004,"MDA,CBJ"
Niklas Kronwall,1981-01-12,15,2004,2019,DET
Maxime Lagace,1993-01-12,1,2018,2019,VEG
Dan Lambert,1970-01-12,1,1991,1992,QUE
Fern LeBlanc,1956-01-12,2,1977,1979,DET
Mike McBain,1977-01-12,1,1998,1999,TBL
Jay More,1969-01-12,10,1989,1999,"NYR,MNS,SJS,PHX,CHI,NSH"
Rich Parent,1973-01-12,3,1998,2001,"STL,TBL,PIT"
Alex Pirus,1955-01-12,3,1977,1980,"MNS,DET"
Armand Raymond,1913-01-12,2,1938,1940,MTL
Herb Rheaume,1900-01-12,0,1926,1926,MTL
Dave Ritchie,1892-01-12,8,1918,1926,"MTW,OTS,TRA,QBC,MTL"
Cam Russell,1969-01-12,9,1990,1999,"CHI,COL"
Jack Shill,1913-01-12,5,1934,1939,"TOR,BOS,CBH,NYA"
Dennis Sobchuk,1954-01-12,3,1980,1983,"DET,QUE"
Jocelyn Thibault,1975-01-12,14,1994,2008,"QUE,COL,MTL,CHI,PIT,BUF"
Lindsay Vallis,1971-01-12,0,1994,1994,MTL
Rick Vasko,1957-01-12,3,1978,1981,DET
Pete Bessone,1913-01-13,0,1938,1938,DET
Tyler Bouck,1980-01-13,6,2001,2007,"DAL,PHX,VAN"
Sergei Brylin,1974-01-13,13,1995,2008,NJD
Kyle Clifford,1991-01-13,9,2011,2020,"LAK,TOR"
Jeremy Colliton,1985-01-13,5,2006,2011,NYI
Robb Gordon,1976-01-13,0,1999,1999,VAN
Paul Higgins,1962-01-13,1,1982,1983,TOR
Kelly Hrudey,1961-01-13,14,1984,1998,"NYI,LAK,SJS"
Jack Johnson,1987-01-13,13,2007,2020,"LAK,CBJ,PIT"
Nikolai Khabibulin,1973-01-13,19,1995,2014,"WIN,PHX,TBL,CHI,EDM"
Lloyd Klein,1910-01-13,9,1929,1938,"BOS,NYA"
Adie Lafrance,1912-01-13,0,1934,1934,MTL
Maxim Mamin,1995-01-13,1,2018,2019,FLA
Cesare Maniago,1939-01-13,17,1961,1978,"TOR,MTL,NYR,MNS,VAN"
Connor McDavid,1997-01-13,4,2016,2020,EDM
Graeme Nicolson,1958-01-13,4,1979,1983,"BOS,CLR,NYR"
Mike Palmateer,1954-01-13,7,1977,1984,"TOR,WSH"
Allen Pedersen,1965-01-13,7,1987,1994,"BOS,MNS,HAR"
Roger Picard,1935-01-13,0,1968,1968,STL
Adrien Plavsic,1970-01-13,7,1990,1997,"STL,VAN,TBL,MDA"
Ivan Provorov,1997-01-13,3,2017,2020,PHI
Art Ross*,1886-01-13,0,1918,1918,MTW
Mike Rupp,1980-01-13,11,2003,2014,"NJD,PHX,CBJ,PIT,NYR,MIN"
Ryan Sproul,1993-01-13,4,2014,2018,"DET,NYR"
Marc Staal,1987-01-13,12,2008,2020,NYR
Yakov Trenin,1997-01-13,0,2020,2020,NSH
Austin Watson,1992-01-13,7,2013,2020,NSH
Zdenek Blatny,1981-01-14,3,2003,2006,"ATL,BOS"
Fred Boimistruck,1962-01-14,1,1982,1983,TOR
Nick Boynton,1979-01-14,11,2000,2011,"BOS,PHX,FLA,ANA,CHI,PHI"
Connor Brown,1994-01-14,4,2016,2020,"TOR,OTT"
Eric Charron,1970-01-14,7,1993,2000,"MTL,TBL,WSH,CGY"
Nick Drazenovic,1987-01-14,3,2011,2014,"STL,CBJ,PIT"
David Emma,1969-01-14,8,1993,2001,"NJD,BOS,FLA"
Bob Essensa,1965-01-14,13,1989,2002,"WIN,DET,EDM,PHX,VAN,BUF"
Peter Holland,1991-01-14,6,2012,2018,"ANA,TOR,ARI,NYR"
Greg Johnston,1965-01-14,8,1984,1992,"BOS,TOR"
Justin Kurtz,1977-01-14,0,2002,2002,VAN
Dave MacKay,1919-01-14,0,1941,1941,CBH
Don MacLean,1977-01-14,9,1998,2007,"LAK,TOR,CBJ,DET,PHX"
Alan May,1965-01-14,7,1988,1995,"BOS,EDM,WSH,DAL,CGY"
Sergei Nemchinov,1964-01-14,10,1992,2002,"NYR,VAN,NYI,NJD"
Mark Pederson,1968-01-14,4,1990,1994,"MTL,PHI,SJS,DET"
Tom Pederson,1970-01-14,4,1993,1997,"SJS,TOR"
Andrew Poturalski,1994-01-14,0,2017,2017,CAR
George Ranieri,1936-01-14,0,1957,1957,BOS
Terry Ryan,1977-01-14,2,1997,1999,MTL
Babe Siebert*,1904-01-14,13,1926,1939,"MTM,NYR,BOS,MTL"
Aud Tuten,1914-01-14,1,1942,1943,CBH
Mike Wong,1955-01-14,0,1976,1976,DET
Mason Appleton,1996-01-15,1,2019,2020,WPG
Francis Belanger,1978-01-15,0,2001,2001,MTL
John Bethel,1957-01-15,0,1980,1980,WIN
Steve Brule,1975-01-15,0,2003,2003,COL
Adam Burt,1969-01-15,12,1989,2001,"HAR,CAR,PHI,ATL"
Cade Fairchild,1989-01-15,0,2012,2012,STL
Ron Handy,1963-01-15,3,1985,1988,"NYI,STL"
Randy Holt,1953-01-15,9,1975,1984,"CBH,CLE,LAK,VAN,CGY,WSH,PHI"
Willie Huber,1958-01-15,9,1979,1988,"DET,NYR,PHI,VAN"
Bjorn Johansson,1956-01-15,1,1977,1978,CLE
Alexander Korolyuk,1976-01-15,6,1998,2004,SJS
Brett Lebda,1982-01-15,6,2006,2012,"DET,TOR,CBJ"
Rob McVicar,1982-01-15,0,2006,2006,VAN
Hillary Menard,1934-01-15,0,1954,1954,CBH
Mike Murphy,1989-01-15,0,2012,2012,CAR
Martin Necas,1999-01-15,2,2018,2020,CAR
Justin Papineau,1980-01-15,2,2002,2004,"STL,NYI"
Nolan Schaefer,1980-01-15,0,2006,2006,SJS
Cam Severson,1978-01-15,3,2003,2006,"MDA,CBJ"
Martin Strbak,1975-01-15,0,2004,2004,"LAK,PIT"
Alexander Suglobov,1982-01-15,3,2004,2007,"NJD,TOR"
Slava Voynov,1990-01-15,3,2012,2015,LAK
Alex Wood,1911-01-15,0,1937,1937,NYA
Lou Angotti,1938-01-16,9,1965,1974,"NYR,CBH,PHI,PIT,STL"
Darren Boyko,1964-01-16,0,1989,1989,WIN
Gary Burns,1955-01-16,0,1981,1981,NYR
Polly Drouin,1916-01-16,6,1935,1941,MTL
Matt Duchene,1991-01-16,10,2010,2020,"COL,OTT,CBJ,NSH"
Daniel Goneau,1976-01-16,3,1997,2000,NYR
Ken Kilrea,1919-01-16,5,1939,1944,DET
Scot Kleinendorst,1960-01-16,7,1983,1990,"NYR,HAR,WSH"
Stephen Leach,1966-01-16,14,1986,2000,"WSH,BOS,STL,CAR,OTT,PHX,PIT"
Jamie Lundmark,1981-01-16,7,2003,2010,"NYR,CGY,PHX,LAK,TOR"
Masi Marjamaki,1985-01-16,0,2006,2006,NYI
Pat McReavy,1918-01-16,3,1939,1942,"BOS,DET"
Brenden Morrow,1979-01-16,15,2000,2015,"DAL,PIT,STL,TBL"
Petteri Nokelainen,1986-01-16,6,2006,2012,"NYI,BOS,ANA,PHX,MTL"
Derrick Pouliot,1994-01-16,5,2015,2020,"PIT,VAN,STL"
Todd Rohloff,1974-01-16,2,2002,2004,"WSH,CBJ"
Kurt Sauer,1981-01-16,7,2003,2010,"MDA,COL,PHX"
John Sorrell,1906-01-16,10,1931,1941,"DTF,DET,NYA"
Ben Thomson,1993-01-16,0,2017,2017,NJD
Jason Ward,1979-01-16,9,2000,2009,"MTL,NYR,LAK,TBL"
Jason Zucker,1992-01-16,8,2012,2020,"MIN,PIT"
Tim Bernhardt,1958-01-17,4,1983,1987,"CGY,TOR"
Leo Bourgeault,1903-01-17,8,1927,1935,"NYR,TOR,OTS,MTL"
Russ Brayshaw,1918-01-17,0,1945,1945,CBH
Al Conroy,1966-01-17,2,1992,1994,PHI
Scott Foster,1982-01-17,0,2018,2018,CHI
Stanislav Galiev,1992-01-17,1,2015,2016,WSH
Jeff Heerema,1980-01-17,1,2003,2004,"CAR,STL"
Ryan Hughes,1972-01-17,0,1996,1996,BOS
Fred Hunt,1918-01-17,4,1941,1945,"NYA,NYR"
Pep Kelly,1914-01-17,7,1935,1942,"TOR,CBH,BRO"
Milan Kraft,1980-01-17,3,2001,2004,PIT
Derek Plante,1971-01-17,7,1994,2001,"BUF,DAL,CHI,PHI"
Jacques Plante*,1929-01-17,20,1953,1973,"MTL,NYR,STL,TOR,BOS"
Richie Regehr,1983-01-17,1,2006,2007,CGY
Jeremy Roenick,1970-01-17,20,1989,2009,"CHI,PHX,PHI,LAK,SJS"
Viktor Stalberg,1986-01-17,7,2010,2017,"TOR,CHI,NSH,NYR,CAR,OTT"
Sylvain Turgeon,1965-01-17,11,1984,1995,"HAR,NJD,MTL,OTT"
Mark Van Guilder,1984-01-17,0,2014,2014,NSH
Aaron Ward,1973-01-17,16,1994,2010,"DET,CAR,BOS,NYR,ANA"
Craig Weller,1981-01-17,1,2008,2009,"PHX,MIN"
Mike Zigomanis,1981-01-17,8,2003,2011,"CAR,STL,PHX,PIT,TOR"
Syl Apps*,1915-01-18,11,1937,1948,TOR
Alain Belanger,1956-01-18,0,1978,1978,TOR
Radim Bicanek,1975-01-18,7,1995,2002,"OTT,CHI,CBJ"
Mike Blaisdell,1960-01-18,8,1981,1989,"DET,NYR,PIT,TOR"
Ryan Carpenter,1991-01-18,4,2016,2020,"SJS,VEG,CHI"
Pheonix Copley,1992-01-18,3,2016,2019,"STL,WSH"
Ruslan Fedotenko,1979-01-18,12,2001,2013,"PHI,TBL,NYI,PIT,NYR"
Jere Gillis,1957-01-18,9,1978,1987,"VAN,NYR,QUE,BUF,PHI"
Brian Gionta,1979-01-18,16,2002,2018,"NJD,MTL,BUF,BOS"
Chuck Hamilton,1939-01-18,11,1962,1973,"MTL,STL"
Jim Hamilton,1957-01-18,7,1978,1985,PIT
Josh Holden,1978-01-18,5,1999,2004,"VAN,CAR,TOR"
Dean Kennedy,1963-01-18,12,1983,1995,"LAK,NYR,BUF,WIN,EDM"
Jason LaBarbera,1980-01-18,14,2001,2015,"NYR,LAK,VAN,PHX,EDM,ANA"
Max Labovitch,1924-01-18,0,1944,1944,NYR
Pete Laframboise,1950-01-18,3,1972,1975,"CGS,PIT,WSH"
Denis Malgin,1997-01-18,3,2017,2020,"FLA,TOR"
Andrew McBain,1965-01-18,10,1984,1994,"WIN,PIT,VAN,OTT"
Mark Messier*,1961-01-18,24,1980,2004,"EDM,NYR,VAN"
Alex Pietrangelo,1990-01-18,11,2009,2020,STL
Jamie Ram,1971-01-18,0,1996,1996,NYR
Chad Rau,1987-01-18,0,2012,2012,MIN
Fern Rivard,1946-01-18,6,1969,1975,MNS
Jaime Sifers,1983-01-18,1,2009,2010,"TOR,MIN"
Jesse Spring,1901-01-18,6,1924,1930,"HAM,PTP,TOR,NYA"
Scott Thomas,1970-01-18,8,1993,2001,"BUF,LAK"
John Albert,1989-01-19,0,2014,2014,WPG
Johnny Boychuk,1984-01-19,12,2008,2020,"COL,BOS,NYI"
Gary Bromley,1950-01-19,7,1974,1981,"BUF,VAN"
Billy Carroll,1959-01-19,6,1981,1987,"NYI,EDM,DET"
Sylvain Cote,1966-01-19,18,1985,2003,"HAR,WSH,TOR,CHI,DAL"
Tyler Cuma,1990-01-19,0,2012,2012,MIN
Kimbi Daniels,1972-01-19,1,1991,1992,PHI
Norm Defelice,1933-01-19,0,1957,1957,BOS
John Gallagher,1909-01-19,8,1931,1939,"MTM,DET,NYA"
Larry Goodenough,1953-01-19,5,1975,1980,"PHI,VAN"
Gord Hannigan,1929-01-19,3,1953,1956,TOR
Busher Jackson*,1911-01-19,14,1930,1944,"TOR,NYA,BOS"
Francis Kane,1923-01-19,0,1944,1944,DET
Ed Kea,1948-01-19,9,1974,1983,"ATF,STL"
Mike Komisarek,1982-01-19,11,2003,2014,"MTL,TOR,CAR"
Ian Laperriere,1974-01-19,16,1994,2010,"STL,LAK,NYR,COL,PHI"
Ross Lupaschuk,1981-01-19,0,2003,2003,PIT
Don McLean,1954-01-19,0,1976,1976,WSH
Sean McMorrow,1982-01-19,0,2003,2003,BUF
Dunc Munro,1901-01-19,7,1925,1932,"MTM,MTL"
Timo Parssinen,1977-01-19,0,2002,2002,MDA
Jukka Porvari,1954-01-19,1,1982,1983,"CLR,NJD"
Art Somers,1902-01-19,5,1930,1935,"CBH,NYR"
Thomas Vanek,1984-01-19,13,2006,2019,"BUF,MTL,NYI,MIN,DET,FLA,CBJ,VAN"
Jordy Douglas,1958-01-20,5,1980,1985,"HAR,MNS,WIN"
Lou Fontinato,1932-01-20,8,1955,1963,"NYR,MTL"
Bob Frampton,1929-01-20,0,1950,1950,MTL
Rob Gaudreau,1970-01-20,3,1993,1996,"SJS,OTT"
Gabe Gauthier,1984-01-20,1,2007,2008,LAK
Alex Grant,1989-01-20,2,2014,2016,"ANA,ARI"
Inge Hammarstrom,1948-01-20,5,1974,1979,"TOR,STL"
Eric Healey,1975-01-20,0,2006,2006,BOS
Jamie Hislop,1954-01-20,4,1980,1984,"QUE,CGY"
Joe Jerwa,1907-01-20,8,1931,1939,"NYR,BOS,NYA"
Maxim Kondratiev,1983-01-20,4,2004,2008,"TOR,NYR,ANA"
Sean Kuraly,1993-01-20,3,2017,2020,BOS
Eric Landry,1975-01-20,4,1998,2002,"CGY,MTL"
Chuck Lefley,1950-01-20,10,1971,1981,"MTL,STL"
Bryan Lerg,1986-01-20,1,2015,2016,SJS
Grant Lewis,1985-01-20,0,2009,2009,ATL
Hampus Lindholm,1994-01-20,6,2014,2020,ANA
Kari Makkonen,1955-01-20,0,1980,1980,EDM
Christian Matte,1975-01-20,4,1997,2001,"COL,MIN"
Roland McKeown,1996-01-20,0,2018,2018,CAR
Josef Melichar,1979-01-20,8,2001,2009,"PIT,CAR,TBL"
Jan Mursak,1988-01-20,2,2011,2013,DET
Ryan Reaves,1987-01-20,9,2011,2020,"STL,PIT,VEG"
Mike Sislo,1988-01-20,2,2014,2016,NJD
Anthony Stolarz,1994-01-20,3,2017,2020,"PHI,EDM,ANA"
Dick Tarnstrom,1975-01-20,6,2002,2008,"NYI,PIT,EDM,CBJ"
Nikos Tselios,1979-01-20,0,2002,2002,CAR
Ron Anderson,1950-01-21,0,1975,1975,WSH
Oskars Bartulis,1987-01-21,1,2010,2011,PHI
Brian Bradley,1965-01-21,12,1986,1998,"CGY,VAN,TOR,TBL"
Josh Brown,1994-01-21,1,2019,2020,FLA
Craig Coxe,1964-01-21,7,1985,1992,"VAN,CGY,STL,SJS"
Kirby Dach,2001-01-21,0,2020,2020,CHI
Ulf Dahlen,1967-01-21,15,1988,2003,"NYR,MNS,DAL,SJS,CHI,WSH"
Andreas Englund,1996-01-21,3,2017,2020,OTT
Bobby Farnham,1989-01-21,2,2015,2017,"PIT,NJD,MTL"
Dany Heatley,1981-01-21,13,2002,2015,"ATL,OTT,SJS,MIN,ANA"
Darren Helm,1987-01-21,12,2008,2020,DET
Burke Henry,1979-01-21,1,2003,2004,CHI
Quinton Howden,1992-01-21,4,2013,2017,"FLA,WPG"
Mike Keating,1957-01-21,0,1978,1978,NYR
Tom Kuhnhackl,1992-01-21,4,2016,2020,"PIT,NYI"
John LeBlanc,1964-01-21,8,1987,1995,"VAN,EDM,WIN"
Moe Mantha,1961-01-21,11,1981,1992,"WIN,PIT,EDM,MNS,PHI"
Craig Martin,1971-01-21,2,1995,1997,"WIN,FLA"
Brayden McNabb,1991-01-21,8,2012,2020,"BUF,LAK,VEG"
Griffen Molino,1994-01-21,0,2017,2017,VAN
Jonathan Quick,1986-01-21,12,2008,2020,LAK
John Quilty,1921-01-21,7,1941,1948,"MTL,BOS"
Michal Sivek,1981-01-21,0,2003,2003,PIT
Tobias Stephan,1984-01-21,1,2008,2009,DAL
Ryan Suter,1985-01-21,14,2006,2020,"NSH,MIN"
Georges Vezina*,1887-01-21,8,1918,1926,MTL
Doug Weight,1971-01-21,19,1992,2011,"NYR,EDM,STL,CAR,ANA,NYI"
Dmitri Yakushin,1978-01-21,0,2000,2000,TOR
Andrei Zyuzin,1978-01-21,10,1998,2008,"SJS,TBL,NJD,MIN,CGY,CHI"
Mike Bossy*,1957-01-22,9,1978,1987,NYI
Tom Brennan,1922-01-22,1,1944,1945,BOS
Shean Donovan,1975-01-22,15,1995,2010,"SJS,COL,ATL,PIT,CGY,BOS,OTT"
Bill Durnan*,1916-01-22,6,1944,1950,MTL
Ben Eager,1984-01-22,8,2006,2014,"PHI,CHI,ATL,SJS,EDM"
Robert Esche,1978-01-22,8,1999,2007,"PHX,PHI"
Robby Fabbri,1996-01-22,4,2016,2020,"STL,DET"
Greg Gilbert,1962-01-22,14,1982,1996,"NYI,CHI,NYR,STL"
Jon Gillies,1994-01-22,1,2017,2018,CGY
Nicklas Grossmann,1985-01-22,10,2007,2017,"DAL,PHI,ARI,CGY"
Sami Helenius,1974-01-22,6,1997,2003,"CGY,TBL,COL,DAL,CHI"
Joshua Ho-Sang,1996-01-22,2,2017,2019,NYI
Elmer Lach*,1918-01-22,13,1941,1954,MTL
Simon Lajeunesse,1981-01-22,0,2002,2002,OTT
Jay Mazur,1965-01-22,3,1989,1992,VAN
John Mitchell,1985-01-22,8,2009,2017,"TOR,NYR,COL"
Oscar Moller,1989-01-22,2,2009,2011,LAK
Ken Murray,1948-01-22,6,1970,1976,"TOR,DET,NYI,KCS"
Dick Sarrazin,1946-01-22,3,1969,1972,PHI
Serge Savard*,1946-01-22,16,1967,1983,"MTL,WIN"
Scott Shaunessy,1964-01-22,2,1987,1989,QUE
Kole Sherwood,1997-01-22,1,2019,2020,CBJ
Derrick Smith,1965-01-22,9,1985,1994,"PHI,MNS,DAL"
Damian Surma,1981-01-22,1,2003,2004,CAR
J.C. Tremblay,1939-01-22,12,1960,1972,MTL
David Vyborny,1975-01-22,7,2001,2008,CBJ
Tom Younghans,1953-01-22,5,1977,1982,"MNS,NYR"
Timo Blomqvist,1961-01-23,5,1982,1987,"WSH,NJD"
Joel Bouchard,1974-01-23,11,1995,2006,"CGY,NSH,DAL,PHX,NJD,NYR,PIT,NYI"
Randy Boyd,1962-01-23,7,1982,1989,"PIT,CBH,NYI,VAN"
Steve Christoff,1958-01-23,4,1980,1984,"MNS,CGY,LAK"
Francois Groleau,1973-01-23,2,1996,1998,MTL
Scott Hannan,1979-01-23,16,1999,2015,"SJS,COL,WSH,CGY,NSH"
Tomas Holmstrom,1973-01-23,15,1997,2012,DET
Mark Kolesar,1973-01-23,1,1996,1997,TOR
Leo Komarov,1987-01-23,7,2013,2020,"TOR,NYI"
Lucas Lessio,1993-01-23,2,2014,2016,"PHX,ARI,MTL"
Ray Markham,1958-01-23,0,1980,1980,NYR
Boo Nieves,1994-01-23,3,2017,2020,NYR
Ivan Novoseltsev,1979-01-23,4,2000,2004,"FLA,PHX"
Steve Peters,1960-01-23,0,1980,1980,CLR
Jaroslav Pouzar,1952-01-23,4,1983,1987,EDM
Chris Pryor,1961-01-23,5,1985,1990,"MNS,NYI"
Darren Rumble,1969-01-23,13,1991,2004,"PHI,OTT,STL,TBL"
J.F. Sauve,1960-01-23,6,1981,1987,"BUF,QUE"
Brendan Shanahan*,1969-01-23,21,1988,2009,"NJD,STL,HAR,DET,NYR"
Richard Smehlik,1970-01-23,10,1993,2003,"BUF,ATL,NJD"
Martin Sonnenberg,1978-01-23,5,1999,2004,"PIT,CGY"
Fr√©d√©ric St. Denis,1986-01-23,3,2012,2015,"MTL,CBJ"
Jamie Tardif,1985-01-23,0,2013,2013,BOS
Chick Chalmers,1934-01-24,0,1954,1954,NYR
Guy Charron,1949-01-24,11,1970,1981,"MTL,DET,KCS,WSH"
Patrick Cote,1975-01-24,5,1996,2001,"DAL,NSH,EDM"
Jeff Farkas,1978-01-24,2,2001,2003,"TOR,ATL"
Chris Ferraro,1973-01-24,6,1996,2002,"NYR,PIT,EDM,NYI,WSH"
Peter Ferraro,1973-01-24,6,1996,2002,"NYR,PIT,BOS,WSH"
Danny Geoffrion,1958-01-24,2,1980,1982,"MTL,WIN"
Jack Hillen,1986-01-24,7,2008,2015,"NYI,NSH,WSH,CAR"
Zack Kassian,1991-01-24,8,2012,2020,"BUF,VAN,EDM"
Bill Knibbs,1942-01-24,0,1965,1965,BOS
Scott Kosmachuk,1994-01-24,0,2016,2016,WPG
Tom Kostopoulos,1979-01-24,11,2002,2013,"PIT,LAK,MTL,CAR,CGY,NJD"
Jim Mathieson,1970-01-24,0,1990,1990,WSH
Gus Mortson,1925-01-24,12,1947,1959,"TOR,CBH,DET"
Matt Puempel,1993-01-24,4,2015,2019,"OTT,NYR,DET"
Mark Reeds,1960-01-24,7,1982,1989,"STL,HAR"
Griffin Reinhart,1994-01-24,1,2015,2016,"NYI,EDM"
Norm Schmidt,1963-01-24,4,1984,1988,PIT
Bobby Taylor,1945-01-24,4,1972,1976,"PHI,PIT"
Cy Wentworth,1905-01-24,12,1928,1940,"CBH,MTM,MTL"
Rick Adduono,1955-01-25,4,1976,1980,"BOS,ATF"
Troy Bodie,1985-01-25,6,2009,2015,"ANA,CAR,TOR"
Rick Bowness,1955-01-25,5,1976,1981,"ATF,DET,STL,WIN"
Mario Brunetta,1967-01-25,2,1988,1990,QUE
Chris Chelios*,1962-01-25,26,1984,2010,"MTL,CHI,DET,ATL"
Jared Cowen,1991-01-25,6,2010,2016,OTT
Barry Cummins,1949-01-25,0,1974,1974,CGS
Corb Denneny,1894-01-25,10,1918,1928,"TRA,TRS,HAM,TOR,CBH"
Gordie Dwyer,1978-01-25,4,2000,2004,"TBL,MTL,NYR"
Aut Erickson,1938-01-25,10,1960,1970,"BOS,CBH,OAK"
Fern Flaman*,1927-01-25,16,1945,1961,"BOS,TOR"
Lorry Gloeckner,1956-01-25,0,1979,1979,DET
Mark Greig,1970-01-25,12,1991,2003,"HAR,TOR,CGY,PHI"
Noah Hanifin,1997-01-25,4,2016,2020,"CAR,CGY"
Pauli Jaks,1972-01-25,0,1995,1995,LAK
Steve Maltais,1969-01-25,11,1990,2001,"WSH,MNS,TBL,DET,CBJ"
Randy McKay,1967-01-25,14,1989,2003,"DET,NJD,DAL,MTL"
Philippe Myers,1997-01-25,1,2019,2020,PHI
Lou Nistico,1953-01-25,0,1978,1978,CLR
Bill O'Dwyer,1960-01-25,6,1984,1990,"LAK,BOS"
Paul Ranheim,1966-01-25,14,1989,2003,"CGY,HAR,CAR,PHI,PHX"
Mario Roberge,1964-01-25,4,1991,1995,MTL
Martin Samuelsson,1982-01-25,1,2003,2004,BOS
Bob Sweeney,1964-01-25,9,1987,1996,"BOS,BUF,CGY,NYI"
Esa Tikkanen,1965-01-25,13,1986,1999,"EDM,NYR,STL,NJD,VAN,FLA,WSH"
Pavel Torgaev,1966-01-25,4,1996,2000,"CGY,TBL"
Lukas Vejdemo,1996-01-25,0,2020,2020,MTL
Amos Arbour,1895-01-26,5,1919,1924,"MTL,HAM,TRS"
Fred Barrett,1950-01-26,13,1971,1984,"MNS,LAK"
Daniel Berthiaume,1966-01-26,7,1987,1994,"WIN,MNS,LAK,BOS,OTT"
Rod Dallman,1967-01-26,4,1988,1992,"NYI,PHI"
Harold Druken,1979-01-26,4,2000,2004,"VAN,CAR,TOR"
Mike Fountain,1972-01-26,4,1997,2001,"VAN,CAR,OTT"
Steve Gainey,1979-01-26,5,2001,2006,"DAL,PHX"
Tyrell Goulbourne,1994-01-26,1,2018,2019,PHI
Wayne Gretzky*,1961-01-26,19,1980,1999,"EDM,LAK,STL,NYR"
Blake Hillman,1996-01-26,0,2018,2018,CHI
Ivan Hlinka,1950-01-26,1,1982,1983,VAN
Chad Kolarik,1986-01-26,1,2010,2011,"CBJ,NYR"
Martin Lauder,1907-01-26,0,1928,1928,BOS
Louis Leblanc,1991-01-26,2,2012,2014,MTL
Vic Lynn,1925-01-26,11,1943,1954,"NYR,DET,MTL,TOR,BOS,CBH"
Dean Malkoc,1970-01-26,3,1996,1999,"VAN,BOS,NYI"
Dale McCourt,1957-01-26,6,1978,1984,"DET,BUF,TOR"
Scott McKay,1972-01-26,0,1994,1994,MDA
Billy McNeill,1936-01-26,7,1957,1964,DET
Dan Newman,1952-01-26,3,1977,1980,"NYR,MTL,EDM"
Frank Nighbor*,1893-01-26,12,1918,1930,"OTS,TOR"
Phil Oreskovic,1987-01-26,0,2009,2009,TOR
Alf Skinner,1896-01-26,8,1918,1926,"TRA,BOS,MTM,PTP"
Glen Skov,1931-01-26,11,1950,1961,"DET,CBH,MTL"
Mark Taylor,1958-01-26,4,1982,1986,"PHI,PIT,WSH"
Jeremy Williams,1984-01-26,5,2006,2011,"TOR,NYR"
Patrice Brisebois,1971-01-27,18,1991,2009,"MTL,COL"
Jiri Bubla,1950-01-27,4,1982,1986,VAN
Carlo Colaiacovo,1983-01-27,13,2003,2016,"TOR,STL,DET,PHI,BUF"
Parris Duffus,1970-01-27,0,1997,1997,PHX
Brian Engblom,1955-01-27,9,1978,1987,"MTL,WSH,LAK,BUF,CGY"
Alexander Godynyuk,1970-01-27,6,1991,1997,"TOR,CGY,FLA,HAR"
Terry Harper,1940-01-27,18,1963,1981,"MTL,LAK,DET,STL,CLR"
Tim Heed,1991-01-27,3,2017,2020,SJS
Tom Hirsch,1963-01-27,4,1984,1988,MNS
Tomi Kallio,1977-01-27,2,2001,2003,"ATL,CBJ,PHI"
Ray Kinsella,1911-01-27,0,1931,1931,OTS
Mark Lawrence,1972-01-27,6,1995,2001,"DAL,NYI"
Dave Manson,1967-01-27,15,1987,2002,"CHI,EDM,WIN,MTL,PHX,DAL,TOR"
Hector Marini,1957-01-27,5,1979,1984,"NYI,NJD"
Tom Mellor,1950-01-27,1,1974,1975,DET
Paul Messier,1958-01-27,0,1979,1979,CLR
Liam Reddox,1986-01-27,3,2008,2011,EDM
Jeff Rohlicek,1966-01-27,1,1988,1989,VAN
Jason Ruff,1970-01-27,1,1993,1994,"STL,TBL"
Rhett Warrener,1976-01-27,12,1996,2008,"FLA,BUF,CGY"
Arnie Brown,1942-01-28,12,1962,1974,"TOR,NYR,DET,ATF,NYI"
Marty Burke,1905-01-28,10,1928,1938,"MTL,PTP,OTS,CBH"
Colin Campbell,1953-01-28,10,1975,1985,"PIT,CLR,EDM,VAN,DET"
Daniel Carcillo,1985-01-28,8,2007,2015,"PHX,PHI,CHI,LAK,NYR"
Carl Dahlstrom,1995-01-28,2,2018,2020,"CHI,WPG"
Martin Desjardins,1967-01-28,0,1990,1990,MTL
Jack Egers,1949-01-28,6,1970,1976,"NYR,STL,WSH"
Colin Fraser,1985-01-28,8,2007,2015,"CHI,EDM,LAK,STL"
Gerry Gray,1948-01-28,2,1971,1973,"DET,NYI"
Paul Henderson,1943-01-28,17,1963,1980,"DET,TOR,ATF"
Bill Hutton,1910-01-28,1,1930,1931,"BOS,OTS,PHQ"
David Kase,1997-01-28,0,2020,2020,PHI
Carl Klingberg,1991-01-28,4,2011,2015,"ATL,WPG"
Mark Napier,1957-01-28,10,1979,1989,"MTL,MNS,EDM,BUF"
Viktor Nechayev,1955-01-28,0,1983,1983,LAK
Bob Perreault,1931-01-28,7,1956,1963,"MTL,DET,BOS"
Michal Pivonka,1966-01-28,12,1987,1999,WSH
Alan Rittinger,1925-01-28,0,1944,1944,BOS
Normand Rochefort,1961-01-28,13,1981,1994,"QUE,NYR,TBL"
Paul Shmyr,1946-01-28,13,1969,1982,"CBH,CGS,MNS,HAR"
Alexei Smirnov,1982-01-28,1,2003,2004,MDA
Stan Smyl,1958-01-28,12,1979,1991,VAN
Ted Speers,1961-01-28,0,1986,1986,DET
Garrett Stafford,1980-01-28,3,2008,2011,"DET,DAL,PHX"
Sean Williams,1968-01-28,0,1992,1992,CHI
Paulin Bordeleau,1953-01-29,2,1974,1976,VAN
Barry Boughner,1948-01-29,1,1970,1971,"OAK,CGS"
Chris Bourque,1986-01-29,5,2008,2013,"WSH,PIT,BOS"
Sean Burke,1967-01-29,19,1988,2007,"NJD,HAR,CAR,PHI,VAN,FLA,PHX,TBL,LAK"
Glen Cochrane,1958-01-29,10,1979,1989,"PHI,VAN,CHI,EDM"
Joe Contini,1957-01-29,3,1978,1981,"CLR,MNS"
Tony Curtale,1962-01-29,0,1981,1981,CGY
Jason Doig,1977-01-29,8,1996,2004,"WIN,PHX,NYR,WSH"
Robert Dome,1979-01-29,5,1998,2003,"PIT,CGY"
Joel Eriksson Ek,1997-01-29,3,2017,2020,MIN
Mike Foligno,1959-01-29,14,1980,1994,"DET,BUF,TOR,FLA"
Tim Gleason,1983-01-29,11,2004,2015,"LAK,CAR,TOR,WSH"
Thomas Greiss,1986-01-29,12,2008,2020,"SJS,PHX,PIT,NYI"
Billy Harris,1952-01-29,11,1973,1984,"NYI,LAK,TOR"
Dominik Hasek*,1965-01-29,17,1991,2008,"CHI,BUF,DET,OTT"
Fred Hergerts,1913-01-29,1,1935,1936,NYA
Lou Holmes,1911-01-29,1,1932,1933,CBH
Ed Kastelic,1964-01-29,6,1986,1992,"WSH,HAR"
Juho Lammikko,1996-01-29,0,2019,2019,FLA
Vladimir Mihalik,1987-01-29,1,2009,2010,TBL
Bob Murdoch,1954-01-29,3,1976,1979,"CGS,CLE,STL"
Jim O'Brien,1989-01-29,7,2011,2018,"OTT,NJD"
Scott Parker,1978-01-29,9,1999,2008,"COL,SJS"
Steve Passmore,1973-01-29,5,1999,2004,"EDM,CHI,LAK"
Larry Pleau,1947-01-29,2,1970,1972,MTL
Marc Potvin,1967-01-29,5,1991,1996,"DET,LAK,HAR,BOS"
Joe Primeau*,1906-01-29,8,1928,1936,TOR
Pat Quinn*,1943-01-29,8,1969,1977,"TOR,VAN,ATF"
Doug Risebrough,1954-01-29,12,1975,1987,"MTL,CGY"
Jack Roslovic,1997-01-29,3,2017,2020,WPG
Kevin Shattenkirk,1989-01-29,9,2011,2020,"COL,STL,WSH,NYR,TBL"
Drew Shore,1991-01-29,4,2013,2017,"FLA,CGY,VAN"
Wayne Stephenson,1945-01-29,9,1972,1981,"STL,PHI,WSH"
Denis Tolpeko,1985-01-29,0,2008,2008,PHI
Roman Tvrdon,1981-01-29,0,2004,2004,WSH
Tom Wandell,1987-01-29,4,2009,2013,DAL
Kyle Wanvig,1981-01-29,5,2003,2008,"MIN,TBL"
Jorge Alves,1979-01-30,0,2017,2017,CAR
Ryan Barnes,1980-01-30,0,2004,2004,DET
Mike Baumgartner,1949-01-30,0,1975,1975,KCS
Jonathon Blum,1989-01-30,4,2011,2015,"NSH,MIN"
Larry Carriere,1952-01-30,7,1973,1980,"BUF,ATF,VAN,LAK,TOR"
Thomas Chabot,1997-01-30,3,2017,2020,OTT
Joe Colborne,1990-01-30,6,2011,2017,"TOR,CGY,COL"
Wade Dubielewicz,1979-01-30,6,2004,2010,"NYI,CBJ,MIN"
Rocky Dundas,1967-01-30,0,1990,1990,TOR
Stefan Elliott,1991-01-30,7,2012,2019,"COL,ARI,NSH,OTT"
Alex Friesen,1991-01-30,0,2016,2016,VAN
Trevor Gillies,1979-01-30,6,2006,2012,"MDA,NYI"
Ted Graham,1906-01-30,9,1928,1937,"CBH,DET,MTM,STE,BOS,NYA"
Steve Heinze,1970-01-30,11,1992,2003,"BOS,BUF,CBJ,LAK"
Dan Hinote,1977-01-30,9,2000,2009,"COL,STL"
Justin Holl,1992-01-30,2,2018,2020,TOR
Earl Ingarfield,1959-01-30,1,1980,1981,"ATF,CGY,DET"
Alexander Khavanov,1972-01-30,5,2001,2006,"STL,TOR"
Trent Klatt,1971-01-30,12,1992,2004,"MNS,DAL,PHI,VAN,LAK"
Scott Levins,1970-01-30,5,1993,1998,"WIN,FLA,OTT,PHX"
Sam LoPresti,1917-01-30,1,1941,1942,CBH
Darcy Martini,1969-01-30,0,1994,1994,EDM
Torrey Mitchell,1985-01-30,10,2008,2018,"SJS,MIN,BUF,MTL,LAK"
Don Nachbaur,1959-01-30,9,1981,1990,"HAR,EDM,PHI"
Danny O'Regan,1994-01-30,2,2017,2019,"SJS,BUF"
Brian Ogilvie,1952-01-30,6,1973,1979,"CBH,STL"
Rip Riopelle,1922-01-30,2,1948,1950,MTL
Shawn Rivers,1971-01-30,0,1993,1993,TBL
Max Sauve,1990-01-30,0,2012,2012,BOS
Luca Sbisa,1990-01-30,11,2009,2020,"PHI,ANA,VAN,VEG,NYI,WPG"
Chris Simon,1972-01-30,15,1993,2008,"QUE,COL,WSH,CHI,CGY,NYR,NYI,MIN"
Ryan Spooner,1992-01-30,6,2013,2019,"BOS,NYR,EDM,VAN"
Martin St. Amour,1970-01-30,0,1993,1993,OTT
Bill Sweeney,1937-01-30,0,1960,1960,NYR
Colin White,1997-01-30,3,2017,2020,OTT
Conor Allen,1990-01-31,1,2014,2015,NYR
Peter Bakovic,1965-01-31,0,1988,1988,VAN
Maxim Bets,1974-01-31,0,1994,1994,MDA
Jeff Bloemberg,1968-01-31,3,1989,1992,NYR
Brandon Bollig,1987-01-31,4,2012,2016,"CHI,CGY"
Curt Brackenbury,1952-01-31,3,1980,1983,"QUE,EDM,STL"
Bobby Dollas,1965-01-31,17,1984,2001,"WIN,QUE,DET,MDA,EDM,PIT,CGY,OTT,SJS"
Rick Dudley,1949-01-31,8,1973,1981,"BUF,WIN"
Allan Egeland,1973-01-31,2,1996,1998,TBL
Mikhail Grabovski,1984-01-31,9,2007,2016,"MTL,TOR,WSH,NYI"
Gaetan Haas,1992-01-31,0,2020,2020,EDM
Camille Henry,1933-01-31,16,1954,1970,"NYR,CBH,STL"
Jacob Markstrom,1990-01-31,9,2011,2020,"FLA,VAN"
Jack McLean,1923-01-31,2,1943,1945,TOR
Eddie Mio,1954-01-31,6,1980,1986,"EDM,NYR,DET"
Wayne Ramsey,1957-01-31,0,1978,1978,BUF
Tyler Seguin,1992-01-31,9,2011,2020,"BOS,DAL"
Alex Singbush,1914-01-31,0,1941,1941,MTL
Janis Sprukts,1982-01-31,2,2007,2009,FLA
Allan Stewart,1964-01-31,6,1986,1992,"NJD,BOS"
Jack Tomson,1918-01-31,1,1940,1941,NYA
Rene Trudell,1919-01-31,2,1946,1948,NYR
Bob Turner,1934-01-31,7,1956,1963,"MTL,CBH"
David Van Drunen,1976-01-31,0,2000,2000,OTT
Ken Baird,1951-02-01,0,1972,1972,CGS
Bob Blackburn,1938-02-01,2,1969,1971,"NYR,PIT"
Patrik Carnback,1968-02-01,3,1993,1996,"MTL,MDA"
Jamie Doornbosch,1990-02-01,0,2011,2011,NYI
Ivan Droppa,1972-02-01,2,1994,1996,CHI
Mark Hardy,1959-02-01,14,1980,1994,"LAK,NYR,MNS"
Shane Harper,1989-02-01,0,2017,2017,FLA
Jeff Hoggan,1978-02-01,4,2006,2010,"STL,BOS,PHX"
Jim Jackson,1960-02-01,5,1983,1988,"CGY,BUF"
Mike Kitchen,1956-02-01,7,1977,1984,"CLR,NJD"
Roger Kortko,1963-02-01,1,1985,1986,NYI
Charley Mason,1912-02-01,4,1935,1939,"NYR,NYA,CBH,DET"
Mike McMahon,1915-02-01,3,1943,1946,"MTL,BOS"
Jayson Megna,1990-02-01,6,2014,2020,"PIT,NYR,VAN,COL"
Doug Morrison,1960-02-01,5,1980,1985,BOS
Tyler Myers,1990-02-01,10,2010,2020,"BUF,WPG,VAN"
Patrick O'Sullivan,1985-02-01,5,2007,2012,"LAK,EDM,CAR,MIN,PHX"
Kyle Palmieri,1991-02-01,9,2011,2020,"ANA,NJD"
Mark Recchi*,1968-02-01,22,1989,2011,"PIT,PHI,MTL,CAR,ATL,BOS,TBL"
Pierre Rioux,1962-02-01,0,1983,1983,CGY
Wayne Rivers,1942-02-01,7,1962,1969,"DET,BOS,STL,NYR"
Des Roche,1909-02-01,4,1931,1935,"MTM,OTS,DET,MTL,STE"
Tommy Salo,1971-02-01,9,1995,2004,"NYI,EDM,COL"
Geoff Sanderson,1972-02-01,17,1991,2008,"HAR,BUF,CAR,VAN,CBJ,PHX,PHI,EDM"
Ladislav Smid,1986-02-01,9,2007,2016,"EDM,CGY"
Bob Stephenson,1954-02-01,0,1980,1980,"HAR,TOR"
Billy Stuart,1900-02-01,6,1921,1927,"TRS,BOS"
Tomas Vlasak,1975-02-01,0,2001,2001,LAK
Chase Balisy,1992-02-02,0,2018,2018,FLA
Todd Bertuzzi,1975-02-02,18,1996,2014,"NYI,VAN,DET,FLA,ANA,CGY"
Ilja Byakin,1963-02-02,1,1994,1995,"EDM,SJS"
Ed Courtenay,1968-02-02,1,1992,1993,SJS
Kjell Dahlin,1963-02-02,2,1986,1988,MTL
Bob Davis,1899-02-02,0,1933,1933,DET
Dave Donnelly,1962-02-02,4,1984,1988,"BOS,CHI,EDM"
Gary Dornhoefer,1943-02-02,14,1964,1978,"BOS,PHI"
Christian Dvorak,1996-02-02,3,2017,2020,ARI
Frank Foyston*,1891-02-02,1,1927,1928,DTC
Chris Govedaris,1970-02-02,4,1990,1994,"HAR,TOR"
Jean-Luc Grand-Pierre,1977-02-02,5,1999,2004,"BUF,CBJ,ATL,WSH"
Triston Grant,1984-02-02,3,2007,2010,"PHI,NSH"
Wayne Groulx,1965-02-02,0,1985,1985,QUE
Jody Hull,1969-02-02,15,1989,2004,"HAR,NYR,OTT,FLA,TBL,PHI"
Arturs Irbe,1967-02-02,12,1992,2004,"SJS,DAL,VAN,CAR"
Dustin Kohn,1987-02-02,0,2010,2010,NYI
Don Kozak,1952-02-02,6,1973,1979,"LAK,VAN"
Jiri Latal,1967-02-02,2,1990,1992,PHI
Curtis Lazar,1995-02-02,5,2015,2020,"OTT,CGY,BUF"
Alex Levinsky,1910-02-02,8,1931,1939,"TOR,CBH,NYR"
Brock McGinn,1994-02-02,4,2016,2020,CAR
Lee Norwood,1960-02-02,13,1981,1994,"QUE,WSH,STL,DET,NJD,HAR,CGY"
Mark Parrish,1977-02-02,12,1999,2011,"FLA,NYI,LAK,MIN,DAL,TBL,BUF"
Steve Penney,1961-02-02,4,1984,1988,"MTL,WIN"
Calle Rosen,1994-02-02,2,2018,2020,"TOR,COL"
Jean-Marc Routhier,1968-02-02,0,1990,1990,QUE
Jordin Tootoo,1983-02-02,13,2004,2017,"NSH,DET,NJD,CHI"
Chris Brown,1991-02-03,3,2013,2016,"PHX,WSH"
Jim Campbell,1973-02-03,10,1996,2006,"MDA,STL,MTL,CHI,FLA,TBL"
Keith Carney,1970-02-03,16,1992,2008,"BUF,CHI,PHX,MDA,VAN,MIN"
Mathieu Dandenault,1976-02-03,13,1996,2009,"DET,MTL"
Paul Gaustad,1982-02-03,13,2003,2016,"BUF,NSH"
Blake Geoffrion,1988-02-03,1,2011,2012,"NSH,MTL"
Tony Horacek,1967-02-03,5,1990,1995,"PHI,CHI"
Mark Kirton,1958-02-03,5,1980,1985,"TOR,DET,VAN"
Andrei Kostitsyn,1985-02-03,6,2006,2012,"MTL,NSH"
Joe Kowal,1956-02-03,1,1977,1978,BUF
Frantisek Kucera,1968-02-03,11,1991,2002,"CHI,HAR,VAN,PHI,CBJ,PIT,WSH"
Peter LeBlanc,1988-02-03,0,2014,2014,WSH
Tommy Lehman,1964-02-03,2,1988,1990,"BOS,EDM"
Steve McCarthy,1981-02-03,8,2000,2008,"CHI,ATL,VAN"
Steve McLaren,1975-02-03,0,2004,2004,STL
Michael McLeod,1998-02-03,1,2019,2020,NJD
Jonathon Merrill,1992-02-03,6,2014,2020,"NJD,VEG"
Jason Muzzatti,1970-02-03,4,1994,1998,"CGY,HAR,NYR,SJS"
Lynn Patrick*,1912-02-03,11,1935,1946,NYR
Dimitri Patzold,1983-02-03,0,2008,2008,SJS
Norm Shay,1899-02-03,1,1925,1926,"BOS,TRS"
Sam Steel,1998-02-03,1,2019,2020,ANA
Sergey Tolchinsky,1995-02-03,1,2016,2017,CAR
Tiger Williams,1954-02-03,13,1975,1988,"TOR,VAN,DET,LAK,HAR"
Ryan Wilson,1987-02-03,5,2010,2015,COL
Marek Zidlicky,1977-02-03,12,2004,2016,"NSH,MIN,NJD,DET,NYI"
Reg Abbott,1930-02-04,0,1953,1953,MTL
Jeff Bandura,1957-02-04,0,1981,1981,NYR
Art Brooks,1889-02-04,0,1918,1918,TRA
Adam Brown,1920-02-04,10,1942,1952,"DET,CBH,BOS"
Andrew Campbell,1988-02-04,2,2014,2016,"LAK,ARI,TOR"
Sam Carrick,1992-02-04,5,2015,2020,"TOR,ANA"
Brandon Convery,1974-02-04,3,1996,1999,"TOR,VAN,LAK"
Ross Cory,1957-02-04,1,1980,1981,WIN
Denis Cyr,1961-02-04,5,1981,1986,"CGY,CBH,STL"
Dallas Drake,1969-02-04,15,1993,2008,"DET,WIN,PHX,STL"
Brian Foster,1987-02-04,0,2012,2012,FLA
Liam Foudy,2000-02-04,0,2020,2020,CBJ
Libor Hajek,1998-02-04,1,2019,2020,NYR
Manny Legace,1973-02-04,11,1999,2010,"LAK,DET,STL,CAR"
Mark Letestu,1985-02-04,10,2010,2020,"PIT,CBJ,EDM,WPG"
Beck Malenstyn,1998-02-04,0,2020,2020,WSH
Dave Marcinyshyn,1967-02-04,2,1991,1993,"NJD,QUE,NYR"
David McIntyre,1987-02-04,0,2012,2012,MIN
Mike Moffat,1962-02-04,2,1982,1984,BOS
Darnell Nurse,1995-02-04,5,2015,2020,EDM
Steven Oleksy,1986-02-04,4,2013,2017,"WSH,PIT"
Steve Patrick,1961-02-04,5,1981,1986,"BUF,NYR,QUE"
Dave Pichette,1960-02-04,7,1981,1988,"QUE,STL,NJD,NYR"
Max Reinhart,1992-02-04,2,2013,2015,CGY
Mitch Reinke,1996-02-04,0,2018,2018,STL
Brad Richardson,1985-02-04,14,2006,2020,"COL,LAK,VAN,ARI"
Ernie Roche,1930-02-04,0,1951,1951,MTL
Joe Sacco,1969-02-04,12,1991,2003,"TOR,MDA,NYI,WSH,PHI"
Denis Savard*,1961-02-04,16,1981,1997,"CBH,CHI,MTL,TBL"
Gary Smith,1944-02-04,14,1966,1980,"TOR,OAK,CGS,CBH,VAN,MNS,WSH,WIN"
Jerred Smithson,1979-02-04,11,2003,2014,"LAK,NSH,FLA,EDM,TOR"
Lee Stempniak,1983-02-04,13,2006,2019,"STL,TOR,PHX,CGY,PIT,NYR,WPG,BOS,NJD,CAR"
Joakim Andersson,1989-02-05,4,2012,2016,DET
Kris Beech,1981-02-05,7,2001,2008,"WSH,PIT,NSH,CBJ,VAN"
Norm Dupont,1957-02-05,4,1980,1984,"MTL,WIN,HAR"
Larry Hillman,1937-02-05,18,1955,1973,"DET,BOS,TOR,MNS,MTL,PHI,BUF,LAK"
Jan Hrdina,1976-02-05,7,1999,2006,"PIT,PHX,NJD,CBJ"
Scott Jackson,1987-02-05,0,2010,2010,TBL
Tomas Kopecky,1982-02-05,9,2006,2015,"DET,CHI,FLA"
Jean-Guy Lagace,1945-02-05,7,1969,1976,"PIT,BUF,KCS"
Rennison Manners,1904-02-05,1,1930,1931,"PTP,PHQ"
Richard Matvichuk,1973-02-05,14,1993,2007,"MNS,DAL,NJD"
Jud McAtee,1920-02-05,2,1943,1945,DET
Linus Omark,1987-02-05,3,2011,2014,"EDM,BUF"
Ty Rattie,1993-02-05,5,2014,2019,"STL,CAR,EDM"
Nicolas Roy,1997-02-05,2,2018,2020,"CAR,VEG"
Christoph Schubert,1982-02-05,4,2006,2010,"OTT,ATL"
Mitchell Stephens,1997-02-05,0,2020,2020,TBL
Jim Storm,1971-02-05,2,1994,1996,"HAR,DAL"
Chris Summers,1988-02-05,5,2011,2016,"PHX,ARI,NYR"
Joel Vermin,1992-02-05,1,2016,2017,TBL
Fabian Brunnstrom,1985-02-06,3,2009,2012,"DAL,DET"
Harry Cameron*,1890-02-06,5,1918,1923,"TRA,OTS,MTL,TRS"
Kent Douglas,1936-02-06,6,1963,1969,"TOR,DET,OAK"
Rob Flockhart,1956-02-06,4,1977,1981,"VAN,MNS"
Paul Gagne,1962-02-06,9,1981,1990,"CLR,NJD,TOR,NYI"
Scott Gordon,1963-02-06,1,1990,1991,QUE
Adam Henrique,1990-02-06,9,2011,2020,"NJD,ANA"
Andy Hilbert,1981-02-06,8,2002,2010,"BOS,CHI,PIT,NYI,MIN"
Mike Hough,1963-02-06,12,1987,1999,"QUE,FLA,NYI"
Mike Hudson,1967-02-06,8,1989,1997,"CHI,EDM,NYR,PIT,STL,TOR,PHX"
Joe Jensen,1983-02-06,0,2008,2008,CAR
Yvan Joly,1960-02-06,2,1981,1983,MTL
Ralph Keller,1936-02-06,0,1963,1963,NYR
Roger Lemelin,1954-02-06,3,1975,1978,"KCS,CLR"
Otto Leskinen,1997-02-06,0,2020,2020,MTL
Vinni Lettieri,1995-02-06,1,2018,2019,NYR
Bob Sirois,1954-02-06,5,1975,1980,"PHI,WSH"
Chris Speyer,1907-02-06,10,1924,1934,"TRS,NYA"
Tim Taylor,1969-02-06,13,1994,2007,"DET,BOS,NYR,TBL"
Joe Whitney,1988-02-06,1,2014,2015,NJD
David Aebischer,1978-02-07,7,2001,2008,"COL,MTL,PHX"
Shawn Anderson,1968-02-07,8,1987,1995,"BUF,QUE,WSH,PHI"
Riley Barber,1994-02-07,3,2017,2020,"WSH,MTL"
Alexandre Boikov,1975-02-07,1,2000,2001,NSH
Peter Bondra,1968-02-07,16,1991,2007,"WSH,OTT,ATL,CHI"
Bert Burry,1906-02-07,0,1933,1933,OTS
Denis Chasse,1970-02-07,3,1994,1997,"STL,WIN,WSH,OTT"
Paul Comrie,1977-02-07,0,2000,2000,EDM
Doug Dadswell,1964-02-07,1,1987,1988,CGY
Alexandre Daigle,1975-02-07,12,1994,2006,"OTT,PHI,TBL,NYR,PIT,MIN"
Aaron Ekblad,1996-02-07,5,2015,2020,FLA
Lee Fogolin,1955-02-07,12,1975,1987,"BUF,EDM"
Mike Hartman,1967-02-07,8,1987,1995,"BUF,WIN,NYR,TBL"
Josh Hennessy,1985-02-07,5,2007,2012,"OTT,BOS"
Tim Higgins,1958-02-07,10,1979,1989,"CBH,NJD,DET"
Todd Hlushko,1970-02-07,4,1994,1998,"PHI,CGY"
Petr Kanko,1984-02-07,0,2006,2006,LAK
Ross Lonsberry,1947-02-07,14,1967,1981,"BOS,LAK,PHI,PIT"
Joey MacDonald,1980-02-07,7,2007,2014,"BOS,DET,NYI,TOR,CGY"
Ryan O'Reilly,1991-02-07,10,2010,2020,"COL,BUF,STL"
Richard Panik,1991-02-07,7,2013,2020,"TBL,TOR,CHI,ARI,WSH"
Yves Racine,1969-02-07,8,1990,1998,"DET,PHI,MTL,SJS,CGY,TBL"
John Ramage,1991-02-07,1,2015,2016,"CGY,CBJ"
Marc Reaume,1934-02-07,16,1955,1971,"TOR,DET,MTL,VAN"
Henrik Samuelsson,1994-02-07,0,2015,2015,ARI
Jody Shelley,1976-02-07,12,2001,2013,"CBJ,SJS,NYR,PHI"
John Slaney,1972-02-07,10,1994,2004,"WSH,COL,LAK,PHX,NSH,PIT,PHI"
Matthew Spiller,1983-02-07,4,2004,2008,"PHX,NYI"
Steven Stamkos,1990-02-07,11,2009,2020,TBL
Chris Tancill,1968-02-07,7,1991,1998,"HAR,DET,DAL,SJS"
Randy Turnbull,1962-02-07,0,1982,1982,CGY
Nathan Walker,1994-02-07,2,2018,2020,"EDM,WSH,STL"
Kevin Westgarth,1984-02-07,5,2009,2014,"LAK,CAR,CGY"
Brian White,1976-02-07,0,1999,1999,COL
Tom Williams,1951-02-07,7,1972,1979,"NYR,LAK"
Alexander Yelesin,1996-02-07,0,2020,2020,CGY
Larry Aurie,1905-02-08,11,1928,1939,"DTC,DTF,DET"
Sean Bergenheim,1984-02-08,11,2004,2015,"NYI,TBL,FLA,MIN"
Dino Ciccarelli*,1960-02-08,18,1981,1999,"MNS,WSH,DET,TBL,FLA"
Les Colvin,1921-02-08,0,1949,1949,BOS
Alec Connell*,1902-02-08,12,1925,1937,"OTS,DTF,NYA,MTM"
Yvon Corriveau,1967-02-08,8,1986,1994,"WSH,HAR,SJS"
Jean-Sebastien Dea,1994-02-08,3,2017,2020,"PIT,NJD,BUF"
Rocco Grimaldi,1993-02-08,5,2015,2020,"FLA,COL,NSH"
Robert Hagg,1995-02-08,3,2017,2020,PHI
Thomas Hickey,1989-02-08,6,2013,2019,NYI
Hobie Kitchen,1904-02-08,1,1926,1927,"MTM,DTC"
Doug MacDonald,1969-02-08,2,1993,1995,BUF
Bob McCulley,1912-02-08,0,1935,1935,MTL
Duncan Milroy,1983-02-08,0,2007,2007,MTL
Kirk Muller,1966-02-08,18,1985,2003,"NJD,MTL,NYI,TOR,FLA,DAL"
Patrik Nemeth,1992-02-08,6,2014,2020,"DAL,COL,DET"
Kelly Pratt,1953-02-08,0,1975,1975,PIT
Andre Roy,1975-02-08,13,1996,2009,"BOS,OTT,TBL,PIT,CGY"
Gary Sargent,1954-02-08,7,1976,1983,"LAK,MNS"
Sean Shanahan,1951-02-08,2,1976,1978,"MTL,CLR,BOS"
Brendan Smith,1989-02-08,8,2012,2020,"DET,NYR"
Trevor Smith,1985-02-08,8,2009,2017,"NYI,TBL,PIT,TOR,NSH"
Max Sutherland,1907-02-08,0,1932,1932,BOS
Curtis Valk,1993-02-08,0,2018,2018,FLA
Darren Archibald,1990-02-09,5,2014,2019,"VAN,OTT"
Ron Attwell,1935-02-09,0,1968,1968,"NYR,STL"
John Brackenborough,1897-02-09,0,1926,1926,BOS
Andre Burakovsky,1995-02-09,5,2015,2020,"WSH,COL"
Dit Clapper*,1907-02-09,19,1928,1947,BOS
Bert Corbeau,1894-02-09,9,1918,1927,"MTL,HAM,TRS,TOR"
Nigel Dawes,1985-02-09,4,2007,2011,"NYR,PHX,CGY,ATL,MTL"
Neil Eisenhut,1967-02-09,1,1994,1995,"VAN,CGY"
Jonathan Ferland,1983-02-09,0,2006,2006,MTL
Christian Folin,1991-02-09,6,2014,2020,"MIN,LAK,MTL,PHI"
Archie Fraser,1914-02-09,0,1944,1944,NYR
Ed Hospodar,1959-02-09,8,1980,1988,"NYR,HAR,PHI,MNS,BUF"
Mathieu Joseph,1997-02-09,1,2019,2020,TBL
Mike Lauen,1961-02-09,0,1984,1984,WIN
Michel Mongeau,1965-02-09,3,1990,1993,"STL,TBL"
Chris Nilan,1958-02-09,12,1980,1992,"MTL,NYR,BOS"
Skene Ronan,1889-02-09,0,1919,1919,OTS
Andre Savard,1953-02-09,11,1974,1985,"BOS,BUF,QUE"
Neil Sheehy,1960-02-09,8,1984,1992,"CGY,HAR,WSH"
Nathan Smith,1982-02-09,6,2004,2010,"VAN,PIT,MIN"
Justin Braun,1987-02-10,9,2011,2020,"SJS,PHI"
Brian Chapman,1968-02-10,0,1991,1991,HAR
Bob Davidson,1912-02-10,11,1935,1946,TOR
Norm Foster,1965-02-10,1,1991,1992,"BOS,EDM"
Alexandar Georgiev,1996-02-10,2,2018,2020,NYR
Jakub Kindl,1987-02-10,7,2010,2017,"DET,FLA"
Steve Konroyd,1961-02-10,14,1981,1995,"CGY,NYI,CHI,HAR,DET,OTT"
Scott McLellan,1963-02-10,0,1983,1983,BOS
Jarod Palmer,1986-02-10,0,2012,2012,MIN
Rick Paterson,1958-02-10,7,1980,1987,"CBH,CHI"
Bud Poile*,1924-02-10,7,1943,1950,"TOR,CBH,DET,BOS,NYR"
Peter Popovic,1968-02-10,7,1994,2001,"MTL,NYR,PIT,BOS"
Mike Ribeiro,1980-02-10,17,2000,2017,"MTL,DAL,WSH,PHX,NSH"
Dillon Simpson,1993-02-10,0,2017,2017,EDM
Eric Tangradi,1989-02-10,9,2010,2019,"PIT,WPG,MTL,DET,NJD"
Randy Velischek,1962-02-10,9,1983,1992,"MNS,NJD,QUE"
Tyler Bunz,1992-02-11,0,2015,2015,EDM
Matt Climie,1983-02-11,2,2009,2011,"DAL,PHX"
Michel Dion,1954-02-11,5,1980,1985,"QUE,WIN,PIT"
Andre Dore,1958-02-11,6,1979,1985,"NYR,STL,QUE"
Trent Frederic,1998-02-11,1,2019,2020,BOS
Bruce Gardiner,1972-02-11,5,1997,2002,"OTT,TBL,CBJ,NJD"
Sean Haggerty,1976-02-11,5,1996,2001,"TOR,NYI,NSH"
Andrew Hammond,1988-02-11,4,2014,2018,"OTT,COL"
Paul Harrison,1955-02-11,6,1976,1982,"MNS,TOR,BUF,PIT"
Dwayne Hay,1977-02-11,3,1998,2001,"WSH,FLA,TBL,CGY"
Derek King,1967-02-11,13,1987,2000,"NYI,HAR,TOR,STL"
Brian Kinsella,1954-02-11,1,1976,1977,WSH
Ryan Lindgren,1998-02-11,1,2019,2020,NYR
Lew Morrison,1948-02-11,8,1970,1978,"PHI,ATF,PIT,WSH"
Steve Nemeth,1967-02-11,0,1988,1988,NYR
Frank Nigro,1960-02-11,1,1983,1984,TOR
Mathieu Olivier,1997-02-11,0,2020,2020,NSH
Jamie Pushor,1973-02-11,10,1996,2006,"DET,MDA,DAL,CBJ,PIT,NYR"
Jeremy Reich,1979-02-11,4,2004,2008,"CBJ,BOS"
Mike Richards,1985-02-11,10,2006,2016,"PHI,LAK,WSH"
Bryce Salvador,1976-02-11,14,2001,2015,"STL,NJD"
Alexander Semak,1966-02-11,5,1992,1997,"NJD,TBL,NYI,VAN"
Eddie Shack,1937-02-11,16,1959,1975,"NYR,TOR,BOS,LAK,BUF,PIT"
Ville Siren,1964-02-11,4,1986,1990,"PIT,MNS"
Jaroslav Spacek,1974-02-11,13,1999,2012,"FLA,CHI,CBJ,EDM,BUF,MTL,CAR"
Greg Stefan,1961-02-11,8,1982,1990,DET
Ulf Sterner,1941-02-11,0,1965,1965,NYR
David Struch,1971-02-11,0,1994,1994,CGY
Maxime Talbot,1984-02-11,10,2006,2016,"PIT,PHI,COL,BOS"
Joe Ward,1961-02-11,0,1981,1981,CLR
Bob Wilkie,1969-02-11,3,1991,1994,"DET,PHI"
Fred Ahern,1952-02-12,3,1975,1978,"CGS,CLE,CLR"
Russ Anderson,1955-02-12,8,1977,1985,"PIT,HAR,LAK"
Curtis Brown,1976-02-12,13,1995,2008,"BUF,SJS,CHI"
Frederic Chabot,1968-02-12,8,1991,1999,"MTL,PHI,LAK"
Rico Fata,1980-02-12,8,1999,2007,"CGY,NYR,PIT,ATL,WSH"
Alex Galchenyuk,1994-02-12,7,2013,2020,"MTL,ARI,MIN,PIT"
Colton Gillies,1989-02-12,4,2009,2013,"MIN,CBJ"
Jonas Hiller,1982-02-12,8,2008,2016,"ANA,CGY"
Martin Houle,1985-02-12,0,2007,2007,PHI
John Keating,1908-02-12,1,1932,1933,NYA
Jacques Locas,1926-02-12,1,1948,1949,MTL
Petr Mika,1979-02-12,0,2000,2000,NYI
Stefan Noesen,1993-02-12,5,2015,2020,"ANA,NJD,PIT,SJS"
Owen Nolan,1972-02-12,19,1991,2010,"QUE,COL,SJS,TOR,PHX,CGY,MIN"
George Owen,1901-02-12,4,1929,1933,BOS
Michel Petit,1964-02-12,15,1983,1998,"VAN,NYR,QUE,TOR,CGY,LAK,TBL,EDM,PHI,PHX"
John Purves,1968-02-12,0,1991,1991,WSH
Konstantin Pushkarev,1985-02-12,1,2006,2007,LAK
Mike Robitaille,1948-02-12,7,1970,1977,"NYR,DET,BUF,VAN"
Remi Royer,1978-02-12,0,1999,1999,CHI
Oleg Saprykin,1981-02-12,7,2000,2007,"CGY,PHX,OTT"
Hamby Shore,1886-02-12,0,1918,1918,OTS
Jonathan Sigalet,1986-02-12,0,2007,2007,BOS
Bobby Smith,1958-02-12,14,1979,1993,"MNS,MTL"
Wayne Smith,1943-02-12,0,1967,1967,CBH
Peter Sturgeon,1954-02-12,1,1980,1981,CLR
Brad Werenka,1969-02-12,8,1993,2001,"EDM,QUE,CHI,PIT,CGY"
Chris Winnes,1968-02-12,2,1992,1994,"BOS,PHI"
Niklas Backstrom,1978-02-13,9,2007,2016,"MIN,CGY"
Cecil Browne,1896-02-13,0,1928,1928,CBH
Patsy Callighen,1906-02-13,0,1928,1928,NYR
Kim Clackson,1955-02-13,1,1980,1981,"PIT,QUE"
Sylvain Cloutier,1974-02-13,0,1999,1999,CHI
Marc Crawford,1961-02-13,5,1982,1987,VAN
Luc Dufour,1963-02-13,2,1983,1985,"BOS,QUE,STL"
Todd Fedoruk,1979-02-13,9,2001,2010,"PHI,MDA,ANA,DAL,MIN,PHX,TBL"
Gaston Gingras,1959-02-13,9,1980,1989,"MTL,TOR,STL"
Gord Hampson,1959-02-13,0,1983,1983,CGY
Kaapo Kakko,2001-02-13,0,2020,2020,NYR
Zdenek Kutlak,1980-02-13,3,2001,2004,BOS
Al Montoya,1985-02-13,9,2009,2018,"PHX,NYI,WPG,FLA,MTL,EDM"
Cory Murphy,1978-02-13,2,2008,2010,"FLA,TBL,NJD"
Brad Norton,1975-02-13,5,2002,2007,"FLA,LAK,WSH,OTT,DET"
Daryl Reaugh,1965-02-13,6,1985,1991,"EDM,HAR"
Everett Sanipass,1968-02-13,4,1987,1991,"CHI,QUE"
Grant Sasser,1964-02-13,0,1984,1984,PIT
Wyatt Smith,1977-02-13,8,2000,2008,"PHX,NSH,NYI,MIN,COL"
Ben Street,1987-02-13,7,2013,2020,"CGY,COL,DET,ANA,NJD"
Mats Sundin*,1971-02-13,18,1991,2009,"QUE,TOR,VAN"
Vesa Viitakoski,1971-02-13,2,1994,1996,CGY
Juha Ylonen,1972-02-13,5,1997,2002,"PHX,OTT,TBL"
Frank Bathgate,1930-02-14,0,1953,1953,NYR
Bobby Boucher,1904-02-14,0,1924,1924,MTL
Charlie Burns,1936-02-14,14,1959,1973,"DET,BOS,OAK,PIT,MNS"
Matt Campanale,1988-02-14,0,2011,2011,NYI
Murph Chamberlain,1915-02-14,11,1938,1949,"TOR,MTL,BRO,BOS"
Val Delory,1927-02-14,0,1949,1949,NYR
Nikolaj Ehlers,1996-02-14,4,2016,2020,WPG
Marian Gaborik,1982-02-14,17,2001,2018,"MIN,NYR,CBJ,LAK,OTT"
Howie Glover,1935-02-14,10,1959,1969,"CBH,DET,NYR,MTL"
John Hayden,1995-02-14,3,2017,2020,"CHI,NJD"
Milan Hejduk,1976-02-14,14,1999,2013,COL
Sean Hill,1970-02-14,15,1993,2008,"MTL,MDA,OTT,CAR,STL,FLA,NYI,MIN"
Val James,1957-02-14,5,1982,1987,"BUF,TOR"
Marko Jantunen,1971-02-14,0,1997,1997,CGY
Calle Johansson,1967-02-14,16,1988,2004,"BUF,WSH,TOR"
Ryan Johnston,1992-02-14,1,2016,2017,MTL
Bogdan Kiselevich,1990-02-14,0,2019,2019,FLA
Viktor Kozlov,1975-02-14,14,1995,2009,"SJS,FLA,NJD,NYI,WSH"
Bonner Larose,1901-02-14,0,1926,1926,BOS
Gerry Lowrey,1906-02-14,5,1928,1933,"TOR,PTP,PHQ,CBH,OTS"
Dave Lowry,1965-02-14,18,1986,2004,"VAN,STL,FLA,SJS,CGY"
Ryan MacInnis,1996-02-14,0,2020,2020,CBJ
Mike MacWilliam,1967-02-14,0,1996,1996,NYI
Norm Milley,1980-02-14,4,2002,2006,"BUF,TBL"
Petr Mrazek,1992-02-14,7,2013,2020,"DET,PHI,CAR"
Jan Nemecek,1976-02-14,1,1999,2000,LAK
Eric Nystrom,1983-02-14,10,2006,2016,"CGY,MIN,DAL,NSH"
Matt O'Connor,1992-02-14,0,2016,2016,OTT
Walt Poddubny,1960-02-14,10,1982,1992,"EDM,TOR,NYR,QUE,NJD"
Tom Pyatt,1987-02-14,9,2010,2019,"MTL,TBL,OTT"
Jack Rodewald,1994-02-14,1,2018,2019,OTT
Simo Saarinen,1963-02-14,0,1985,1985,NYR
Brandon Sutter,1989-02-14,11,2009,2020,"CAR,PIT,VAN"
Petr Svoboda,1966-02-14,16,1985,2001,"MTL,BUF,PHI,TBL"
Boris Valabik,1986-02-14,2,2008,2010,ATL
Ilya Zubov,1987-02-14,1,2008,2009,OTT
Serge Aubin,1975-02-15,7,1999,2006,"COL,CBJ,ATL"
Bruce Bell,1965-02-15,5,1985,1990,"QUE,STL,NYR,EDM"
Gilles Boisvert,1933-02-15,0,1960,1960,DET
Sebastien Bordeleau,1975-02-15,6,1996,2002,"MTL,NSH,MIN,PHX"
Andy Brown,1944-02-15,2,1972,1974,"DET,PIT"
Dave Chartier,1961-02-15,0,1981,1981,WIN
Tim Cheveldae,1968-02-15,8,1989,1997,"DET,WIN,BOS"
Dennis Cholowski,1998-02-15,1,2019,2020,DET
Rob Cimetta,1970-02-15,3,1989,1992,"BOS,TOR"
Rejean Cloutier,1960-02-15,2,1980,1982,DET
Marty Dallman,1963-02-15,1,1988,1989,TOR
Martin Gendron,1974-02-15,3,1995,1998,"WSH,CHI"
Mel Hill,1914-02-15,8,1938,1946,"BOS,BRO,TOR"
Joshua Jacobs,1996-02-15,1,2019,2020,NJD
Jaromir Jagr,1972-02-15,27,1991,2018,"PIT,WSH,NYR,PHI,BOS,DAL,NJD,FLA,CGY"
Glenn Johannesen,1962-02-15,0,1986,1986,NYI
Markku Kyllonen,1962-02-15,0,1989,1989,WIN
Taylor Leier,1994-02-15,2,2016,2018,PHI
Ron Lyons,1909-02-15,0,1931,1931,"BOS,PHQ"
Adam Mair,1979-02-15,11,2000,2011,"TOR,LAK,BUF,NJD"
Tony McKegney,1958-02-15,12,1979,1991,"BUF,QUE,MNS,NYR,STL,DET,CHI"
Leo Murray,1906-02-15,0,1933,1933,MTL
Brent Peterson,1958-02-15,10,1979,1989,"DET,BUF,VAN,HAR"
Ronald Petrovicky,1977-02-15,6,2001,2007,"CGY,NYR,ATL,PIT"
Daniel Poudrier,1964-02-15,2,1986,1988,QUE
Brian Propp,1959-02-15,14,1980,1994,"PHI,BOS,MNS,HAR"
Robbie Russo,1993-02-15,0,2017,2017,DET
Chuck Scherza,1923-02-15,1,1944,1945,"BOS,NYR"
Craig Simpson,1967-02-15,9,1986,1995,"PIT,EDM,BUF"
Phil Stevens,1893-02-15,8,1918,1926,"MTW,MTL,BOS"
Harvey Teno,1915-02-15,0,1939,1939,DET
Mitch Wilson,1962-02-15,2,1985,1987,"NJD,PIT"
Bobby Bauer*,1915-02-16,15,1937,1952,BOS
Blair Betts,1980-02-16,9,2002,2011,"CGY,NYR,PHI"
Luc Bourdon,1987-02-16,1,2007,2008,VAN
Ken Broderick,1942-02-16,5,1970,1975,"MNS,BOS"
Les Costello,1928-02-16,0,1949,1949,TOR
Colin Forbes,1976-02-16,9,1997,2006,"PHI,TBL,OTT,NYR,WSH"
Bernie Geoffrion*,1931-02-16,17,1951,1968,"MTL,NYR"
Jordan Greenway,1997-02-16,2,2018,2020,MIN
Obs Heximer,1910-02-16,5,1930,1935,"NYR,BOS,NYA"
Korbinian Holzer,1988-02-16,9,2011,2020,"TOR,ANA,NSH"
Ladislav Karabin,1970-02-16,0,1994,1994,PIT
Michael Liambas,1989-02-16,1,2017,2018,"NSH,ANA"
Garth MacGuigan,1956-02-16,4,1980,1984,NYI
Lanny McDonald*,1953-02-16,15,1974,1989,"TOR,CLR,CGY"
Peter McDuffe,1948-02-16,4,1972,1976,"STL,NYR,KCS,DET"
Nick Metz,1914-02-16,13,1935,1948,TOR
Aleksey Morozov,1977-02-16,6,1998,2004,PIT
Mark Mowers,1974-02-16,9,1999,2008,"NSH,DET,BOS,ANA"
Marty Murray,1975-02-16,11,1996,2007,"CGY,PHI,CAR,LAK"
Paul Nicholson,1954-02-16,2,1975,1977,WSH
Chris Nielsen,1980-02-16,1,2001,2002,CBJ
Cristopher Nilstorp,1984-02-16,1,2013,2014,DAL
Doug O'Brien,1984-02-16,0,2006,2006,TBL
Evan Oberg,1988-02-16,2,2010,2012,"VAN,TBL"
Jimmie Olvestad,1980-02-16,1,2002,2003,TBL
Austin Poganski,1996-02-16,0,2020,2020,STL
Darcy Rota,1953-02-16,10,1974,1984,"CBH,ATF,VAN"
Tuomo Ruutu,1983-02-16,12,2004,2016,"CHI,CAR,NJD"
Peter Smrek,1979-02-16,1,2001,2002,"NYR,STL"
Andre St. Laurent,1953-02-16,10,1974,1984,"NYI,DET,LAK,PIT"
Sam St. Laurent,1959-02-16,4,1986,1990,"NJD,DET"
George Swarbrick,1942-02-16,3,1968,1971,"OAK,PIT,PHI"
Owen Tippett,1999-02-16,0,2018,2018,FLA
Mikhail Yakubov,1982-02-16,2,2004,2006,"CHI,FLA"
Sebastian Aho,1996-02-17,0,2018,2018,NYI
Kaspars Astashenko,1975-02-17,1,2000,2001,TBL
Victor Bartley,1988-02-17,3,2013,2016,"NSH,MTL"
Claude Cardin,1941-02-17,0,1968,1968,STL
D'arcy Coulson,1908-02-17,0,1931,1931,PHQ
Hnat Domenichelli,1976-02-17,6,1997,2003,"CGY,HAR,ATL,MIN"
Brodie Dupont,1987-02-17,0,2011,2011,NYR
Adam Fox,1998-02-17,0,2020,2020,NYR
Michael Frolik,1988-02-17,11,2009,2020,"FLA,CHI,WPG,CGY,BUF"
Todd Harvey,1975-02-17,11,1995,2006,"DAL,NYR,SJS,EDM"
Archie Henderson,1957-02-17,2,1981,1983,"WSH,MNS,HAR"
Max Jones,1998-02-17,1,2019,2020,ANA
Nathan LaFayette,1973-02-17,5,1994,1999,"STL,VAN,NYR,LAK"
Marc Magnan,1962-02-17,0,1983,1983,TOR
Peter Mannino,1984-02-17,3,2009,2012,"NYI,ATL,WPG"
Paul Meger,1929-02-17,4,1951,1955,MTL
Drew Miller,1984-02-17,9,2008,2017,"ANA,DET,TBL"
Darren Pang,1964-02-17,4,1985,1989,"CBH,CHI"
Vinny Prospal,1975-02-17,16,1997,2013,"PHI,OTT,FLA,TBL,MDA,NYR,CBJ"
Al Pudas,1899-02-17,0,1927,1927,TOR
Reg Reid,1899-02-17,1,1925,1926,TRS
Gerry Rioux,1959-02-17,0,1980,1980,WIN
Luc Robitaille*,1966-02-17,19,1987,2006,"LAK,PIT,NYR,DET"
Jean-Yves Roy,1969-02-17,3,1995,1998,"NYR,OTT,BOS"
Lindy Ruff,1960-02-17,11,1980,1991,"BUF,NYR"
Jim Rutherford*,1949-02-17,12,1971,1983,"DET,PIT,LAK,TOR"
Stefan Ruzicka,1985-02-17,2,2006,2008,PHI
Gary Shuchuk,1967-02-17,5,1991,1996,"DET,LAK"
Vladimir Vujtek,1972-02-17,11,1992,2003,"MTL,EDM,TBL,ATL,PIT"
Nik Antropov,1980-02-18,13,2000,2013,"TOR,NYR,ATL,WPG"
Ryan Bonni,1979-02-18,0,2000,2000,VAN
Mike Card,1986-02-18,0,2007,2007,BUF
Blake Comeau,1986-02-18,13,2007,2020,"NYI,CGY,CBJ,PIT,COL,DAL"
Maurice Courteau,1920-02-18,0,1944,1944,BOS
Dick Duff*,1936-02-18,17,1955,1972,"TOR,NYR,MTL,LAK,BUF"
Fred Elliott,1903-02-18,0,1929,1929,OTS
Brandon Gormley,1992-02-18,2,2014,2016,"PHX,ARI,COL"
Thomas Gradin,1956-02-18,8,1979,1987,"VAN,BOS"
Cody Hodgson,1990-02-18,5,2011,2016,"VAN,BUF,NSH"
Warren Holmes,1957-02-18,2,1982,1984,LAK
Marty Howe,1954-02-18,5,1980,1985,"HAR,BOS"
Tom Johnson*,1928-02-18,17,1948,1965,"MTL,BOS"
Ross Johnston,1994-02-18,4,2016,2020,NYI
Wally Kilrea,1909-02-18,8,1930,1938,"OTS,PHQ,NYA,MTM,DET"
Kris King,1966-02-18,13,1988,2001,"DET,NYR,WIN,PHX,TOR,CHI"
Slater Koekkoek,1994-02-18,5,2015,2020,"TBL,CHI"
Moe Lemay,1962-02-18,7,1982,1989,"VAN,EDM,BOS,WIN"
Martin Marincin,1992-02-18,6,2014,2020,"EDM,TOR"
Ab McDonald,1936-02-18,13,1959,1972,"MTL,CBH,BOS,DET,PIT,STL"
Alexander Mogilny,1969-02-18,16,1990,2006,"BUF,VAN,NJD,TOR"
Andy Moog,1960-02-18,17,1981,1998,"EDM,BOS,DAL,MTL"
Glenn Mulvenna,1967-02-18,1,1992,1993,"PIT,PHI"
Rick Newell,1948-02-18,1,1973,1974,DET
Jason Podollan,1976-02-18,5,1997,2002,"FLA,TOR,LAK,NYI"
Goldie Prodgers,1891-02-18,5,1920,1925,"TRS,HAM"
Yann Sauve,1990-02-18,3,2011,2014,VAN
Jack Studnicka,1999-02-18,0,2020,2020,BOS
Josh Teves,1995-02-18,0,2019,2019,VAN
Ivan Vishnevskiy,1988-02-18,1,2009,2010,DAL
Bob Wilson,1934-02-18,0,1954,1954,CBH
Jim Wiste,1946-02-18,2,1969,1971,"CBH,VAN"
Ruslan Batyrshin,1975-02-19,0,1996,1996,LAK
John Blue,1966-02-19,3,1993,1996,"BOS,BUF"
Kyle Chipchura,1986-02-19,8,2008,2016,"MTL,ANA,PHX,ARI"
Joe Crozier,1929-02-19,0,1960,1960,TOR
Jerry D'Amigo,1991-02-19,1,2014,2015,"TOR,BUF"
Rob DiMaio,1968-02-19,17,1989,2006,"NYI,TBL,PHI,BOS,NYR,CAR,DAL"
Peter Douris,1966-02-19,12,1986,1998,"WIN,BOS,MDA,DAL"
Randy Gregg,1956-02-19,9,1983,1992,"EDM,VAN"
Pierre Hedin,1978-02-19,0,2004,2004,TOR
Linus Klasen,1986-02-19,0,2011,2011,NSH
Gary Leeman,1964-02-19,13,1984,1997,"TOR,CGY,MTL,VAN,STL"
Charlie Luksa,1954-02-19,0,1980,1980,HAR
Shawn Matthias,1988-02-19,10,2008,2018,"FLA,VAN,COL,TOR,WPG"
Kris Newbury,1982-02-19,7,2007,2014,"TOR,DET,NYR,PHI"
Russell Oatman,1905-02-19,2,1927,1929,"DTC,MTM,NYR"
Bob Parent,1958-02-19,1,1982,1983,TOR
Gord Reid,1912-02-19,0,1937,1937,NYA
Jason Ryznar,1983-02-19,0,2006,2006,NJD
Raymond Sawada,1985-02-19,2,2009,2011,DAL
Jordan Sigalet,1981-02-19,0,2006,2006,BOS
Gene Sobchuk,1951-02-19,0,1974,1974,VAN
Clayton Stoner,1985-02-19,7,2010,2017,"MIN,ANA"
Jeff Taffe,1981-02-19,9,2003,2012,"PHX,NYR,PIT,FLA,CHI,MIN"
Ryan Whitney,1983-02-19,8,2006,2014,"PIT,ANA,EDM,FLA"
Pierre Bouchard,1948-02-20,11,1971,1982,"MTL,WSH"
Norm Burns,1918-02-20,0,1942,1942,NYR
Wally Clune,1930-02-20,0,1956,1956,MTL
Joe Daley,1943-02-20,3,1969,1972,"PIT,BUF,DET"
Jamie Devane,1991-02-20,0,2014,2014,TOR
Bill Dickie,1916-02-20,0,1942,1942,CBH
Christopher Didomenico,1989-02-20,1,2017,2018,OTT
Phil Esposito*,1942-02-20,17,1964,1981,"CBH,BOS,NYR"
Rick Green,1956-02-20,15,1977,1992,"WSH,MTL,DET,NYI"
Brent Gretzky,1972-02-20,1,1994,1995,TBL
Taylor Hall,1964-02-20,4,1984,1988,"VAN,BOS"
Glen Hanlon,1957-02-20,13,1978,1991,"VAN,STL,NYR,DET"
Martin Hanzal,1987-02-20,11,2008,2019,"PHX,ARI,MIN,DAL"
Gord Haworth,1932-02-20,0,1953,1953,NYR
Mark Kachowski,1965-02-20,2,1988,1990,PIT
Sergei Kharin,1963-02-20,0,1991,1991,WIN
Maxim Letunov,1996-02-20,0,2020,2020,SJS
Ben Lovejoy,1984-02-20,10,2009,2019,"PIT,ANA,NJD,DAL"
Bill Orban,1944-02-20,2,1968,1970,"CBH,MNS"
Blake Pietila,1993-02-20,3,2016,2019,NJD
Bob Ritchie,1955-02-20,1,1977,1978,"DET,PHI"
Christian Ruuttu,1964-02-20,8,1987,1995,"BUF,CHI,VAN"
Dave Scatchard,1976-02-20,13,1998,2011,"VAN,NYI,BOS,PHX,NSH,STL"
Jarred Tinordi,1992-02-20,7,2013,2020,"MTL,ARI,NSH"
Niclas Wallin,1975-02-20,10,2001,2011,"CAR,SJS"
Jake Walman,1996-02-20,0,2020,2020,STL
Brendan Witt,1975-02-20,14,1996,2010,"WSH,NSH,NYI"
Dane Byers,1986-02-21,4,2008,2012,"NYR,CBJ"
Jason Cirone,1971-02-21,0,1992,1992,WIN
Ian Cole,1989-02-21,9,2011,2020,"STL,PIT,CBJ,COL"
Charlie Cotch,1900-02-21,0,1925,1925,"HAM,TRS"
Ken Duggan,1963-02-21,0,1988,1988,MNS
Jerome Dupont,1962-02-21,5,1982,1987,"CBH,TOR"
Brad Fast,1980-02-21,0,2004,2004,CAR
Evgeny Grachev,1990-02-21,1,2011,2012,"NYR,STL"
Danny Grant,1946-02-21,13,1966,1979,"MTL,MNS,DET,LAK"
Hap Holmes*,1888-02-21,10,1918,1928,"TRA,DTC"
Greg Holst,1954-02-21,2,1976,1978,NYR
Hank Lammens,1966-02-21,0,1994,1994,OTT
Mike Laughton,1944-02-21,3,1968,1971,"OAK,CGS"
Mark LaVarre,1965-02-21,2,1986,1988,"CBH,CHI"
Derek Laxdal,1966-02-21,6,1985,1991,"TOR,NYI"
Lynn Loyns,1981-02-21,3,2003,2006,"SJS,CGY"
Wayne McBean,1969-02-21,6,1988,1994,"LAK,NYI,WIN"
Larry Melnyk,1960-02-21,9,1981,1990,"BOS,EDM,NYR,VAN"
Jake Muzzin,1989-02-21,9,2011,2020,"LAK,TOR"
Mark Renaud,1959-02-21,4,1980,1984,"HAR,BUF"
Brian Rolston,1973-02-21,17,1995,2012,"NJD,BOS,COL,MIN,NYI"
Kevin Sawyer,1974-02-21,7,1996,2003,"BOS,STL,PHX,MDA"
Ryan Smyth,1976-02-21,19,1995,2014,"EDM,NYI,COL,LAK"
Don Tannahill,1949-02-21,1,1973,1974,VAN
Mattias Tedenby,1990-02-21,3,2011,2014,NJD
Devon Toews,1994-02-21,1,2019,2020,NYI
Jim Vandermeer,1980-02-21,9,2003,2012,"PHI,CHI,CGY,PHX,EDM,SJS"
James Wisniewski,1984-02-21,10,2006,2016,"CHI,ANA,MTL,NYI,CBJ,CAR"
Jakub Zboril,1997-02-21,0,2019,2019,BOS
Sid Abel*,1918-02-22,15,1939,1954,"DET,CBH"
Jozef Balej,1982-02-22,2,2004,2006,"MTL,NYR,VAN"
Chris Bigras,1995-02-22,2,2016,2018,COL
Patrick Boileau,1975-02-22,7,1997,2004,"WSH,DET,PIT"
Nicolas Deslauriers,1991-02-22,6,2014,2020,"BUF,MTL,ANA"
Aaron Gavey,1974-02-22,10,1996,2006,"TBL,CGY,DAL,MIN,TOR,MDA"
Eddie Gerard*,1890-02-22,5,1918,1923,OTS
Carsen Germyn,1982-02-22,1,2006,2007,CGY
Scott Glennie,1991-02-22,0,2012,2012,DAL
Al Hangsleben,1953-02-22,2,1980,1982,"HAR,WSH,LAK"
Lorne Henning,1952-02-22,8,1973,1981,NYI
Mathias Johansson,1974-02-22,0,2003,2003,"CGY,PIT"
Ty Jones,1979-02-22,5,1999,2004,"CHI,FLA"
Pat LaFontaine*,1965-02-22,14,1984,1998,"NYI,BUF,NYR"
William Lagesson,1996-02-22,0,2020,2020,EDM
Robert Logan,1964-02-22,2,1987,1989,"BUF,LAK"
Jason Marshall,1971-02-22,14,1992,2006,"STL,MDA,WSH,MIN,SJS"
Curtis McKenzie,1991-02-22,3,2015,2018,DAL
Mark McNeill,1993-02-22,1,2016,2017,"CHI,DAL"
Bill Mitchell,1930-02-22,0,1964,1964,DET
Andrej Nestrasil,1991-02-22,2,2015,2017,"CAR,DET"
Mark Paterson,1964-02-22,3,1983,1986,HAR
Paul Postma,1989-02-22,7,2011,2018,"ATL,WPG,BOS"
Joe Reekie,1965-02-22,16,1986,2002,"BUF,NYI,TBL,WSH,CHI"
Earl Roche,1910-02-22,4,1931,1935,"MTM,BOS,OTS,DET,STE"
Dominic Roussel,1970-02-22,9,1992,2001,"PHI,WIN,MDA,EDM"
Ilya Samsonov,1997-02-22,0,2020,2020,WSH
Brent Severyn,1966-02-22,9,1990,1999,"QUE,FLA,NYI,COL,MDA,DAL"
Des Smith,1914-02-22,4,1938,1942,"MTM,MTL,BOS,CBH"
Mike Stothers,1962-02-22,3,1985,1988,"PHI,TOR"
Kevin Wortman,1969-02-22,0,1994,1994,CGY
Tim Young,1955-02-22,9,1976,1985,"MNS,WIN,PHI"
Kevin Connauton,1990-02-23,6,2014,2020,"DAL,CBJ,ARI,COL"
Andre Deveaux,1984-02-23,3,2009,2012,"TOR,NYR"
John Druce,1966-02-23,9,1989,1998,"WSH,WIN,LAK,PHI"
Corey Elkins,1985-02-23,0,2010,2010,LAK
Kris Fredheim,1987-02-23,0,2012,2012,MIN
Jordan Hendry,1984-02-23,5,2008,2013,"CHI,ANA"
Doug Kostynski,1963-02-23,1,1984,1985,BOS
Stefan Matteau,1994-02-23,7,2013,2020,"NJD,MTL,VEG,CBJ"
Mike Meeker,1958-02-23,0,1979,1979,PIT
Greg Meredith,1958-02-23,2,1981,1983,CGY
Jeff O'Neill,1976-02-23,11,1996,2007,"HAR,CAR,TOR"
Peter Scamurra,1955-02-23,4,1976,1980,WSH
Marco Scandella,1990-02-23,9,2011,2020,"MIN,BUF,MTL,STL"
Nick Schmaltz,1996-02-23,3,2017,2020,"CHI,ARI"
Dan Snyder,1978-02-23,2,2001,2003,ATL
Jimmy Thomson,1927-02-23,12,1946,1958,"TOR,CBH"
Mike Torchia,1972-02-23,0,1995,1995,DAL
Earl Anderson,1951-02-24,2,1975,1977,"BOS,DET"
Jonas Andersson,1981-02-24,9,2002,2011,"NSH,VAN"
Tyler Bertuzzi,1995-02-24,3,2017,2020,DET
Jeff Brubaker,1958-02-24,9,1980,1989,"HAR,MTL,CGY,TOR,EDM,NYR,DET"
Murray Costello*,1934-02-24,3,1954,1957,"CBH,BOS,DET"
Tim Coulis,1958-02-24,6,1980,1986,"WSH,MNS"
Don Cutts,1953-02-24,0,1980,1980,EDM
Phillip Danault,1993-02-24,5,2015,2020,"CHI,MTL"
Tim Erixon,1991-02-24,3,2012,2015,"NYR,CBJ,CHI,TOR"
Paul Evans,1955-02-24,1,1977,1978,TOR
Chris Herperger,1974-02-24,3,2000,2003,"CHI,OTT,ATL"
Terry Hollinger,1971-02-24,1,1994,1995,STL
Alex Kovalev,1973-02-24,20,1993,2013,"NYR,PIT,MTL,OTT,FLA"
Francois Lacombe,1948-02-24,11,1969,1980,"OAK,BUF,QUE"
Kevin MacDonald,1966-02-24,0,1994,1994,OTT
Doug McCaig,1919-02-24,9,1942,1951,"DET,CBH"
George Pargeter,1923-02-24,0,1947,1947,MTL
Brian Savage,1971-02-24,12,1994,2006,"MTL,PHX,STL,PHI"
Neil Strain,1926-02-24,0,1953,1953,NYR
Mike Vernon,1963-02-24,19,1983,2002,"CGY,DET,SJS,FLA"
Wojtek Wolski,1986-02-24,7,2006,2013,"COL,PHX,NYR,FLA,WSH"
Justin Abdelkader,1987-02-25,12,2008,2020,DET
Brock Boeser,1997-02-25,3,2017,2020,VAN
Connor Brickley,1992-02-25,3,2016,2019,"FLA,NYR"
Colin Chisholm,1963-02-25,0,1987,1987,MNS
Marian Cisar,1978-02-25,2,2000,2002,NSH
King Clancy*,1903-02-25,15,1922,1937,"OTS,TOR"
Byron Dafoe,1971-02-25,11,1993,2004,"WSH,LAK,BOS,ATL"
Stefan Della Rovere,1990-02-25,0,2011,2011,STL
Joe DiPenta,1979-02-25,5,2003,2008,"ATL,MDA,ANA"
Gary Doak,1946-02-25,15,1966,1981,"BOS,DET,VAN,NYR"
Joel Farabee,2000-02-25,0,2020,2020,PHI
Len Fontaine,1948-02-25,1,1973,1974,DET
Alexandre Fortin,1997-02-25,0,2019,2019,CHI
Jamie Fritsch,1985-02-25,0,2009,2009,PHI
Paul Goodman,1905-02-25,1,1940,1941,CBH
Duke Harris,1942-02-25,0,1968,1968,"MNS,TOR"
Rick Hayward,1966-02-25,0,1991,1991,LAK
Anders Hedberg,1951-02-25,6,1979,1985,NYR
John Holota,1921-02-25,3,1943,1946,DET
Darrin Madeley,1968-02-25,2,1993,1995,OTT
Troy Mallette,1970-02-25,8,1990,1998,"NYR,EDM,NJD,OTT,BOS,TBL"
Frank Mario,1921-02-25,3,1942,1945,BOS
Clare Martin,1922-02-25,10,1942,1952,"BOS,DET,CBH,NYR"
Jamie McBain,1988-02-25,7,2010,2017,"CAR,BUF,LAK,ARI"
Cam Newton,1950-02-25,2,1971,1973,PIT
Joakim Nordstrom,1992-02-25,6,2014,2020,"CHI,CAR,BOS"
Andre Peloffy,1951-02-25,0,1975,1975,WSH
Alan Quine,1993-02-25,4,2016,2020,"NYI,CGY"
Jeff Schultz,1986-02-25,9,2007,2016,"WSH,LAK"
Lukas Sedlak,1993-02-25,2,2017,2019,CBJ
Brandon Smith,1973-02-25,4,1999,2003,"BOS,NYI"
John Smrke,1956-02-25,2,1978,1980,"STL,QUE"
Ted Taylor,1942-02-25,7,1965,1972,"NYR,DET,MNS,VAN"
Dominic Turgeon,1996-02-25,1,2018,2019,DET
T.J. Tynan,1992-02-25,3,2017,2020,"CBJ,COL"
Mike Vecchione,1993-02-25,0,2017,2017,PHI
Anton Volchenkov,1982-02-25,12,2003,2015,"OTT,NJD,NSH"
P.J. Axelsson,1975-02-26,11,1998,2009,BOS
Larry Bolonchuk,1952-02-26,5,1973,1978,"VAN,WSH"
Andrei Chibisov,1993-02-26,0,2020,2020,WPG
Bob Cunningham,1941-02-26,1,1961,1962,NYR
Kevin Dallman,1981-02-26,2,2006,2008,"BOS,STL,LAK"
Barry Dean,1955-02-26,2,1977,1979,"CLR,PHI"
Marc Fortier,1966-02-26,5,1988,1993,"QUE,LAK,OTT"
Brian Gibbons,1988-02-26,6,2014,2020,"PIT,CBJ,NJD,ANA,OTT,CAR"
Barclay Goodrow,1993-02-26,5,2015,2020,"SJS,TBL"
Mikael Granlund,1992-02-26,7,2013,2020,"MIN,NSH"
Mike Hoffman,1963-02-26,3,1983,1986,HAR
Martins Karsums,1986-02-26,0,2009,2009,"BOS,TBL"
Rick Knickle,1960-02-26,1,1993,1994,LAK
Darcy Loewen,1969-02-26,4,1990,1994,"BUF,OTT"
Jacob MacDonald,1993-02-26,0,2019,2019,FLA
Joe Mullen*,1957-02-26,15,1982,1997,"STL,CGY,PIT,BOS"
Marty Reasoner,1977-02-26,14,1999,2013,"STL,EDM,BOS,ATL,FLA,NYI"
Leif Rohlin,1968-02-26,1,1996,1997,VAN
Kirill Safronov,1981-02-26,1,2002,2003,"ATL,PHX"
Paxton Schafer,1976-02-26,0,1997,1997,BOS
Jarrod Skalde,1971-02-26,11,1991,2002,"NJD,MDA,CGY,CHI,DAL,SJS,ATL,PHI"
Jacob Trouba,1994-02-26,6,2014,2020,"WPG,NYR"
Denis Tsygurov,1971-02-26,2,1994,1996,"BUF,LAK"
Mike Wilson,1975-02-26,7,1996,2003,"BUF,FLA,PIT,NYR"
Ralph Wycherley,1920-02-26,1,1941,1942,"NYA,BRO"
Adam Almqvist,1991-02-27,0,2014,2014,DET
Joe Benoit,1916-02-27,6,1941,1947,MTL
Andy Blair,1908-02-27,8,1929,1937,"TOR,CBH"
Jerry Butler,1951-02-27,10,1973,1983,"NYR,STL,TOR,VAN,WIN"
Casey Cizikas,1991-02-27,8,2012,2020,NYI
Braydon Coburn,1985-02-27,14,2006,2020,"ATL,PHI,TBL"
John Curry,1984-02-27,6,2009,2015,"PIT,MIN"
John Davidson,1953-02-27,9,1974,1983,"STL,NYR"
Ab DeMarco,1949-02-27,9,1970,1979,"NYR,STL,PIT,VAN,LAK,BOS"
Dallas Eakins,1967-02-27,9,1993,2002,"WIN,FLA,STL,NYR,PHX,TOR,NYI,CGY"
Lee Fogolin,1926-02-27,7,1949,1956,"DET,CBH"
Matthew Highmore,1996-02-27,2,2018,2020,CHI
Dustin Jeffrey,1988-02-27,7,2009,2016,"PIT,DAL,ARI"
Mike Kaszycki,1956-02-27,5,1978,1983,"NYI,TOR,WSH"
Greg Koehler,1975-02-27,0,2001,2001,CAR
Robert Kron,1967-02-27,11,1991,2002,"VAN,HAR,CAR,CBJ"
Marc Lamothe,1974-02-27,4,2000,2004,"CHI,DET"
Mike Matheson,1994-02-27,4,2016,2020,FLA
Jaroslav Modry,1971-02-27,14,1994,2008,"NJD,LAK,OTT,ATL,DAL,PHI"
Dean Morton,1968-02-27,0,1990,1990,DET
Jimmy Orlando,1916-02-27,6,1937,1943,DET
Paul Raymond,1913-02-27,6,1933,1939,MTL
Philippe Sauve,1980-02-27,3,2004,2007,"COL,CGY,PHX,BOS"
Mike Sullivan,1968-02-27,10,1992,2002,"SJS,CGY,BOS,PHX"
Brian Wilks,1966-02-27,4,1985,1989,LAK
J.T. Wyman,1986-02-27,3,2010,2013,"MTL,TBL"
Clint Albright,1926-02-28,0,1949,1949,NYR
Matt Carey,1992-02-28,0,2014,2014,CHI
Oscar Dansk,1994-02-28,2,2018,2020,VEG
Jeff Daw,1972-02-28,0,2002,2002,COL
Jean-Paul Denis,1924-02-28,3,1947,1950,NYR
Gary Dillon,1959-02-28,0,1981,1981,CLR
Rhett Gardner,1996-02-28,0,2020,2020,DAL
Jeff Greenlaw,1968-02-28,7,1987,1994,"WSH,FLA"
Henrik Haapala,1994-02-28,0,2018,2018,FLA
Jay Johnston,1958-02-28,1,1981,1982,WSH
Ronalds Kenins,1991-02-28,1,2015,2016,VAN
Stephan Lebeau,1968-02-28,6,1989,1995,"MTL,MDA"
Eric Lindros*,1973-02-28,14,1993,2007,"PHI,NYR,TOR,DAL"
Wilf Loughlin,1896-02-28,0,1924,1924,TRS
Danny Lucas,1958-02-28,0,1979,1979,PHI
Mikko Makela,1965-02-28,9,1986,1995,"NYI,LAK,BUF,BOS"
Joe Malone*,1890-02-28,6,1918,1924,"MTL,QBC,HAM"
Jack McDonald,1887-02-28,4,1918,1922,"MTL,MTW,QBC,TRS"
Shawn McEachern,1969-02-28,14,1992,2006,"PIT,LAK,BOS,OTT,ATL"
Ryan McGill,1969-02-28,3,1992,1995,"CHI,PHI,EDM"
Dale McTavish,1972-02-28,0,1997,1997,CGY
Andreas Nodl,1987-02-28,4,2009,2013,"PHI,CAR"
Mark Pavelich,1958-02-28,10,1982,1992,"NYR,MNS,SJS"
Poul Popiel,1943-02-28,14,1966,1980,"BOS,LAK,DET,VAN,EDM"
Brett Seney,1996-02-28,1,2019,2020,NJD
Givani Smith,1998-02-28,0,2020,2020,DET
Mike Stutzel,1979-02-28,0,2004,2004,PHX
Ryan VandenBussche,1973-02-28,9,1997,2006,"NYR,CHI,PIT"
Jakub Vrana,1996-02-28,3,2017,2020,WSH
Barry Wilkins,1947-02-28,9,1967,1976,"BOS,VAN,PIT"
Jordan Willis,1975-02-28,0,1996,1996,DAL
Lyndon Byers,1964-02-29,9,1984,1993,"BOS,SJS"
Dan Daoust,1960-02-29,7,1983,1990,"MTL,TOR"
Jim Dobson,1960-02-29,4,1980,1984,"MNS,CLR,QUE"
Kari Eloranta,1956-02-29,5,1982,1987,"CGY,STL"
Simon Gagne,1980-02-29,15,2000,2015,"PHI,TBL,LAK,BOS"
Henri Richard*,1936-02-29,19,1956,1975,MTL
Bobby Sanguinetti,1988-02-29,3,2010,2013,"NYR,CAR"
Cam Ward,1984-02-29,13,2006,2019,"CAR,CHI"
Darryl Williams,1968-02-29,0,1993,1993,LAK
Max Bentley*,1920-03-01,13,1941,1954,"CBH,TOR,NYR"
Claude Boivin,1970-03-01,3,1992,1995,"PHI,OTT"
Pat Boutette,1952-03-01,9,1976,1985,"TOR,HAR,PIT"
Jim Brown,1960-03-01,0,1983,1983,LAK
Jeff Brownschidle,1959-03-01,1,1982,1983,HAR
Mike Buchanan,1932-03-01,0,1952,1952,CBH
Billy Coutu,1892-03-01,9,1918,1927,"MTL,HAM,BOS"
Roland Eriksson,1954-03-01,2,1977,1979,"MNS,VAN"
Ron Francis*,1963-03-01,22,1982,2004,"HAR,PIT,CAR,TOR"
Michel Galarneau,1961-03-01,2,1981,1983,HAR
Jocelyn Guevremont,1951-03-01,8,1972,1980,"VAN,BUF,NYR"
Marc Habscheid,1963-03-01,10,1982,1992,"EDM,MNS,DET,CGY"
Paul Haynes,1910-03-01,10,1931,1941,"MTM,BOS,MTL"
Riku Helenius,1988-03-01,0,2009,2009,TBL
Bert Hirschfeld,1929-03-01,1,1950,1951,MTL
Bud Holloway,1988-03-01,0,2016,2016,MTL
Tony Joseph,1969-03-01,0,1989,1989,WIN
Jeff Lank,1975-03-01,0,2000,2000,PHI
Jeff Libby,1974-03-01,0,1998,1998,NYI
Kent McDonell,1979-03-01,1,2003,2004,CBJ
Jason Miller,1971-03-01,2,1991,1993,NJD
Richard Mulhern,1955-03-01,5,1976,1981,"ATF,LAK,TOR,WIN"
Marcus Nilson,1978-03-01,9,1999,2008,"FLA,CGY"
Jeff Paul,1978-03-01,0,2003,2003,COL
Victor Rask,1993-03-01,5,2015,2020,"CAR,MIN"
Matt Roy,1995-03-01,1,2019,2020,LAK
Chris Schmidt,1976-03-01,0,2003,2003,LAK
Gilles Senn,1996-03-01,0,2020,2020,NJD
Scott Sharples,1968-03-01,0,1992,1992,CGY
Allan Stanley*,1926-03-01,20,1949,1969,"NYR,CBH,BOS,TOR,PHI"
Alex Steen,1984-03-01,14,2006,2020,"TOR,STL"
Brian Sutherby,1982-03-01,9,2002,2011,"WSH,ANA,DAL"
Magnus Svensson,1963-03-01,1,1995,1996,FLA
Claude Vilgrain,1963-03-01,6,1988,1994,"VAN,NJD,PHI"
Anton Wedin,1993-03-01,0,2020,2020,CHI
Brad Winchester,1981-03-01,6,2006,2012,"EDM,DAL,STL,ANA,SJS"
Art Alexandre,1909-03-02,1,1932,1933,MTL
Peter Andersson,1962-03-02,2,1984,1986,"WSH,QUE"
Roman Cechmanek,1971-03-02,3,2001,2004,"PHI,LAK"
Charlie Coyle,1992-03-02,7,2013,2020,"MIN,BOS"
Max Domi,1995-03-02,4,2016,2020,"ARI,MTL"
Dan Dorion,1963-03-02,2,1986,1988,NJD
Clarence Drouillard,1914-03-02,0,1938,1938,DET
Herb Drury,1895-03-02,5,1926,1931,"PTP,PHQ"
Jonathan Ericsson,1984-03-02,12,2008,2020,DET
Brian Fahey,1981-03-02,0,2011,2011,WSH
Fern Headley,1901-03-02,0,1925,1925,"BOS,MTL"
Ville Heinola,2001-03-02,0,2020,2020,WPG
Michael Hutchinson,1990-03-02,6,2014,2020,"WPG,FLA,TOR,COL"
Eddie Johnstone,1954-03-02,11,1976,1987,"NYR,DET"
Jacob Josefson,1991-03-02,7,2011,2018,"NJD,BUF"
Tomas Kaberle,1978-03-02,14,1999,2013,"TOR,BOS,CAR,MTL"
Stan Kemp,1924-03-02,0,1949,1949,TOR
Morgan Klimchuk,1995-03-02,0,2018,2018,CGY
Claude Larose,1942-03-02,15,1963,1978,"MTL,MNS,STL"
Henrik Lundqvist,1982-03-02,14,2006,2020,NYR
Joel Lundqvist,1982-03-02,2,2007,2009,DAL
Jay McClement,1983-03-02,11,2006,2017,"STL,COL,TOR,CAR"
Joby Messier,1970-03-02,2,1993,1995,NYR
Alexander Nylander,1998-03-02,3,2017,2020,"BUF,CHI"
Bill Quackenbush*,1922-03-02,13,1943,1956,"DET,BOS"
Ryan Shannon,1983-03-02,5,2007,2012,"ANA,VAN,OTT,TBL"
Raimo Summanen,1962-03-02,4,1984,1988,"EDM,VAN"
Darren Turcotte,1968-03-02,11,1989,2000,"NYR,HAR,SJS,WIN,STL,NSH"
Ken Ellacott,1959-03-03,0,1983,1983,VAN
Brett Festerling,1986-03-03,3,2009,2012,"ANA,WPG"
Jean-Marc Gaulin,1962-03-03,3,1983,1986,QUE
Jack Gordon,1928-03-03,2,1949,1951,NYR
Steve Hrymnak,1926-03-03,0,1952,1952,CBH
Joey Johnston,1949-03-03,7,1969,1976,"MNS,CGS,CBH"
Stephen Kraftcheck,1929-03-03,8,1951,1959,"BOS,NYR,TOR"
Bob Kudelski,1964-03-03,8,1988,1996,"LAK,OTT,FLA"
Brian Leetch*,1968-03-03,18,1988,2006,"NYR,TOR,BOS"
Doug Lewis,1921-03-03,0,1947,1947,MTL
Norm Mann,1914-03-03,2,1939,1941,TOR
Ross McKay,1964-03-03,0,1991,1991,HAR
Kelly Miller,1963-03-03,14,1985,1999,"NYR,WSH"
Zdenek Nedved,1975-03-03,2,1995,1997,TOR
Wes O'Neill,1986-03-03,1,2009,2010,COL
Colton Orr,1982-03-03,11,2004,2015,"BOS,NYR,TOR"
Alexander Petrovic,1992-03-03,6,2013,2019,"FLA,EDM"
Martin Prochazka,1972-03-03,2,1998,2000,"TOR,ATL"
Stephane Robidas,1977-03-03,15,2000,2015,"MTL,DAL,CHI,ANA,TOR"
Al Secord,1958-03-03,11,1979,1990,"BOS,CBH,CHI,TOR,PHI"
Alexander Semin,1984-03-03,12,2004,2016,"WSH,CAR,MTL"
Joey Tetarenko,1978-03-03,3,2001,2004,"FLA,OTT,CAR"
Mickey Volcan,1962-03-03,3,1981,1984,"HAR,CGY"
Richard Zemlak,1963-03-03,5,1987,1992,"QUE,MNS,PIT,CGY"
Andrei Zubarev,1987-03-03,0,2011,2011,ATL
Antti Aalto,1975-03-04,3,1998,2001,MDA
Ray Allison,1959-03-04,7,1980,1987,"HAR,PHI"
Frank Bennett,1922-03-04,0,1944,1944,DET
Pierre Dagenais,1978-03-04,5,2001,2006,"NJD,FLA,MTL"
Jarrett Deuling,1974-03-04,1,1996,1997,NYI
Jake Dowell,1985-03-04,6,2008,2014,"CHI,DAL,MIN"
Derek Forbort,1992-03-04,4,2016,2020,"LAK,CGY"
Jocelyn Gauvreau,1964-03-04,0,1984,1984,MTL
Virgil Johnson,1912-03-04,7,1938,1945,CBH
Mikko Jokela,1980-03-04,0,2003,2003,VAN
Gord Kluzak,1964-03-04,8,1983,1991,BOS
Ladislav Kohn,1975-03-04,7,1996,2003,"CGY,TOR,MDA,ATL,DET"
Tord Lundstrom,1945-03-04,0,1974,1974,DET
John Morrison,1895-03-04,0,1926,1926,NYA
Valeri Nichushkin,1995-03-04,6,2014,2020,"DAL,COL"
Adam Payerl,1991-03-04,0,2014,2014,PIT
Jean-Marc Pelletier,1978-03-04,5,1999,2004,"PHI,PHX"
Joel Persson,1994-03-04,0,2020,2020,EDM
Tony Poeta,1933-03-04,0,1952,1952,CBH
Libor Sulak,1994-03-04,0,2019,2019,DET
Gilles Thibaudeau,1963-03-04,4,1987,1991,"MTL,NYI,TOR"
Sergei Zinovjev,1980-03-04,0,2004,2004,BOS
Dale Anderson,1932-03-05,0,1957,1957,DET
Bryan Berard,1977-03-05,11,1997,2008,"NYI,TOR,NYR,BOS,CHI,CBJ"
Logan Brown,1998-03-05,2,2018,2020,OTT
Matt DelGuidice,1967-03-05,1,1991,1992,BOS
Tim Friday,1961-03-05,0,1986,1986,DET
Paul Gardner,1956-03-05,9,1977,1986,"CLR,TOR,PIT,WSH,BUF"
Bob Halkidis,1966-03-05,10,1986,1996,"BUF,LAK,TOR,DET,TBL,NYI"
Pat Hannigan,1936-03-05,9,1960,1969,"TOR,NYR,PHI"
Barret Jackman,1981-03-05,14,2002,2016,"STL,NSH"
Paul Martin,1981-03-05,14,2004,2018,"NJD,PIT,SJS"
Michel Ouellet,1982-03-05,3,2006,2009,"PIT,TBL,VAN"
Harry Pidhirny,1928-03-05,0,1958,1958,BOS
Shjon Podein,1968-03-05,10,1993,2003,"EDM,PHI,COL,STL"
Bob Richer,1951-03-05,0,1973,1973,BUF
Milt Schmidt*,1918-03-05,18,1937,1955,BOS
Anatoli Semenov,1962-03-05,6,1991,1997,"EDM,TBL,VAN,MDA,PHI,BUF"
Bill Thoms,1910-03-05,12,1933,1945,"TOR,CBH,BOS"
Ken Yackel,1932-03-05,0,1959,1959,BOS
Andy Aitkenhead,1904-03-06,2,1933,1935,NYR
Peter Allen,1970-03-06,0,1996,1996,PIT
Anthony Angello,1996-03-06,0,2020,2020,PIT
Fred Arthur,1961-03-06,2,1981,1983,"HAR,PHI"
Pierre-Edouard Bellemare,1985-03-06,5,2015,2020,"PHI,VEG,COL"
Mario Bliznak,1987-03-06,1,2010,2011,VAN
Buzz Boll,1911-03-06,10,1934,1944,"TOR,NYA,BRO,BOS"
Dan Bourbonnais,1962-03-06,2,1982,1984,HAR
Louis Domingue,1992-03-06,5,2015,2020,"ARI,TBL,NJD,VAN"
Paul Gauthier,1915-03-06,0,1938,1938,MTL
Pete Goegan,1934-03-06,10,1958,1968,"DET,NYR,MNS"
Kevin Gravel,1992-03-06,4,2016,2020,"LAK,EDM,TOR"
Nicklas Jensen,1993-03-06,4,2013,2017,"VAN,NYR"
Patrick Labrecque,1971-03-06,0,1996,1996,MTL
Sam Lafferty,1995-03-06,0,2020,2020,PIT
Joe Matte,1893-03-06,6,1920,1926,"TRS,HAM,BOS,MTL"
Darrell May,1962-03-06,2,1986,1988,STL
Chris Mueller,1986-03-06,4,2011,2015,"NSH,DAL,NYR"
Rhett Rakhshani,1988-03-06,1,2011,2012,NYI
George Redding,1903-03-06,1,1925,1926,BOS
Allan Rourke,1980-03-06,4,2004,2008,"CAR,NYI,EDM"
Bill Shill,1923-03-06,4,1943,1947,BOS
Reg Sinclair,1925-03-06,2,1951,1953,"NYR,DET"
Chris Taylor,1972-03-06,9,1995,2004,"NYI,BOS,BUF"
Lubomir Vaic,1977-03-06,2,1998,2000,VAN
Vic Venasky,1951-03-06,6,1973,1979,LAK
Steve Wagner,1984-03-06,1,2008,2009,STL
Eric Wellwood,1990-03-06,2,2011,2013,PHI
Daniel Winnik,1985-03-06,10,2008,2018,"PHX,COL,SJS,ANA,PIT,TOR,WSH,MIN"
Gary Aldcorn,1935-03-07,4,1957,1961,"TOR,DET,BOS"
Jack Arbour,1899-03-07,2,1927,1929,"DTC,TOR"
Maxim Balmochnykh,1979-03-07,0,2000,2000,MDA
Niclas Bergfors,1987-03-07,4,2008,2012,"NJD,ATL,FLA,NSH"
Alex Broadhurst,1993-03-07,0,2018,2018,CBJ
Greg Brown,1968-03-07,4,1991,1995,"BUF,PIT,WIN"
Morley Bruce,1894-03-07,4,1918,1922,OTS
Terry Carkner,1966-03-07,12,1987,1999,"NYR,QUE,PHI,DET,FLA"
Danny DeKeyser,1990-03-07,7,2013,2020,DET
Mike Eagles,1963-03-07,17,1983,2000,"QUE,CHI,WIN,WSH"
Bryan Erickson,1960-03-07,10,1984,1994,"WSH,LAK,PIT,WIN"
Eric Godard,1980-03-07,8,2003,2011,"NYI,CGY,PIT"
Matt Hackett,1990-03-07,3,2012,2015,"MIN,BUF"
Greg Hotham,1956-03-07,5,1980,1985,"TOR,PIT"
Frank King,1929-03-07,0,1951,1951,MTL
Tomas Kloucek,1980-03-07,5,2001,2006,"NYR,NSH,ATL"
Mark Kumpel,1961-03-07,6,1985,1991,"QUE,DET,WIN"
Ron Loustel,1962-03-07,0,1981,1981,WIN
Aaron MacKenzie,1981-03-07,0,2009,2009,COL
Billy MacMillan,1943-03-07,6,1971,1977,"TOR,ATF,NYI"
Bernie MacNeil,1950-03-07,0,1974,1974,STL
Tom Manastersky,1929-03-07,0,1951,1951,MTL
Michael McCarron,1995-03-07,2,2016,2018,MTL
Jack McIlhargey,1952-03-07,7,1975,1982,"PHI,VAN,HAR"
Sean McKenna,1962-03-07,8,1982,1990,"BUF,LAK,TOR"
Alex Ritson,1922-03-07,0,1945,1945,NYR
Rasmus Sandin,2000-03-07,0,2020,2020,TOR
Steven Santini,1995-03-07,4,2016,2020,"NJD,NSH"
Geoff Smith,1969-03-07,9,1990,1999,"EDM,FLA,NYR"
Dylan Strome,1997-03-07,3,2017,2020,"ARI,CHI"
Don Ashby,1955-03-08,5,1976,1981,"TOR,CLR,EDM"
Bob Boughner,1971-03-08,10,1996,2006,"BUF,NSH,PIT,CGY,CAR,COL"
Drayson Bowman,1989-03-08,5,2010,2015,"CAR,MTL"
Jake Chelios,1991-03-08,0,2019,2019,DET
Chris Clark,1976-03-08,11,2000,2011,"CGY,WSH,CBJ"
Erik Ersberg,1982-03-08,2,2008,2010,LAK
Brent Fedyk,1967-03-08,11,1988,1999,"DET,PHI,DAL,NYR"
Steven Halko,1974-03-08,5,1998,2003,CAR
Greg Hickey,1955-03-08,0,1978,1978,NYR
Sergei Klimovich,1974-03-08,0,1997,1997,CHI
Brandon Kozun,1990-03-08,0,2015,2015,TOR
Mike Lalor,1963-03-08,11,1986,1997,"MTL,STL,WSH,WIN,DAL,SJS"
Greg Malone,1956-03-08,10,1977,1987,"PIT,HAR,QUE"
Larry Murphy*,1961-03-08,20,1981,2001,"LAK,WSH,MNS,PIT,TOR,DET"
Rob Pearson,1971-03-08,5,1992,1997,"TOR,WSH,STL"
Tracy Pratt,1943-03-08,9,1968,1977,"OAK,PIT,BUF,VAN,CLR,TOR"
Mike Rowe,1965-03-08,2,1985,1987,PIT
John Taft,1954-03-08,0,1979,1979,DET
Colten Teubert,1990-03-08,0,2012,2012,EDM
Ed Zeniuk,1933-03-08,0,1955,1955,DET
Rob Zettler,1968-03-08,13,1989,2002,"MNS,SJS,PHI,TOR,NSH,WSH"
Bryan Bickell,1986-03-09,10,2007,2017,"CHI,CAR"
Damien Brunner,1986-03-09,2,2013,2015,"DET,NJD"
Brent Burns,1985-03-09,16,2004,2020,"MIN,SJS"
Daniel Catenacci,1993-03-09,2,2016,2018,"BUF,NYR"
Radek Dvorak,1977-03-09,18,1996,2014,"FLA,NYR,EDM,STL,ATL,DAL,ANA,CAR"
Ryan Dzingel,1992-03-09,4,2016,2020,"OTT,CBJ,CAR"
Yan Golubovsky,1976-03-09,3,1998,2001,"DET,FLA"
Colin Greening,1986-03-09,5,2011,2016,"OTT,TOR"
Bill Holmes,1899-03-09,4,1926,1930,"MTL,NYA"
Phil Housley*,1964-03-09,20,1983,2003,"BUF,WIN,STL,CGY,NJD,WSH,CHI,TOR"
Paul Jacobs,1894-03-09,0,1919,1919,TRA
Jim Krulicki,1948-03-09,0,1971,1971,"DET,NYR"
Gary Kurt,1947-03-09,0,1972,1972,CGS
Mackenzie MacEachern,1994-03-09,1,2019,2020,STL
Paul MacLean,1958-03-09,10,1981,1991,"STL,WIN,DET"
Gary Marsh,1946-03-09,1,1968,1969,"DET,TOR"
Eddie Ouellette,1911-03-09,0,1936,1936,CBH
Chris Phillips,1978-03-09,17,1998,2015,OTT
Brandon Reid,1981-03-09,4,2003,2007,VAN
Morgan Rielly,1994-03-09,6,2014,2020,TOR
Miikka Salomaki,1993-03-09,5,2015,2020,NSH
Riley Stillman,1998-03-09,1,2019,2020,FLA
Dominic Toninato,1994-03-09,2,2018,2020,"COL,FLA"
Perry Turnbull,1959-03-09,8,1980,1988,"STL,MTL,WIN"
Stefan Bergkvist,1975-03-10,1,1996,1997,PIT
Cam Botting,1954-03-10,0,1976,1976,ATF
Tim Brent,1984-03-10,6,2007,2013,"ANA,PIT,CHI,TOR,CAR"
Martin Brochu,1973-03-10,5,1999,2004,"WSH,VAN,PIT"
Mike Bullard,1961-03-10,11,1981,1992,"PIT,CGY,PHI,STL,TOR"
Christian Hanson,1986-03-10,2,2009,2011,TOR
Scott Harrington,1993-03-10,5,2015,2020,"PIT,TOR,CBJ"
Stu Kulak,1963-03-10,6,1983,1989,"VAN,EDM,NYR,QUE,WIN"
Shawn Lalonde,1990-03-10,0,2013,2013,CHI
Doug Lecuyer,1958-03-10,4,1979,1983,"CBH,WIN,PIT"
John Markell,1956-03-10,5,1980,1985,"WIN,STL,MNS"
Kevin Marshall,1989-03-10,0,2012,2012,PHI
Simon Moser,1989-03-10,0,2014,2014,NSH
Tyler Motte,1995-03-10,3,2017,2020,"CHI,CBJ,VAN"
Stephen Peat,1980-03-10,4,2002,2006,WSH
Tuukka Rask,1987-03-10,12,2008,2020,BOS
Sergei Shirokov,1986-03-10,1,2010,2011,VAN
Andy Sutton,1975-03-10,13,1999,2012,"SJS,MIN,ATL,NYI,OTT,ANA,EDM"
Stephen Tepper,1969-03-10,0,1993,1993,CHI
Jesse Wallin,1978-03-10,3,2000,2003,DET
Ken Baumgartner,1966-03-11,11,1988,1999,"LAK,NYI,TOR,MDA,BOS"
Sergei Bautin,1967-03-11,3,1993,1996,"WIN,DET,SJS"
Paul Bissonnette,1985-03-11,5,2009,2014,"PIT,PHX"
Gord Byers,1930-03-11,0,1950,1950,BOS
Sprague Cleghorn*,1890-03-11,9,1919,1928,"OTS,TRS,MTL,BOS"
Dave Downie,1909-03-11,0,1933,1933,TOR
Nils Ekman,1976-03-11,7,2000,2007,"TBL,SJS,PIT"
Bill Ezinicki,1924-03-11,10,1945,1955,"TOR,BOS,NYR"
Ray Fortin,1941-03-11,2,1968,1970,STL
Conor Garland,1996-03-11,1,2019,2020,ARI
Tom Gorence,1957-03-11,5,1979,1984,"PHI,EDM"
Marc-Andre Gragnani,1987-03-11,8,2008,2016,"BUF,VAN,CAR,NJD"
Michal Handzus,1977-03-11,15,1999,2014,"STL,PHX,PHI,CHI,LAK,SJS"
Raimo Helminen,1964-03-11,3,1986,1989,"NYR,MNS,NYI"
Bill Houlder,1967-03-11,15,1988,2003,"WSH,BUF,MDA,STL,TBL,SJS,NSH"
Travis Konecny,1997-03-11,3,2017,2020,PHI
Lukas Krajicek,1983-03-11,8,2002,2010,"FLA,VAN,TBL,PHI"
Daniel Lacroix,1969-03-11,6,1994,2000,"NYR,BOS,PHI,EDM,NYI"
Kirby Law,1977-03-11,3,2001,2004,PHI
Bill Lecaine,1940-03-11,0,1969,1969,PIT
Larry Lozinski,1958-03-11,0,1981,1981,DET
Mark Morrison,1963-03-11,2,1982,1984,NYR
Tyson Nash,1975-03-11,7,1999,2006,"STL,PHX"
Jim Niekamp,1946-03-11,1,1971,1972,DET
Bob Plager,1943-03-11,13,1965,1978,"NYR,STL"
Earl Robinson,1907-03-11,11,1929,1940,"MTM,CBH,MTL"
Martin Rucinsky,1971-03-11,16,1992,2008,"EDM,QUE,COL,MTL,DAL,NYR,STL,VAN"
Christian Berglund,1980-03-12,2,2002,2004,"NJD,FLA"
Russ Blinco,1908-03-12,5,1934,1939,"MTM,CBH"
Evgenii Dadonov,1989-03-12,10,2010,2020,FLA
Jonathan Davidsson,1997-03-12,0,2020,2020,OTT
Roy Edwards,1937-03-12,6,1968,1974,"DET,PIT"
Byron Froese,1991-03-12,2,2016,2018,"TOR,TBL,MTL"
Mark Fusco,1961-03-12,1,1984,1985,HAR
Ed Gilbert,1952-03-12,2,1975,1977,"KCS,PIT"
Rich Healey,1938-03-12,0,1961,1961,DET
Bronco Horvath,1930-03-12,12,1956,1968,"NYR,MTL,BOS,CBH,TOR,MNS"
Brent Johnson,1977-03-12,13,1999,2012,"STL,PHX,WSH,PIT"
Bingo Kampman,1914-03-12,4,1938,1942,TOR
Mikko Koivu,1983-03-12,14,2006,2020,MIN
Dmitry Korobov,1989-03-12,0,2014,2014,TBL
Tyler Larter,1968-03-12,0,1990,1990,WSH
Danny Lewicki,1931-03-12,8,1951,1959,"TOR,NYR,CBH"
Bill McKenzie,1949-03-12,6,1974,1980,"DET,KCS,CLR"
Douglas Murray,1980-03-12,8,2006,2014,"SJS,PIT,MTL"
Cam Plante,1964-03-12,0,1985,1985,TOR
Kevin Porter,1986-03-12,8,2009,2017,"PHX,COL,BUF,PIT"
Deron Quint,1976-03-12,11,1996,2007,"WIN,PHX,NJD,CBJ,CHI,NYI"
Vadim Shipachyov,1987-03-12,0,2018,2018,VEG
Tyler Wotherspoon,1993-03-12,3,2014,2017,CGY
Gordie Bell,1925-03-13,0,1946,1946,TOR
Tom Bissett,1966-03-13,0,1991,1991,DET
Michel Bolduc,1961-03-13,1,1982,1983,QUE
Bill Burega,1932-03-13,0,1956,1956,TOR
Kris Chucko,1986-03-13,0,2009,2009,CGY
Jim Culhane,1965-03-13,0,1990,1990,HAR
Eddie Dorohoy,1929-03-13,0,1949,1949,MTL
Maxim Galanov,1974-03-13,3,1998,2001,"NYR,PIT,ATL,TBL"
Ernie Godden,1961-03-13,0,1982,1982,TOR
Ivan Irwin,1927-03-13,5,1953,1958,"MTL,NYR"
Kevin Kaminski,1969-03-13,8,1989,1997,"MNS,QUE,WSH"
Petteri Lehto,1961-03-13,0,1985,1985,PIT
Olli Malmivaara,1982-03-13,0,2008,2008,NJD
Grant Martin,1962-03-13,3,1984,1987,"VAN,WSH"
Paul McIntosh,1954-03-13,1,1975,1976,BUF
Barry Pederson,1961-03-13,11,1981,1992,"BOS,VAN,PIT,HAR"
Brayden Point,1996-03-13,3,2017,2020,TBL
Dalton Prout,1990-03-13,8,2012,2020,"CBJ,NJD,CGY,SJS"
Gaetan Royer,1976-03-13,0,2002,2002,TBL
Petri Skriko,1962-03-13,8,1985,1993,"VAN,BOS,WIN,SJS"
Brad Smyth,1973-03-13,7,1996,2003,"FLA,LAK,NYR,NSH,OTT"
Blaine Stoughton,1953-03-13,10,1974,1984,"PIT,TOR,HAR,NYR"
Landon Wilson,1975-03-13,13,1996,2009,"COL,BOS,PHX,PIT,DAL"
Anton Blidh,1995-03-14,3,2017,2020,BOS
Aris Brimanis,1972-03-14,10,1994,2004,"PHI,NYI,MDA,STL"
Ron Carter,1958-03-14,0,1980,1980,EDM
Tommy Filmore,1906-03-14,3,1931,1934,"DTF,NYA,BOS"
Erik Gustafsson,1992-03-14,4,2016,2020,"CHI,CGY"
Tyson Jost,1998-03-14,3,2017,2020,COL
Pat Kavanagh,1979-03-14,3,2003,2006,"VAN,PHI"
J.T. Miller,1993-03-14,7,2013,2020,"NYR,TBL,VAN"
Roy Mitchell,1969-03-14,0,1993,1993,MNS
Joe Motzko,1980-03-14,5,2004,2009,"CBJ,WSH,ATL"
Vaclav Nedomansky*,1944-03-14,5,1978,1983,"DET,NYR,STL"
Derek Peltier,1985-03-14,1,2009,2010,COL
Mattias Ritola,1987-03-14,4,2008,2012,"DET,TBL"
Jeff Shevalier,1974-03-14,5,1995,2000,"LAK,TBL"
Patrick Traverse,1974-03-14,10,1996,2006,"OTT,BOS,MDA,MTL,DAL"
Frank Vatrano,1994-03-14,4,2016,2020,"BOS,FLA"
Darcy Wakaluk,1966-03-14,8,1989,1997,"BUF,MNS,DAL,PHX"
Jared Aulin,1982-03-15,0,2003,2003,LAK
Tyler Benson,1998-03-15,0,2020,2020,EDM
Hy Buller,1926-03-15,10,1944,1954,"DET,NYR"
Tom Cassidy,1952-03-15,0,1978,1978,PIT
Rob Collins,1978-03-15,0,2006,2006,NYI
Dan Currie,1968-03-15,3,1991,1994,"EDM,LAK"
Jean-Francois Fortin,1979-03-15,2,2002,2004,WSH
Stew Gavin,1960-03-15,12,1981,1993,"TOR,HAR,MNS"
Steve Guolla,1973-03-15,6,1997,2003,"SJS,ATL,TBL,NJD"
Jannik Hansen,1986-03-15,10,2008,2018,"VAN,SJS"
Phil Hoene,1949-03-15,2,1973,1975,LAK
Ryan Jardine,1980-03-15,0,2002,2002,FLA
Frank Jerwa,1909-03-15,3,1932,1935,"BOS,STE"
Paul Kruse,1970-03-15,10,1991,2001,"CGY,NYI,BUF,SJS"
Brendan Lemieux,1996-03-15,2,2018,2020,"WPG,NYR"
Craig Ludwig,1961-03-15,16,1983,1999,"MTL,NYI,MNS,DAL"
Joe Matte,1909-03-15,13,1930,1943,"DTC,CBH"
Philip McRae,1990-03-15,0,2011,2011,STL
James Reimer,1988-03-15,9,2011,2020,"TOR,SJS,FLA,CAR"
Stacy Roest,1974-03-15,4,1999,2003,"DET,MIN"
Mark Scheifele,1993-03-15,8,2012,2020,WPG
Tyler Sloan,1981-03-15,2,2009,2011,WSH
David Steckel,1982-03-15,8,2006,2014,"WSH,NJD,TOR,ANA"
Blair Stewart,1953-03-15,6,1974,1980,"DET,WSH,QUE"
Darcy Tucker,1975-03-15,14,1996,2010,"MTL,TBL,TOR,COL"
Chris VandeVelde,1987-03-15,6,2011,2017,"EDM,PHI"
Peter White,1969-03-15,10,1994,2004,"EDM,TOR,PHI,CHI"
Tyler Arnason,1979-03-16,7,2002,2009,"CHI,OTT,COL"
Dick Behling,1916-03-16,2,1941,1943,DET
Arto Blomsten,1965-03-16,2,1994,1996,"WIN,LAK"
Riley Cote,1982-03-16,3,2007,2010,PHI
Roger Crozier,1942-03-16,13,1964,1977,"DET,BUF,WSH"
David Harlock,1971-03-16,8,1994,2002,"TOR,WSH,NYI,ATL"
Greg Johnson,1971-03-16,12,1994,2006,"DET,PIT,CHI,NSH"
Kim Johnsson,1976-03-16,10,2000,2010,"NYR,PHI,MIN,CHI"
Alexander Kerch,1967-03-16,0,1994,1994,EDM
Jaroslav Kristek,1980-03-16,0,2003,2003,BUF
Gord Laxton,1955-03-16,3,1976,1979,PIT
Al MacAdam,1952-03-16,11,1974,1985,"PHI,CGS,CLE,MNS,VAN"
Jeff McDill,1956-03-16,0,1977,1977,CBH
Brian McKenzie,1951-03-16,0,1972,1972,PIT
Fred McLean,1893-03-16,1,1920,1921,"QBC,HAM"
Brian Mullen,1962-03-16,10,1983,1993,"WIN,NYR,SJS,NYI"
Vaclav Nedorost,1982-03-16,2,2002,2004,"COL,FLA"
Brandon Prust,1984-03-16,9,2007,2016,"CGY,PHX,NYR,MTL,VAN"
Jamie Rivers,1975-03-16,11,1996,2007,"STL,NYI,OTT,BOS,FLA,DET,PHX"
Louis Robitaille,1982-03-16,0,2006,2006,WSH
Marc Rodgers,1972-03-16,0,2000,2000,DET
Church Russell,1923-03-16,2,1946,1948,NYR
Duane Sutter,1960-03-16,10,1980,1990,"NYI,CHI"
Jiri Tlusty,1988-03-16,8,2008,2016,"TOR,CAR,WPG,NJD"
Brian Willsie,1978-03-16,11,2000,2011,"COL,WSH,LAK"
Garrett Wilson,1991-03-16,5,2014,2019,"FLA,PIT"
Mikael Backlund,1989-03-17,11,2009,2020,CGY
Gord Buttrey,1926-03-17,0,1944,1944,CBH
Matthew Corrente,1988-03-17,1,2010,2011,NJD
Craig Duncanson,1967-03-17,7,1986,1993,"LAK,WIN,NYR"
Andrew Ference,1979-03-17,16,2000,2016,"PIT,CGY,BOS,EDM"
Larry Hopkins,1954-03-17,5,1978,1983,"TOR,WIN"
Derek Joslin,1987-03-17,4,2009,2013,"SJS,CAR,VAN"
Sergey Kalinin,1991-03-17,1,2016,2017,NJD
David Laliberte,1986-03-17,0,2010,2010,PHI
Patrick Lebeau,1970-03-17,8,1991,1999,"MTL,CGY,FLA,PIT"
Tony Leswick,1923-03-17,12,1946,1958,"NYR,DET,CBH"
Joe Levandoski,1921-03-17,0,1947,1947,NYR
Chris Luongo,1967-03-17,5,1991,1996,"DET,OTT,NYI"
Bruce McIntosh,1949-03-17,0,1973,1973,MNS
Ryan Parent,1987-03-17,4,2007,2011,"PHI,VAN"
Andrew Peeke,1998-03-17,0,2020,2020,CBJ
Craig Ramsay,1951-03-17,13,1972,1985,BUF
Bobby Ryan,1987-03-17,12,2008,2020,"ANA,OTT"
Bob Sabourin,1933-03-17,0,1952,1952,TOR
Cliff Schmautz,1939-03-17,0,1971,1971,"BUF,PHI"
Stu Smith,1960-03-17,3,1980,1983,HAR
Daniel Sprong,1997-03-17,4,2016,2020,"PIT,ANA"
C.J. Suess,1994-03-17,0,2020,2020,WPG
Antti Suomela,1994-03-17,1,2019,2020,SJS
John Tanner,1971-03-17,2,1990,1992,QUE
Tom Thornbury,1963-03-17,0,1984,1984,PIT
Stan Weir,1952-03-17,10,1973,1983,"CGS,TOR,EDM,CLR,DET"
Ryan White,1988-03-17,7,2010,2017,"MTL,PHI,ARI,MIN"
Christian Wolanin,1995-03-17,2,2018,2020,OTT
Darren Banks,1966-03-18,1,1993,1994,BOS
Ken Block,1944-03-18,0,1971,1971,VAN
Robert Bortuzzo,1989-03-18,8,2012,2020,"PIT,STL"
Jan Bulis,1978-03-18,9,1998,2007,"WSH,MTL,VAN"
Guy Carbonneau*,1960-03-18,19,1981,2000,"MTL,STL,DAL"
Zdeno Chara,1977-03-18,22,1998,2020,"NYI,OTT,BOS"
Bill Gardner,1960-03-18,8,1981,1989,"CBH,HAR,CHI"
Gilles Hamel,1960-03-18,8,1981,1989,"BUF,WIN,LAK"
John Hughes,1954-03-18,1,1980,1981,"VAN,EDM"
Jonas Johansson,1984-03-18,0,2006,2006,WSH
Craig Johnson,1972-03-18,9,1995,2004,"STL,LAK,MDA,TOR,WSH"
Guy Lapointe*,1948-03-18,15,1969,1984,"MTL,STL,BOS"
Matthew Lombardi,1982-03-18,9,2004,2013,"CGY,PHX,NSH,TOR,ANA"
Bernie Lukowich,1952-03-18,1,1974,1975,"PIT,STL"
Gerry McDonald,1958-03-18,2,1982,1984,HAR
Brantt Myhres,1974-03-18,8,1995,2003,"TBL,PHI,SJS,NSH,WSH,BOS"
Bob Nevin,1938-03-18,18,1958,1976,"TOR,NYR,MNS,LAK"
Cory Schneider,1986-03-18,11,2009,2020,"VAN,NJD"
Brad Selwood,1948-03-18,9,1971,1980,"TOR,LAK"
Normie Smith,1908-03-18,13,1932,1945,"MTM,DET"
Phil Sykes,1959-03-18,9,1983,1992,"LAK,WIN"
Kimmo Timonen,1975-03-18,16,1999,2015,"NSH,PHI,CHI"
Jack Valiquette,1954-03-18,6,1975,1981,"TOR,CLR"
Vitaly Vishnevski,1980-03-18,8,2000,2008,"MDA,ATL,NSH,NJD"
Dody Wood,1972-03-18,5,1993,1998,SJS
Gregg Boddy,1949-03-19,4,1972,1976,VAN
Tyler Bozak,1986-03-19,10,2010,2020,"TOR,STL"
Gord Buynak,1954-03-19,0,1975,1975,STL
Louie DeBrusk,1971-03-19,11,1992,2003,"EDM,TBL,PHX,CHI"
Cameron Gaunce,1990-03-19,9,2011,2020,"COL,DAL,PIT,TBL"
Mats Hallin,1958-03-19,4,1983,1987,"NYI,MNS"
Barrett Heisten,1980-03-19,0,2002,2002,NYR
Ulf Isaksson,1954-03-19,0,1983,1983,LAK
Vladimir Konstantinov,1967-03-19,5,1992,1997,DET
Janne Laukkanen,1970-03-19,8,1995,2003,"QUE,COL,OTT,PIT,TBL"
Lyle Moffat,1948-03-19,7,1973,1980,"TOR,WIN"
Mike Mottau,1978-03-19,13,2001,2014,"NYR,CGY,NJD,NYI,BOS,FLA"
Anders Nilsson,1990-03-19,8,2012,2020,"NYI,EDM,STL,BUF,VAN,OTT"
Larry Patey,1953-03-19,11,1974,1985,"CGS,STL,NYR"
Glen Smith,1931-03-19,0,1951,1951,CBH
Frank Steele,1905-03-19,0,1931,1931,DTF
Brad Thiessen,1986-03-19,0,2012,2012,PIT
Joe Thorsteinson,1905-03-19,0,1933,1933,NYA
Eddie Wares,1915-03-19,10,1937,1947,"NYR,DET,CBH"
Bryan Adams,1977-03-20,1,2000,2001,ATL
Justin Faulk,1992-03-20,8,2012,2020,"CAR,STL"
Valtteri Filppula,1984-03-20,14,2006,2020,"DET,TBL,PHI,NYI"
Paul Healey,1975-03-20,9,1997,2006,"PHI,TOR,NYR,COL"
Nikolai Knyzhov,1998-03-20,0,2020,2020,SJS
Sergei Kostitsyn,1987-03-20,5,2008,2013,"MTL,NSH"
Nick Leddy,1991-03-20,9,2011,2020,"CHI,NYI"
Mark Major,1970-03-20,0,1997,1997,DET
Brad Moran,1979-03-20,5,2002,2007,"CBJ,VAN"
Bobby Orr*,1948-03-20,12,1967,1979,"BOS,CBH"
Nick Paul,1995-03-20,4,2016,2020,OTT
Charlie Simmer,1954-03-20,13,1975,1988,"CGS,CLE,LAK,BOS,PIT"
Bill Speer,1942-03-20,3,1968,1971,"PIT,BOS"
Ryan Stone,1985-03-20,2,2008,2010,"PIT,EDM"
Robbie Tallas,1973-03-20,5,1996,2001,"BOS,CHI"
Dennis Wideman,1983-03-20,11,2006,2017,"STL,BOS,FLA,WSH,CGY"
Hal Winkler,1892-03-20,1,1927,1928,"BOS,NYR"
Jim Agnew,1966-03-21,6,1987,1993,"VAN,HAR"
Sven Andrighetto,1993-03-21,4,2015,2019,"MTL,COL"
Goran Bezina,1980-03-21,0,2004,2004,PHX
Ryan Callahan,1985-03-21,12,2007,2019,"NYR,TBL"
Joe Carveth,1918-03-21,10,1941,1951,"DET,BOS,MTL"
Lloyd Cook,1890-03-21,0,1925,1925,BOS
Johan Garpenlov,1968-03-21,9,1991,2000,"DET,SJS,FLA,ATL"
Terry Gray,1938-03-21,8,1962,1970,"BOS,MTL,LAK,STL"
Al Iafrate,1966-03-21,13,1985,1998,"TOR,WSH,BOS,SJS"
Jim Jamieson,1922-03-21,0,1944,1944,NYR
Erik Johnson,1988-03-21,12,2008,2020,"STL,COL"
Duke Keats*,1895-03-21,2,1927,1929,"BOS,DTC,CBH"
Rostislav Klesla,1982-03-21,13,2001,2014,"CBJ,PHX"
Jim Kyte,1964-03-21,13,1983,1996,"WIN,PIT,CGY,OTT,SJS"
Roland Lafleur,1899-03-21,0,1925,1925,MTL
Jeff Lazaro,1968-03-21,2,1991,1993,"BOS,OTT"
Howard Lockhart,1895-03-21,5,1920,1925,"QBC,TRS,HAM,BOS"
Boris Mironov,1972-03-21,10,1994,2004,"EDM,WIN,CHI,NYR"
Sandy Moger,1969-03-21,4,1995,1999,"BOS,LAK"
Mirco Mueller,1995-03-21,5,2015,2020,"SJS,NJD"
Ed Ronan,1968-03-21,5,1992,1997,"MTL,WIN,BUF"
Jason Simon,1969-03-21,3,1994,1997,"NYI,PHX"
Paul Stewart,1954-03-21,0,1980,1980,QUE
Jeremy Yablonski,1980-03-21,0,2004,2004,STL
Sven Butensch√∂n,1976-03-22,8,1998,2006,"PIT,EDM,NYI,VAN"
Francis Cain,1899-03-22,1,1925,1926,"MTM,TRS"
Todd Charlesworth,1965-03-22,6,1984,1990,"PIT,NYR"
Tim Conboy,1982-03-22,2,2008,2010,CAR
Pelle Eklund,1963-03-22,8,1986,1994,"PHI,DAL"
Todd Ewen,1966-03-22,10,1987,1997,"STL,MTL,MDA,SJS"
Tuomas Gronman,1974-03-22,1,1997,1998,"CHI,PIT"
Dave Keon*,1940-03-22,21,1961,1982,"TOR,HAR"
John Kordic,1965-03-22,6,1986,1992,"MTL,TOR,WSH,QUE"
Joel Kwiatkowski,1977-03-22,7,2001,2008,"OTT,WSH,FLA,PIT,ATL"
Bobby Leiter,1941-03-22,13,1963,1976,"BOS,PIT,ATF"
Dave Lucas,1932-03-22,0,1963,1963,DET
John Marks,1948-03-22,9,1973,1982,CBH
Brandon McMillan,1990-03-22,4,2011,2015,"ANA,PHX,ARI,VAN"
Cam Paddock,1983-03-22,0,2009,2009,STL
Nic Petan,1995-03-22,4,2016,2020,"WPG,TOR"
Tom Poti,1977-03-22,14,1999,2013,"EDM,NYR,NYI,WSH"
Travis Richards,1970-03-22,1,1995,1996,DAL
Eddie Rodden,1901-03-22,4,1927,1931,"CBH,TOR,BOS,NYR"
Chuck Shannon,1916-03-22,0,1940,1940,NYA
Warren Skorodenski,1960-03-22,6,1982,1988,"CBH,CHI,EDM"
Mike Smith,1982-03-22,13,2007,2020,"DAL,TBL,PHX,ARI,CGY,EDM"
Hannu Virta,1963-03-22,4,1982,1986,BUF
Jan Vopat,1973-03-22,4,1996,2000,"LAK,NSH"
Michael Ware,1967-03-22,1,1989,1990,EDM
Dunc Wilson,1948-03-22,9,1970,1979,"PHI,VAN,TOR,NYR,PIT"
Hub Anslow,1926-03-23,0,1948,1948,NYR
Mark Barberio,1990-03-23,7,2013,2020,"TBL,MTL,COL"
Nolan Baumgartner,1976-03-23,14,1996,2010,"WSH,CHI,VAN,PIT,DAL,PHI"
Patrick Bordeleau,1986-03-23,2,2013,2015,COL
Pavel Brendl,1981-03-23,4,2002,2006,"PHI,CAR,PHX"
Laurent Brossoit,1993-03-23,5,2015,2020,"EDM,WPG"
Dale Clarke,1978-03-23,0,2001,2001,STL
Marc-Andre Cliche,1987-03-23,5,2010,2015,"LAK,COL"
Roger Cormier,1905-03-23,0,1926,1926,MTL
Justin Duberman,1970-03-23,0,1994,1994,PIT
Warren Godfrey,1931-03-23,15,1953,1968,"BOS,DET"
Ted Green,1940-03-23,11,1961,1972,BOS
Bengt-Ake Gustafsson,1958-03-23,9,1980,1989,WSH
Erik Haula,1991-03-23,6,2014,2020,"MIN,VEG,CAR,FLA"
Tomas Hyka,1993-03-23,1,2018,2019,VEG
Iiro Jarvi,1965-03-23,1,1989,1990,QUE
Dmitrij Jaskin,1993-03-23,6,2013,2019,"STL,WSH"
Chris Kelleher,1975-03-23,0,2002,2002,BOS
Joel Kiviranta,1996-03-23,0,2020,2020,DAL
Matt Lindblad,1990-03-23,1,2014,2015,BOS
Chris Lipuma,1971-03-23,4,1993,1997,"TBL,SJS"
Don Marshall,1932-03-23,20,1952,1972,"MTL,NYR,BUF,TOR"
John McCreedy,1911-03-23,3,1942,1945,TOR
Brian McDonald,1945-03-23,0,1971,1971,BUF
Gord Murphy,1967-03-23,13,1989,2002,"PHI,BOS,FLA,ATL"
Michal Neuvirth,1988-03-23,10,2009,2019,"WSH,BUF,NYI,PHI"
Wayne Presley,1965-03-23,11,1985,1996,"CBH,CHI,BUF,SJS,NYR,TOR"
Daren Puppa,1965-03-23,14,1986,2000,"BUF,TOR,TBL"
Magnus Roupe,1963-03-23,1,1988,1989,PHI
Charlie Sands,1911-03-23,11,1933,1944,"TOR,BOS,MTL,NYR"
Werner Schnarr,1903-03-23,1,1925,1926,BOS
Ganton Scott,1903-03-23,2,1923,1925,"TRS,HAM,MTM"
Alex Selivanov,1971-03-23,6,1995,2001,"TBL,EDM,CBJ"
Nick Smith,1979-03-23,0,2002,2002,FLA
Oskar Sundqvist,1994-03-23,4,2016,2020,"PIT,STL"
Bill Thomson,1914-03-23,5,1939,1944,DET
Mike Toal,1959-03-23,0,1980,1980,EDM
John Tonelli,1957-03-23,13,1979,1992,"NYI,CGY,LAK,CHI,QUE"
Bill Touhey,1906-03-23,6,1928,1934,"MTM,OTS,BOS"
Flat Walsh,1897-03-23,6,1927,1933,"MTM,NYA"
Ramzi Abid,1980-03-24,4,2003,2007,"PHX,PIT,ATL,NSH"
Ladislav Benysek,1975-03-24,5,1998,2003,"EDM,MIN"
Philippe Boucher,1973-03-24,16,1993,2009,"BUF,LAK,DAL,PIT"
Tom Cavanagh,1982-03-24,1,2008,2009,SJS
Jake Dotchin,1994-03-24,2,2017,2019,"TBL,ANA"
Ron Hainsey,1981-03-24,17,2003,2020,"MTL,CBJ,ATL,WPG,CAR,PIT,TOR,OTT"
Andrew Hutchinson,1980-03-24,7,2004,2011,"NSH,CAR,DAL,TBL,PIT"
Brayden Irwin,1987-03-24,0,2010,2010,TOR
Doug Jarvis,1955-03-24,12,1976,1988,"MTL,WSH,HAR"
Maxim Kuznetsov,1977-03-24,3,2001,2004,"DET,LAK"
Oliver Lauridsen,1989-03-24,2,2013,2015,PHI
Don McFadyen,1907-03-24,3,1933,1936,CBH
David Moravec,1973-03-24,0,2000,2000,BUF
P.A. Parenteau,1983-03-24,10,2007,2017,"CHI,NYR,NYI,COL,MTL,TOR,NJD,NSH"
Pat Price,1955-03-24,12,1976,1988,"NYI,EDM,PIT,QUE,NYR,MNS"
Joonas Rask,1990-03-24,0,2013,2013,NSH
Jeff Reese,1966-03-24,11,1988,1999,"TOR,CGY,HAR,TBL,NJD"
Brian Swanson,1976-03-24,3,2001,2004,"EDM,ATL"
James Wright,1990-03-24,4,2010,2014,"TBL,WPG"
Shawn Antoski,1970-03-25,7,1991,1998,"VAN,PHI,MDA,PIT"
Bill Barilko,1927-03-25,4,1947,1951,TOR
J.C. Beaudin,1997-03-25,0,2020,2020,OTT
Lance Bouma,1990-03-25,7,2011,2018,"CGY,CHI"
Ted Bulley,1955-03-25,7,1977,1984,"CBH,WSH,PIT"
Bruce Crowder,1957-03-25,3,1982,1985,"BOS,PIT"
Bert Gardiner,1913-03-25,8,1936,1944,"NYR,MTL,CBH,BOS"
Brendan Gaunce,1994-03-25,4,2016,2020,"VAN,BOS"
Ben Gleason,1998-03-25,0,2019,2019,DAL
John Henderson,1933-03-25,1,1955,1956,BOS
Pat Hughes,1955-03-25,9,1978,1987,"MTL,PIT,EDM,BUF,HAR,STL"
Jere Karalahti,1975-03-25,2,2000,2002,"LAK,NSH"
Anton Klementyev,1990-03-25,0,2010,2010,NYI
Dmitri Kvartalnov,1966-03-25,1,1993,1994,BOS
Kurtis MacDermid,1994-03-25,2,2018,2020,LAK
Andrew MacWilliam,1990-03-25,0,2015,2015,TOR
John Negrin,1989-03-25,0,2009,2009,CGY
Eric Nickulas,1975-03-25,7,1999,2006,"BOS,STL,CHI"
Andrei Nikolishin,1973-03-25,9,1995,2004,"HAR,WSH,CHI,COL"
Greg Parks,1967-03-25,2,1991,1993,NYI
Jean Potvin,1949-03-25,10,1971,1981,"LAK,PHI,NYI,CLE,MNS"
Borna Rendulic,1992-03-25,2,2015,2017,"COL,VAN"
Dwight Schofield,1956-03-25,11,1977,1988,"DET,MTL,STL,WSH,PIT,WIN"
Chad Wiseman,1981-03-25,3,2003,2006,"SJS,NYR"
Ken Wregget,1964-03-25,16,1984,2000,"TOR,PHI,PIT,CGY,DET"
Krys Barch,1980-03-26,7,2007,2014,"DAL,FLA,NJD"
Robin Bawa,1966-03-26,4,1990,1994,"WSH,VAN,SJS,MDA"
Fred Berry,1956-03-26,0,1977,1977,DET
Allan Bester,1964-03-26,12,1984,1996,"TOR,DET,DAL"
Sebastien Centomo,1981-03-26,0,2002,2002,TOR
Frank Corrado,1993-03-26,5,2013,2018,"VAN,TOR,PIT"
Laurent Dauphin,1995-03-26,3,2016,2019,ARI
Markus Hannikainen,1993-03-26,3,2016,2019,CBJ
Bob Hassard,1929-03-26,5,1950,1955,"TOR,CBH"
Jimmy Howard,1984-03-26,14,2006,2020,DET
Doug Janik,1980-03-26,9,2003,2012,"BUF,TBL,DAL,MTL,DET"
Trevor Kidd,1972-03-26,12,1992,2004,"CGY,CAR,FLA,TOR"
Brian Lee,1987-03-26,5,2008,2013,"OTT,TBL"
Roger Leger,1919-03-26,6,1944,1950,"NYR,MTL"
Mark Marquess,1925-03-26,0,1947,1947,BOS
Maksim Mayorov,1989-03-26,3,2009,2012,CBJ
Mike Moher,1962-03-26,0,1983,1983,NJD
Greg Moore,1984-03-26,2,2008,2010,"NYR,CBJ"
Connor Murphy,1993-03-26,6,2014,2020,"PHX,ARI,CHI"
Michael Peca,1974-03-26,15,1994,2009,"VAN,BUF,NYI,EDM,TOR,CBJ"
Barclay Plager,1941-03-26,9,1968,1977,STL
Luke Richardson,1969-03-26,21,1988,2009,"TOR,EDM,PHI,CBJ,TBL,OTT"
Ulf Samuelsson,1964-03-26,15,1985,2000,"HAR,PIT,NYR,DET,PHI"
Kent Simpson,1992-03-26,0,2014,2014,CHI
Brady Skjei,1994-03-26,4,2016,2020,"NYR,CAR"
Andrei Svechnikov,2000-03-26,1,2019,2020,CAR
Jim Warner,1954-03-26,0,1980,1980,HAR
Scott Barney,1979-03-27,3,2003,2006,"LAK,ATL"
Curt Bennett,1948-03-27,9,1971,1980,"STL,ATF,NYR"
Dustin Byfuglien,1985-03-27,13,2006,2019,"CHI,ATL,WPG"
Bryan Campbell,1944-03-27,4,1968,1972,"LAK,CBH"
Claude Cyr,1939-03-27,0,1959,1959,MTL
Pat Daley,1959-03-27,1,1980,1981,WIN
Dave Debol,1956-03-27,1,1980,1981,HAR
Kevin Hodson,1972-03-27,7,1996,2003,"DET,TBL"
Bobby Lalonde,1951-03-27,10,1972,1982,"VAN,ATF,BOS,CGY"
Jean-Marc Lanthier,1963-03-27,4,1984,1988,VAN
Chad Larose,1982-03-27,7,2006,2013,CAR
Stephane Morin,1969-03-27,4,1990,1994,"QUE,VAN"
Brit Selby,1945-03-27,7,1965,1972,"TOR,PHI,STL"
Ken Solheim,1961-03-27,5,1981,1986,"CBH,MNS,DET,EDM"
Mike Allison,1961-03-28,9,1981,1990,"NYR,TOR,LAK"
John Anderson,1957-03-28,11,1978,1989,"TOR,HAR,QUE"
Jan Benda,1972-03-28,0,1998,1998,WSH
Jeff Beukeboom,1965-03-28,12,1987,1999,"EDM,NYR"
Colin Blackwell,1993-03-28,1,2019,2020,NSH
Dick Cherry,1937-03-28,13,1957,1970,"BOS,PHI"
Ron Chipperfield,1954-03-28,1,1980,1981,"EDM,QUE"
Philippe Cornet,1990-03-28,0,2012,2012,EDM
Logan Couture,1989-03-28,10,2010,2020,SJS
Jonathan Drouin,1995-03-28,5,2015,2020,"TBL,MTL"
Lou Franceschetti,1958-03-28,10,1982,1992,"WSH,TOR,BUF"
Dave Gatherum,1932-03-28,0,1954,1954,DET
Sean Gauthier,1971-03-28,0,1999,1999,SJS
Dave Goertz,1965-03-28,0,1988,1988,PIT
Tim Jacobs,1952-03-28,0,1976,1976,CGS
Hugh Jessiman,1984-03-28,0,2011,2011,FLA
Alan Kerr,1964-03-28,8,1985,1993,"NYI,DET,WIN"
Veli-Pekka Ketola,1948-03-28,0,1982,1982,CLR
Dan LaCosta,1986-03-28,1,2008,2009,CBJ
Daniel Laperriere,1969-03-28,3,1993,1996,"STL,OTT"
Darryl Laplante,1977-03-28,2,1998,2000,DET
Josh Morrissey,1995-03-28,4,2016,2020,WPG
Nikita Nesterov,1993-03-28,2,2015,2017,"TBL,MTL"
Dennis Owchar,1953-03-28,5,1975,1980,"PIT,CLR"
Ondrej Palat,1991-03-28,7,2013,2020,TBL
Joe Papike,1915-03-28,4,1941,1945,CBH
Tomas Plihal,1983-03-28,2,2007,2009,SJS
Erik Rasmussen,1977-03-28,9,1998,2007,"BUF,LAK,NJD"
Bobby Schmautz,1945-03-28,13,1968,1981,"CBH,VAN,BOS,CLR,EDM"
Harry Taylor,1926-03-28,5,1947,1952,"TOR,CBH"
Tom Tilley,1965-03-28,5,1989,1994,STL
Keith Tkachuk,1972-03-28,18,1992,2010,"WIN,PHX,STL,ATL"
Joe Turner,1919-03-28,0,1942,1942,DET
Hardy Astrom,1951-03-29,3,1978,1981,"NYR,CLR"
Clark Bishop,1996-03-29,1,2019,2020,CAR
Jerry Byers,1952-03-29,5,1973,1978,"MNS,ATF,NYR"
Jon Casey,1962-03-29,13,1984,1997,"MNS,BOS,STL"
Eddy Godin,1957-03-29,1,1978,1979,WSH
Brandon Halverson,1996-03-29,0,2018,2018,NYR
Brett Howden,1998-03-29,1,2019,2020,NYR
Evgeny Konstantinov,1981-03-29,2,2001,2003,TBL
Richard Kromm,1964-03-29,9,1984,1993,"CGY,NYI"
Maxim Lapierre,1985-03-29,9,2006,2015,"MTL,ANA,VAN,STL,PIT"
Keegan Lowe,1993-03-29,3,2015,2018,"CAR,EDM"
Adam Lowry,1993-03-29,5,2015,2020,WPG
Frank Mathers*,1924-03-29,3,1949,1952,TOR
Dunc McCallum,1940-03-29,5,1966,1971,"NYR,PIT"
Brad McCrimmon,1959-03-29,17,1980,1997,"BOS,PHI,CGY,DET,HAR,PHX"
Charley McVeigh,1898-03-29,8,1927,1935,"CBH,NYA"
Hartland Monahan,1951-03-29,7,1974,1981,"CGS,NYR,WSH,LAK,PIT,STL"
Kai Nurminen,1969-03-29,4,1997,2001,"LAK,MIN"
Adam Pardy,1984-03-29,8,2009,2017,"CGY,DAL,BUF,WPG,EDM,NSH"
Libor Pivko,1980-03-29,0,2004,2004,NSH
Kevin Quick,1988-03-29,0,2009,2009,TBL
Scott Robinson,1964-03-29,0,1990,1990,MNS
Duane Rupp,1938-03-29,10,1963,1973,"NYR,TOR,MNS,PIT"
Travis Sanheim,1996-03-29,2,2018,2020,PHI
Andy Schneider,1972-03-29,0,1994,1994,OTT
Ken Stewart,1913-03-29,0,1942,1942,CBH
Ole-Kristian Tollefsen,1984-03-29,4,2006,2010,"CBJ,PHI"
Petr Vrana,1985-03-29,0,2009,2009,NJD
Tom Wilson,1994-03-29,6,2014,2020,WSH
Mark Astley,1969-03-30,2,1994,1996,BUF
Adam Bennett,1971-03-30,2,1992,1994,"CHI,EDM"
Daniel Brickley,1995-03-30,1,2018,2019,LAK
Mike Brodeur,1983-03-30,1,2010,2011,OTT
Ty Conklin,1976-03-30,10,2002,2012,"EDM,BUF,CBJ,PIT,DET,STL"
Jon DiSalvatore,1981-03-30,6,2006,2012,"STL,MIN"
Dave Ellett,1964-03-30,15,1985,2000,"WIN,TOR,NJD,BOS,STL"
Peter Gustavsson,1958-03-30,0,1982,1982,CLR
Micheal Haley,1986-03-30,10,2010,2020,"NYI,NYR,SJS,FLA"
Jamie Heward,1971-03-30,13,1996,2009,"TOR,NSH,NYI,CBJ,WSH,LAK,TBL"
Randy Hillier,1960-03-30,10,1982,1992,"BOS,PIT,BUF,NYI"
Pierre Jarry,1949-03-30,6,1972,1978,"NYR,TOR,DET,MNS"
Trevor Johansen,1957-03-30,4,1978,1982,"TOR,CLR,LAK"
Allan Johnson,1935-03-30,6,1957,1963,"MTL,DET"
Alexander Kharitonov,1976-03-30,1,2001,2002,"TBL,NYI"
Jeff MacMillan,1979-03-30,0,2004,2004,DAL
Ben Maxwell,1988-03-30,3,2009,2012,"MTL,ATL,ANA,WPG"
Kevin Maxwell,1960-03-30,3,1981,1984,"MNS,CLR,NJD"
Bob McCord,1934-03-30,9,1964,1973,"BOS,DET,MNS,STL"
Sandy McGregor,1939-03-30,0,1964,1964,NYR
Corey Millen,1964-03-30,7,1990,1997,"NYR,LAK,NJD,DAL,CGY"
Gregg Naumenko,1977-03-30,0,2001,2001,MDA
Nathan Paetsch,1983-03-30,4,2006,2010,"BUF,CBJ"
Mike Rucinski,1975-03-30,3,1998,2001,CAR
Zachary Senyshyn,1997-03-30,1,2019,2020,BOS
Herb Stuart,1899-03-30,0,1927,1927,DTC
Mats Thelin,1961-03-30,2,1985,1987,BOS
Andrei Vasilyev,1972-03-30,4,1995,1999,"NYI,PHX"
Dennis Ververgaert,1953-03-30,7,1974,1981,"VAN,PHI,WSH"
Marc-Edouard Vlasic,1987-03-30,13,2007,2020,SJS
Bill Watson,1964-03-30,3,1986,1989,"CBH,CHI"
Doug Wickenheiser,1961-03-30,9,1981,1990,"MTL,STL,VAN,NYR,WSH"
Tom Barrasso,1965-03-31,19,1984,2003,"BUF,PIT,OTT,CAR,TOR,STL"
Brendan Bell,1983-03-31,6,2006,2012,"TOR,PHX,OTT,NYR"
Steve Bernier,1985-03-31,12,2006,2018,"SJS,BUF,VAN,FLA,NJD,NYI"
Steve Black,1927-03-31,1,1950,1951,"DET,CBH"
Claude Bourque,1915-03-31,1,1939,1940,"MTL,DET"
Murray Brumwell,1960-03-31,7,1981,1988,"MNS,NJD"
Pavel Bure*,1971-03-31,11,1992,2003,"VAN,FLA,NYR"
Jakob Chychrun,1998-03-31,3,2017,2020,ARI
David Clarkson,1984-03-31,9,2007,2016,"NJD,TOR,CBJ"
Steven Fletcher,1962-03-31,0,1989,1989,WIN
Gilles Gilbert,1949-03-31,13,1970,1983,"MNS,BOS,DET"
Jani Hakanpaa,1992-03-31,0,2020,2020,ANA
Sammy Hebert,1894-03-31,6,1918,1924,"TRA,OTS"
Bill Hicke,1938-03-31,12,1960,1972,"MTL,NYR,OAK,CGS,PIT"
Gordie Howe*,1928-03-31,33,1947,1980,"DET,HAR"
Gord Lane,1953-03-31,9,1976,1985,"WSH,NYI"
Bud MacPherson,1927-03-31,8,1949,1957,MTL
Brad Marsh,1958-03-31,14,1979,1993,"ATF,CGY,PHI,TOR,DET,OTT"
Jim McTaggart,1960-03-31,1,1981,1982,WSH
Vic Mercredi,1953-03-31,0,1975,1975,ATF
Tom Miller,1947-03-31,4,1971,1975,"DET,NYI"
Trevor Moore,1995-03-31,1,2019,2020,"TOR,LAK"
Ryan Murphy,1993-03-31,6,2013,2019,"CAR,MIN,NJD"
Brendon Nash,1987-03-31,0,2011,2011,MTL
Fern Perreault,1927-03-31,2,1948,1950,NYR
Bob Pulford*,1936-03-31,15,1957,1972,"TOR,LAK"
Serge Roberge,1965-03-31,0,1991,1991,QUE
Michael Ryder,1980-03-31,11,2004,2015,"MTL,BOS,DAL,NJD"
Kiefer Sherwood,1995-03-31,1,2019,2020,ANA
Mike Watt,1976-03-31,5,1998,2003,"EDM,NYI,NSH,CAR"
Carter Ashton,1991-04-01,3,2012,2015,TOR
Brad Berry,1965-04-01,8,1986,1994,"WIN,MNS,DAL"
Terry Caffery,1949-04-01,1,1970,1971,"CBH,MNS"
Lex Chisholm,1915-04-01,1,1940,1941,TOR
Kevin Dean,1969-04-01,6,1995,2001,"NJD,ATL,CHI,DAL"
J.P. Dumont,1978-04-01,12,1999,2011,"CHI,BUF,NSH"
Warren Foegele,1996-04-01,2,2018,2020,CAR
Lee Giffin,1967-04-01,1,1987,1988,PIT
Cody Glass,1999-04-01,0,2020,2020,VEG
Brian Johnson,1960-04-01,0,1984,1984,DET
Jussi Jokinen,1983-04-01,12,2006,2018,"DAL,TBL,CAR,PIT,FLA,CBJ,EDM,LAK,VAN"
Bill Kendall,1910-04-01,4,1934,1938,"CBH,TOR"
Mikko Lehtonen,1987-04-01,1,2009,2010,BOS
Jason MacDonald,1974-04-01,0,2004,2004,NYR
Darren McCarty,1972-04-01,15,1994,2009,"DET,CGY"
Hib Milks,1899-04-01,7,1926,1933,"PTP,PHQ,NYR,OTS"
Esa Pirnes,1977-04-01,0,2004,2004,LAK
Ken Reardon*,1921-04-01,9,1941,1950,MTL
Reijo Ruotsalainen,1960-04-01,8,1982,1990,"NYR,EDM,NJD"
Marek Schwarz,1986-04-01,2,2007,2009,STL
Richard Shulmistra,1971-04-01,2,1998,2000,"NJD,FLA"
Reilly Smith,1991-04-01,8,2012,2020,"DAL,BOS,FLA,VEG"
Scott Stevens*,1964-04-01,21,1983,2004,"WSH,STL,NJD"
Guy Trottier,1941-04-01,3,1969,1972,"NYR,TOR"
John Wensink,1953-04-01,9,1974,1983,"STL,BOS,QUE,CLR,NJD"
Nolan Yonkman,1981-04-01,12,2002,2014,"WSH,PHX,FLA,ANA"
Terry Clancy,1943-04-02,5,1968,1973,"OAK,TOR"
Larry Courville,1975-04-02,2,1996,1998,VAN
Brad Ference,1979-04-02,7,2000,2007,"FLA,PHX,CGY"
Dwight Foster,1957-04-02,9,1978,1987,"BOS,CLR,DET,NJD"
Owen Fussey,1983-04-02,0,2004,2004,WSH
Buster Harvey,1950-04-02,6,1971,1977,"MNS,ATF,DET,KCS"
Cec Hoekstra,1935-04-02,0,1960,1960,MTL
Christian Jaros,1996-04-02,2,2018,2020,OTT
Noah Juulsen,1997-04-02,1,2018,2019,MTL
Brent Krahn,1982-04-02,0,2009,2009,DAL
Gord Kruppke,1969-04-02,3,1991,1994,DET
Aggie Kukulowicz,1933-04-02,1,1953,1954,NYR
John McFarland,1992-04-02,0,2016,2016,FLA
Myles O'Connor,1967-04-02,3,1991,1994,"NJD,MDA"
Keith Osborne,1969-04-02,3,1990,1993,"STL,TBL"
Rem Pitlick,1997-04-02,0,2019,2019,NSH
Tom Polanic,1943-04-02,1,1970,1971,MNS
Alex Smith,1902-04-02,10,1925,1935,"OTS,DTF,BOS,NYA"
Joey Tenute,1983-04-02,0,2006,2006,WSH
Shawn Bates,1975-04-03,10,1998,2008,"BOS,NYI"
Neil Belland,1961-04-03,5,1982,1987,"VAN,PIT"
T.J. Brennan,1989-04-03,4,2012,2016,"BUF,FLA,TOR"
Dom Campedelli,1964-04-03,0,1986,1986,MTL
Rourke Chartier,1996-04-03,0,2019,2019,SJS
Bob Chrystal,1930-04-03,1,1954,1955,NYR
Gerald Coleman,1985-04-03,0,2006,2006,TBL
Daniel Corso,1978-04-03,3,2001,2004,"STL,ATL"
Joey Crabb,1983-04-03,5,2009,2014,"ATL,TOR,WSH,FLA"
Billy Dea,1933-04-03,17,1954,1971,"NYR,DET,CBH,PIT"
Steve Downie,1987-04-03,8,2008,2016,"PHI,TBL,COL,PIT,ARI"
Deryk Engelland,1982-04-03,10,2010,2020,"PIT,CGY,VEG"
Ray Getliffe,1914-04-03,9,1936,1945,"BOS,MTL"
Brent Gilchrist,1967-04-03,14,1989,2003,"MTL,EDM,MNS,DAL,DET,NSH"
Vinnie Hinostroza,1994-04-03,4,2016,2020,"CHI,ARI"
Andrei Lomakin,1964-04-03,3,1992,1995,"PHI,FLA"
Steve Ludzik,1961-04-03,8,1982,1990,"CBH,CHI,BUF"
Hugh Millar,1921-04-03,0,1947,1947,DET
Amby Moran,1895-04-03,1,1927,1928,"MTL,CBH"
Jim O'Neil,1913-04-03,8,1934,1942,"BOS,MTL"
Bernie Parent*,1945-04-03,13,1966,1979,"BOS,PHI,TOR"
Darryl Sly,1939-04-03,5,1966,1971,"TOR,MNS,VAN"
Mike Walsh,1962-04-03,1,1988,1989,NYI
Stephen Weiss,1983-04-03,13,2002,2015,"FLA,DET"
Evgeny Artyukhin,1983-04-04,4,2006,2010,"TBL,ANA,ATL"
Cam Barker,1986-04-04,7,2006,2013,"CHI,MIN,EDM,VAN"
Alex Biega,1988-04-04,5,2015,2020,"VAN,DET"
Brandon Bochenski,1982-04-04,4,2006,2010,"CHI,OTT,BOS,ANA,NSH,TBL"
Bobby Burns,1905-04-04,2,1928,1930,CBH
Phil Crowe,1970-04-04,6,1994,2000,"LAK,PHI,OTT,NSH"
Lorne Duguid,1910-04-04,5,1932,1937,"MTM,DET,BOS"
Blake Dunlop,1953-04-04,10,1974,1984,"MNS,PHI,STL,DET"
Christoffer Ehn,1996-04-04,1,2019,2020,DET
Jesse Fibiger,1978-04-04,0,2003,2003,SJS
Tyler Gaudet,1993-04-04,2,2015,2017,ARI
Dale Hawerchuk*,1963-04-04,15,1982,1997,"WIN,BUF,PHI,STL"
Magnus Hellberg,1991-04-04,3,2014,2017,"NSH,NYR"
Howie Hughes,1939-04-04,2,1968,1970,LAK
Martti Jarventie,1976-04-04,0,2002,2002,MTL
Roberto Luongo,1979-04-04,19,2000,2019,"NYI,FLA,VAN"
Gary Lupul,1959-04-04,6,1980,1986,VAN
Doug Lynch,1983-04-04,0,2004,2004,EDM
Andrew Mangiapane,1996-04-04,2,2018,2020,CGY
George McNaughton,1897-04-04,0,1920,1920,QBC
Rob Murray,1967-04-04,9,1990,1999,"WSH,WIN,PHX"
Mike Needham,1970-04-04,1,1993,1994,"PIT,DAL"
Yanic Perreault,1971-04-04,14,1994,2008,"TOR,LAK,MTL,NSH,PHX,CHI"
Lasse Pirjeta,1974-04-04,3,2003,2006,"CBJ,PIT"
Cliff Simpson,1923-04-04,0,1947,1947,DET
Steve Smith,1963-04-04,7,1982,1989,"PHI,BUF"
Garret Stroshein,1980-04-04,0,2004,2004,WSH
Kevin Weekes,1975-04-04,11,1998,2009,"FLA,VAN,NYI,TBL,CAR,NYR,NJD"
Christoph Bertschy,1994-04-05,2,2016,2018,MIN
Butch Deadmarsh,1950-04-05,4,1971,1975,"BUF,ATF,KCS"
Don Dietrich,1961-04-05,2,1984,1986,"CBH,NJD"
Gord Donnelly,1962-04-05,11,1984,1995,"QUE,WIN,BUF,DAL"
Doug Favell,1945-04-05,11,1968,1979,"PHI,TOR,CLR"
Mike Glumac,1980-04-05,2,2006,2008,STL
John Hanna,1935-04-05,9,1959,1968,"NYR,MTL,PHI"
Bo Horvat,1995-04-05,5,2015,2020,VAN
Brent Hughes,1966-04-05,8,1989,1997,"WIN,BOS,BUF,NYI"
Randy Ireland,1957-04-05,0,1979,1979,BUF
Kevin Krook,1958-04-05,0,1979,1979,CLR
Trevor Letowski,1977-04-05,9,1999,2008,"PHX,VAN,CBJ,CAR"
Lars-Erik Sjoberg,1944-04-05,0,1980,1980,WIN
Zack Smith,1988-04-05,11,2009,2020,"OTT,CHI"
Roy Sommer,1957-04-05,0,1981,1981,EDM
Charlie Stephens,1981-04-05,1,2003,2004,COL
Kris Vernarsky,1982-04-05,1,2003,2004,BOS
Clay Wilson,1983-04-05,4,2008,2012,"CBJ,ATL,FLA,CGY"
Bo Berglund,1955-04-06,2,1984,1986,"QUE,MNS,PHI"
Tobias Bjornfot,2001-04-06,0,2020,2020,LAK
Mike Blake,1956-04-06,2,1982,1984,LAK
Danny Bolduc,1953-04-06,5,1979,1984,"DET,CGY"
Connie Broden,1932-04-06,2,1956,1958,MTL
Bob Crawford,1959-04-06,7,1980,1987,"STL,HAR,NYR,WSH"
Gerald Diduck,1965-04-06,16,1985,2001,"NYI,MTL,VAN,CHI,HAR,PHX,TOR,DAL"
Jimmy Fowler,1915-04-06,2,1937,1939,TOR
Hal Gill,1975-04-06,16,1998,2014,"BOS,TOR,PIT,MTL,NSH,PHI"
Trevor Halverson,1971-04-06,0,1999,1999,WSH
Jeff Harding,1969-04-06,1,1989,1990,PHI
Olaf Kolzig,1970-04-06,19,1990,2009,"WSH,TBL"
Michel Larocque,1952-04-06,10,1974,1984,"MTL,TOR,PHI,STL"
Ilya Lyubushkin,1994-04-06,1,2019,2020,ARI
Clarke MacArthur,1985-04-06,10,2007,2017,"BUF,ATL,TOR,OTT"
Darryl Maggs,1949-04-06,8,1972,1980,"CBH,CGS,TOR"
Travis Moen,1982-04-06,12,2004,2016,"CHI,MDA,ANA,SJS,MTL,DAL"
Dave Morisset,1981-04-06,0,2002,2002,FLA
Ville Nieminen,1977-04-06,7,2000,2007,"COL,PIT,CGY,CHI,NYR,SJS,STL"
Michael Paliotta,1993-04-06,1,2015,2016,"CHI,CBJ"
Joel Perrault,1983-04-06,5,2006,2011,"PHX,STL,VAN"
Brian Perry,1944-04-06,2,1969,1971,"OAK,BUF"
Terry Reardon,1919-04-06,8,1939,1947,"BOS,MTL"
Tanner Richard,1993-04-06,0,2017,2017,TBL
Mike Sands,1963-04-06,2,1985,1987,MNS
Steve Short,1954-04-06,1,1978,1979,"LAK,DET"
David Sloane,1985-04-06,0,2009,2009,PHI
Doug Stevenson,1924-04-06,1,1945,1946,"CBH,NYR"
Tyler Wright,1973-04-06,13,1993,2006,"EDM,PIT,CBJ,MDA"
Matthew Yeats,1979-04-06,0,2004,2004,WSH
Pavel Zacha,1997-04-06,4,2016,2020,NJD
Bob Armstrong,1931-04-07,11,1951,1962,BOS
Don Biggs,1965-04-07,5,1985,1990,"MNS,PHI"
Pascal Dupuis,1979-04-07,15,2001,2016,"MIN,ATL,NYR,PIT"
Rocky Farr,1947-04-07,2,1973,1975,BUF
Troy Gamble,1967-04-07,5,1987,1992,VAN
Clark Gillies*,1954-04-07,13,1975,1988,"NYI,BUF"
Erich Goldmann,1976-04-07,0,2000,2000,OTT
Steve Graves,1964-04-07,4,1984,1988,EDM
Ross Johnstone,1926-04-07,1,1944,1945,TOR
Alexander Karpovtsev,1970-04-07,12,1994,2006,"NYR,TOR,CHI,NYI,FLA"
Joonas Kemppainen,1988-04-07,0,2016,2016,BOS
Craig MacDonald,1977-04-07,10,1999,2009,"CAR,BOS,FLA,CGY,CHI,TBL,CBJ"
Eric Manlow,1975-04-07,3,2001,2004,"BOS,NYI"
Dan McCarthy,1958-04-07,0,1981,1981,NYR
Jim McLeod,1937-04-07,0,1972,1972,STL
Rob Murphy,1969-04-07,6,1988,1994,"VAN,OTT,LAK"
Ted Nolan,1958-04-07,4,1982,1986,"DET,PIT"
Jim Paek,1967-04-07,4,1991,1995,"PIT,LAK,OTT"
Marcus Sorensen,1992-04-07,3,2017,2020,SJS
Troy Stecher,1994-04-07,3,2017,2020,VAN
Radoslav Suchy,1976-04-07,6,2000,2006,"PHX,CBJ"
Chris Terry,1989-04-07,4,2013,2017,"CAR,MTL"
Ryan Vesce,1982-04-07,1,2009,2010,SJS
Matt Walker,1980-04-07,9,2003,2012,"STL,CHI,TBL,PHI"
Thommy Abrahamsson,1947-04-08,0,1981,1981,HAR
Viktor Arvidsson,1993-04-08,5,2015,2020,NSH
Rudolfs Balcers,1997-04-08,1,2019,2020,OTT
Marco Baron,1959-04-08,5,1980,1985,"BOS,LAK,EDM"
Bob Beckett,1936-04-08,7,1957,1964,BOS
J.T. Compher,1995-04-08,3,2017,2020,COL
Richard David,1958-04-08,3,1980,1983,QUE
Craig Ferguson,1970-04-08,6,1994,2000,"MTL,CGY,FLA"
Dave Gorman,1955-04-08,0,1980,1980,ATF
Ron Huston,1945-04-08,1,1974,1975,CGS
Jason Jaspers,1981-04-08,2,2002,2004,PHX
Arto Javanainen,1959-04-08,0,1985,1985,PIT
Keegan Kolesar,1997-04-08,0,2020,2020,VEG
Yanick Lehoux,1982-04-08,1,2006,2007,PHX
Jacques Lemieux,1943-04-08,2,1968,1970,LAK
Dan McFall,1963-04-08,1,1985,1986,WIN
Glenn Merkosky,1959-04-08,8,1982,1990,"HAR,NJD,DET"
John Newberry,1962-04-08,2,1984,1986,"MTL,HAR"
Dave Richter,1960-04-08,8,1982,1990,"MNS,PHI,VAN,STL"
John Sherf,1913-04-08,8,1936,1944,DET
Gordon Sherritt,1919-04-08,0,1944,1944,DET
Randy Wyrozub,1950-04-08,3,1971,1974,BUF
Drew Bannister,1974-04-09,6,1996,2002,"TBL,EDM,MDA,NYR"
Milan Bartovic,1981-04-09,3,2003,2006,"BUF,CHI"
Michael Chaput,1992-04-09,6,2014,2020,"CBJ,VAN,MTL,ARI"
Ryan Donato,1996-04-09,2,2018,2020,"BOS,MIN"
Daniel Dore,1970-04-09,1,1990,1991,QUE
Brian Elliott,1985-04-09,12,2008,2020,"OTT,COL,STL,CGY,PHI"
Joacim Eriksson,1990-04-09,0,2014,2014,VAN
Kelly Fairchild,1973-04-09,6,1996,2002,"TOR,DAL,COL"
Ebbie Goodfellow*,1907-04-09,13,1930,1943,"DTC,DTF,DET"
David Goverde,1970-04-09,2,1992,1994,LAK
Daniel Guerard,1974-04-09,0,1995,1995,OTT
Wayne Hicks,1937-04-09,7,1961,1968,"CBH,BOS,MTL,PHI,PIT"
Ben Holmstrom,1987-04-09,1,2011,2012,PHI
Scott Howson,1960-04-09,1,1985,1986,NYI
Shawn Hunwick,1987-04-09,0,2012,2012,CBJ
Tony Licari,1921-04-09,0,1947,1947,DET
David Musil,1993-04-09,0,2015,2015,EDM
Janne Ojanen,1968-04-09,4,1989,1993,NJD
Michel Parizeau,1948-04-09,0,1972,1972,"PHI,STL"
Alexei Ponikarovsky,1980-04-09,12,2001,2013,"TOR,PIT,LAK,CAR,NJD,WPG"
Jimmy Roberts,1940-04-09,14,1964,1978,"MTL,STL"
Rick Tocchet,1964-04-09,17,1985,2002,"PHI,PIT,LAK,BOS,WSH,PHX"
Frank Waite,1905-04-09,0,1931,1931,NYR
Ken Appleby,1995-04-10,0,2018,2018,NJD
Sean Avery,1980-04-10,10,2002,2012,"DET,LAK,NYR,DAL"
Oliver Bjorkstrand,1995-04-10,4,2016,2020,CBJ
Rob Brown,1968-04-10,12,1988,2000,"PIT,HAR,CHI,DAL,LAK"
Enrico Ciccone,1970-04-10,9,1992,2001,"MNS,TBL,WSH,CHI,CAR,VAN,MTL"
Donald Dufresne,1967-04-10,8,1989,1997,"MTL,LAK,TBL,STL,EDM"
Dutch Gainor,1904-04-10,7,1928,1935,"BOS,NYR,OTS,MTM"
Chris Kenady,1973-04-10,2,1998,2000,"STL,NYR"
Jan Lasak,1979-04-10,1,2002,2003,NSH
Brent Meeke,1952-04-10,4,1973,1977,"CGS,CLE"
Ron Murphy,1933-04-10,17,1953,1970,"NYR,CBH,DET,BOS"
Peanuts O'Flaherty,1918-04-10,1,1941,1942,"NYA,BRO"
Dion Phaneuf,1985-04-10,13,2006,2019,"CGY,TOR,OTT,LAK"
Brandon Pirri,1991-04-10,9,2011,2020,"CHI,FLA,ANA,NYR,VEG"
Mel Read,1922-04-10,0,1947,1947,NYR
John Rogers,1953-04-10,1,1974,1975,MNS
Steve Seguin,1964-04-10,0,1985,1985,LAK
Alexei Semenov,1981-04-10,6,2003,2009,"EDM,FLA,SJS"
Dan Trebil,1974-04-10,4,1997,2001,"MDA,PIT,STL"
Dennis Vial,1969-04-10,7,1991,1998,"DET,NYR,OTT"
Phil Von Stefenelli,1969-04-10,1,1996,1997,"BOS,OTT"
Steve Washburn,1975-04-10,5,1996,2001,"FLA,VAN,PHI"
Kay Whitmore,1967-04-10,13,1989,2002,"HAR,VAN,BOS,CGY"
Gord Williams,1960-04-10,1,1982,1983,PHI
Jerry Wilson,1937-04-10,0,1957,1957,MTL
Andy Branigan,1922-04-11,1,1941,1942,"NYA,BRO"
Alexandre Burrows,1981-04-11,12,2006,2018,"VAN,OTT"
Mathieu Chouinard,1980-04-11,0,2004,2004,LAK
Ben Clymer,1978-04-11,7,2000,2007,"TBL,WSH"
Dave Duerden,1977-04-11,0,2000,2000,FLA
Viktor Gordiouk,1970-04-11,2,1993,1995,BUF
John Gould,1949-04-11,8,1972,1980,"BUF,VAN,ATF"
David Gustafsson,2000-04-11,0,2020,2020,WPG
Leland Irving,1988-04-11,1,2012,2013,CGY
Ron Jones,1951-04-11,4,1972,1976,"BOS,PIT,WSH"
Matt Keith,1983-04-11,4,2004,2008,"CHI,NYI"
Michel Lachance,1955-04-11,0,1979,1979,CLR
Pierre Lacroix,1959-04-11,3,1980,1983,"QUE,HAR"
Trevor Linden,1970-04-11,19,1989,2008,"VAN,NYI,MTL,WSH"
Gus Mancuso,1914-04-11,5,1938,1943,"MTL,NYR"
Mike McKenna,1983-04-11,10,2009,2019,"TBL,NJD,CBJ,ARI,DAL,OTT,PHI"
Brandon Montour,1994-04-11,3,2017,2020,"ANA,BUF"
Jim Nill,1958-04-11,8,1982,1990,"STL,VAN,BOS,WIN,DET"
Selmar Odelein,1966-04-11,3,1986,1989,EDM
Michel Riesen,1979-04-11,0,2001,2001,EDM
Dennis Riggin,1936-04-11,3,1960,1963,DET
Richard Sevigny,1957-04-11,7,1980,1987,"MTL,QUE"
Vern Stenlund,1956-04-11,0,1977,1977,CLE
Rocky Trottier,1964-04-11,1,1984,1985,NJD
Mike Bloom,1952-04-12,2,1975,1977,"DET,WSH"
Neil Brady,1968-04-12,4,1990,1994,"NJD,OTT,DAL"
Al Dewsbury,1926-04-12,9,1947,1956,"DET,CBH"
Lloyd Finkbeiner,1920-04-12,0,1941,1941,NYA
Ron Fischer,1959-04-12,1,1982,1983,BUF
Bob Girard,1949-04-12,4,1976,1980,"CGS,CLE,WSH"
Adam Graves,1968-04-12,15,1988,2003,"DET,EDM,NYR,SJS"
Don Grosso,1915-04-12,8,1939,1947,"DET,CBH,BOS"
Stephane Guerard,1968-04-12,2,1988,1990,QUE
Roman Hamrlik,1974-04-12,20,1993,2013,"TBL,EDM,NYI,CGY,MTL,WSH,NYR"
Dave Hanson,1954-04-12,1,1979,1980,"DET,MNS"
Niclas Havelid,1973-04-12,9,2000,2009,"MDA,ATL,NJD"
Tomas Jonsson,1960-04-12,7,1982,1989,"NYI,EDM"
Torey Krug,1991-04-12,8,2012,2020,BOS
Antero Lehtonen,1954-04-12,0,1980,1980,WSH
Jack MacKell,1896-04-12,1,1920,1921,OTS
Kent Manderville,1971-04-12,11,1992,2003,"TOR,EDM,HAR,CAR,PHI,PIT"
Jason McBain,1974-04-12,1,1996,1997,HAR
Bert McCaffrey,1893-04-12,6,1925,1931,"TRS,TOR,PTP,MTL"
Thomas McCarthy,1893-04-12,1,1920,1921,"QBC,HAM"
Gord McRae,1948-04-12,5,1973,1978,TOR
Ryan Nugent-Hopkins,1993-04-12,8,2012,2020,EDM
Krzysztof Oliwa,1973-04-12,9,1997,2006,"NJD,CBJ,PIT,BOS,NYR,CGY"
Magnus Paajarvi,1991-04-12,8,2011,2019,"EDM,STL,OTT"
Fred Perlini,1962-04-12,2,1982,1984,TOR
Kevin Poulin,1990-04-12,4,2011,2015,NYI
Ken Richardson,1951-04-12,4,1975,1979,STL
Rolly Roulston,1911-04-12,2,1936,1938,DET
Tim Sweeney,1967-04-12,7,1991,1998,"CGY,BOS,MDA,NYR"
Tommy Wingels,1988-04-12,7,2011,2018,"SJS,OTT,BOS,CHI"
Paul Woods,1955-04-12,6,1978,1984,DET
Arron Asham,1978-04-13,15,1999,2014,"MTL,NYI,NJD,PHI,PIT,NYR"
Paul Bibeault,1919-04-13,6,1941,1947,"MTL,TOR,BOS,CBH"
Connor Carrick,1994-04-13,6,2014,2020,"WSH,TOR,DAL,NJD"
Jiri Crha,1950-04-13,1,1980,1981,TOR
Mariusz Czerkawski,1972-04-13,12,1994,2006,"BOS,EDM,NYI,MTL,TOR"
Rasmus Dahlin,2000-04-13,1,2019,2020,BUF
Joonas Donskoi,1992-04-13,4,2016,2020,"SJS,COL"
Patrik Elias,1976-04-13,20,1996,2016,NJD
Craig Endean,1968-04-13,0,1987,1987,WIN
Sergei Gonchar,1974-04-13,20,1995,2015,"WSH,BOS,PIT,OTT,DAL,MTL"
Normie Himes,1903-04-13,8,1927,1935,NYA
Ken Hodge,1966-04-13,4,1989,1993,"MNS,BOS,TBL"
Flash Hollett,1911-04-13,12,1934,1946,"OTS,TOR,BOS,DET"
Mike Kennedy,1972-04-13,4,1995,1999,"DAL,TOR,NYI"
Hub Macey,1921-04-13,5,1942,1947,"NYR,MTL"
Steve Martins,1972-04-13,10,1996,2006,"HAR,CAR,OTT,TBL,NYI,STL"
Jim McGeough,1963-04-13,5,1982,1987,"WSH,PIT"
Elvis Merzlikins,1994-04-13,0,2020,2020,CBJ
Jeff Penner,1987-04-13,0,2010,2010,BOS
Lennart Petrell,1984-04-13,1,2012,2013,EDM
Jack Pratt,1906-04-13,1,1931,1932,BOS
Brad Smith,1958-04-13,8,1979,1987,"VAN,ATF,CGY,DET,TOR"
Jeremy Smith,1989-04-13,0,2017,2017,COL
Ryan Stoa,1987-04-13,4,2010,2014,"COL,WSH"
Jeff Tambellini,1984-04-13,5,2006,2011,"LAK,NYI,VAN"
Keith Wright,1944-04-13,0,1968,1968,PHI
Dave Allison,1959-04-14,0,1984,1984,MTL
Dave Archibald,1969-04-14,9,1988,1997,"MNS,NYR,OTT,NYI"
Frank Banham,1975-04-14,6,1997,2003,"MDA,PHX"
Larry Brown,1947-04-14,8,1970,1978,"NYR,DET,PHI,LAK"
Steve Chiasson,1967-04-14,12,1987,1999,"DET,CGY,HAR,CAR"
Grant Clitsome,1985-04-14,5,2010,2015,"CBJ,WPG"
Alain Cote,1967-04-14,8,1986,1994,"BOS,WSH,MTL,TBL,QUE"
Jeff Finley,1967-04-14,16,1988,2004,"NYI,PHI,WIN,PHX,NYR,STL"
Timothy Gettinger,1998-04-14,1,2019,2020,NYR
Sascha Goc,1979-04-14,1,2001,2002,"NJD,TBL"
Eric Gryba,1988-04-14,6,2013,2019,"OTT,EDM,NJD"
Jim Haggarty,1914-04-14,0,1942,1942,MTL
Steve Jensen,1955-04-14,6,1976,1982,"MNS,LAK"
Kalle Kossila,1993-04-14,2,2017,2019,ANA
Steve Larouche,1971-04-14,1,1995,1996,"OTT,LAK,NYR"
Lonnie Loach,1968-04-14,1,1993,1994,"LAK,OTT,MDA"
Paul MacDermid,1963-04-14,13,1982,1995,"HAR,WIN,WSH,QUE"
Sylvio Mantha*,1902-04-14,13,1924,1937,"MTL,BOS"
Paul Masnick,1931-04-14,7,1951,1958,"MTL,CBH,TOR"
Jamie Masters,1955-04-14,3,1976,1979,STL
Peter Mueller,1988-04-14,5,2008,2013,"PHX,COL,FLA"
Brian Salcido,1985-04-14,0,2009,2009,ANA
Barry Tallackson,1983-04-14,3,2006,2009,NJD
Jason Wiemer,1976-04-14,11,1995,2006,"TBL,CGY,FLA,NYI,MIN,NJD"
Luke Witkowski,1990-04-14,5,2015,2020,"TBL,DET"
Keith Acton,1958-04-15,14,1980,1994,"MTL,MNS,EDM,PHI,NYI,WSH"
Pierre Aubry,1960-04-15,4,1981,1985,"QUE,DET"
Hugh Bolton,1929-04-15,7,1950,1957,TOR
Jason Bonsignore,1976-04-15,4,1995,1999,"EDM,TBL"
Micki DuPont,1980-04-15,6,2002,2008,"CGY,PIT,STL"
Todd Elik,1966-04-15,7,1990,1997,"LAK,MNS,EDM,SJS,STL,BOS"
Christian Fischer,1997-04-15,3,2017,2020,ARI
Ryan Hamilton,1985-04-15,3,2012,2015,"TOR,EDM"
Goran Hogosta,1954-04-15,2,1978,1980,"NYI,QUE"
Cam Janssen,1984-04-15,8,2006,2014,"NJD,STL"
Ilya Kovalchuk,1983-04-15,18,2002,2020,"ATL,NJD,LAK,MTL,WSH"
Sergei Krivokrasov,1974-04-15,9,1993,2002,"CHI,NSH,CGY,MIN,MDA"
Pavel Kubina,1977-04-15,14,1998,2012,"TBL,TOR,ATL,PHI"
Tom Laidlaw,1958-04-15,9,1981,1990,"NYR,LAK"
Kevin Lowe*,1959-04-15,18,1980,1998,"EDM,NYR"
Odie Lowe,1928-04-15,0,1950,1950,NYR
Paul Manning,1979-04-15,0,2003,2003,CBJ
Don Marcotte,1947-04-15,16,1966,1982,BOS
Bill McCreary,1960-04-15,0,1981,1981,TOR
Jim McFadden,1920-04-15,6,1948,1954,"DET,CBH"
Bill Meronek,1917-04-15,3,1940,1943,MTL
Andy Miele,1988-04-15,2,2012,2014,PHX
Ray Neufeld,1959-04-15,10,1980,1990,"HAR,WIN,BOS"
Daniel Paille,1984-04-15,10,2006,2016,"BUF,BOS,NYR"
Calvin Pickard,1992-04-15,5,2015,2020,"COL,TOR,ARI,PHI,DET"
Brian Pothier,1977-04-15,9,2001,2010,"ATL,OTT,WSH,CAR"
Wally Schreiber,1962-04-15,1,1988,1989,MNS
Kevin Stevens,1965-04-15,14,1988,2002,"PIT,BOS,LAK,NYR,PHI"
Tim Thomas,1974-04-15,11,2003,2014,"BOS,DAL,FLA"
Mathias Tjarnqvist,1979-04-15,4,2004,2008,"DAL,PHX"
Jimmy Waite,1969-04-15,10,1989,1999,"CHI,SJS,PHX"
Jordan Weal,1992-04-15,4,2016,2020,"LAK,PHI,ARI,MTL"
Jason Zent,1971-04-15,2,1997,1999,"OTT,PHI"
Eric Bertrand,1975-04-16,1,2000,2001,"ATL,NJD,MTL"
Connor Bunnaman,1998-04-16,0,2020,2020,PHI
Mike Crombeen,1957-04-16,7,1978,1985,"CLE,STL,HAR"
Dean Defazio,1963-04-16,0,1984,1984,PIT
Joffre Desilets,1915-04-16,4,1936,1940,"MTL,CBH"
Boyd Devereaux,1978-04-16,11,1998,2009,"EDM,DET,PHX,TOR"
Remi Elie,1995-04-16,2,2017,2019,"DAL,BUF"
Jon Fontas,1955-04-16,1,1980,1981,MNS
Garry Galley,1963-04-16,16,1985,2001,"LAK,WSH,BOS,PHI,BUF,NYI"
Don Gallinger,1925-04-16,5,1943,1948,BOS
Markus Granlund,1993-04-16,6,2014,2020,"CGY,VAN,EDM"
Galen Head,1947-04-16,0,1968,1968,DET
Joseph Labate,1993-04-16,0,2017,2017,VAN
Chris Lindberg,1967-04-16,2,1992,1994,"CGY,QUE"
Jeremy Morin,1991-04-16,4,2011,2015,"CHI,CBJ"
Kyle Okposo,1988-04-16,12,2008,2020,"NYI,BUF"
Joni Ortio,1991-04-16,2,2014,2016,CGY
John Quenneville,1996-04-16,3,2017,2020,"NJD,CHI"
Peter Regin,1986-04-16,6,2009,2015,"OTT,CHI,NYI"
Gemel Smith,1994-04-16,3,2017,2020,"DAL,BOS,TBL"
Mattias Timander,1974-04-16,7,1997,2004,"BOS,CBJ,NYI,PHI"
Harry York,1974-04-16,3,1997,2000,"STL,NYR,PIT,VAN"
Nikita Zadorov,1995-04-16,6,2014,2020,"BUF,COL"
Mike Zuke,1954-04-16,7,1979,1986,"STL,HAR"
Brad Boyes,1982-04-17,12,2004,2016,"SJS,BOS,STL,BUF,NYI,FLA,TOR"
Eric Brewer,1979-04-17,16,1999,2015,"NYI,EDM,STL,TBL,ANA,TOR"
Pavel Buchnevich,1995-04-17,3,2017,2020,NYR
Stanislav Chistov,1983-04-17,4,2003,2007,"MDA,ANA,BOS"
Ken Daneyko,1964-04-17,19,1984,2003,NJD
Bob Gassoff,1953-04-17,3,1974,1977,STL
Bob Geale,1962-04-17,0,1985,1985,PIT
Dennis Hextall,1943-04-17,11,1969,1980,"NYR,LAK,CGS,MNS,DET,WSH"
Dave Hynes,1951-04-17,1,1974,1975,BOS
Roger Johansson,1967-04-17,5,1990,1995,"CGY,CHI"
Chuck Kobasew,1982-04-17,11,2003,2014,"CGY,BOS,MIN,COL,PIT"
Konstantin Koltsov,1981-04-17,3,2003,2006,PIT
Herbie Lewis*,1906-04-17,10,1929,1939,"DTC,DTF,DET"
Jimmy Mann,1959-04-17,8,1980,1988,"WIN,QUE,PIT"
Alex McKinnon,1895-04-17,4,1925,1929,"HAM,NYA,CBH"
Gerry McNeil,1926-04-17,9,1948,1957,MTL
Jim Nahrgang,1951-04-17,2,1975,1977,DET
David Oliver,1971-04-17,11,1995,2006,"EDM,NYR,OTT,PHX,DAL"
Kent Paynter,1965-04-17,6,1988,1994,"CHI,WSH,WIN,OTT"
Michael Rasmussen,1999-04-17,0,2019,2019,DET
Borje Salming*,1951-04-17,16,1974,1990,"TOR,DET"
Terran Sandwith,1972-04-17,0,1998,1998,EDM
Andy Spruce,1954-04-17,2,1977,1979,"VAN,CLR"
Tommy Williams,1940-04-17,14,1962,1976,"BOS,MNS,CGS,WSH"
Sebastien Charpentier,1977-04-18,2,2002,2004,WSH
Stan Crossett,1900-04-18,0,1931,1931,PHQ
Scott Hartnell,1982-04-18,17,2001,2018,"NSH,PHI,CBJ"
Stephen Johns,1992-04-18,4,2016,2020,DAL
Valeri Kamensky,1966-04-18,10,1992,2002,"QUE,COL,NYR,DAL,NJD"
Boyd Kane,1978-04-18,6,2004,2010,"PHI,WSH"
Dan Kordic,1971-04-18,7,1992,1999,PHI
Dan LaCouture,1977-04-18,10,1999,2009,"EDM,PIT,NYR,BOS,NJD,CAR"
Francois Leroux,1970-04-18,9,1989,1998,"EDM,OTT,PIT,COL"
Cody McCormick,1983-04-18,11,2004,2015,"COL,BUF,MIN"
Anthony Peluso,1989-04-18,6,2013,2019,"WPG,WSH,CGY"
Cliff Pennington,1940-04-18,2,1961,1963,"MTL,BOS"
Oleg Petrov,1971-04-18,10,1993,2003,"MTL,NSH"
Petr Schastlivy,1979-04-18,4,2000,2004,"OTT,MDA"
Al Sims,1953-04-18,9,1974,1983,"BOS,HAR,LAK"
Vladimir Tsyplakov,1969-04-18,5,1996,2001,"LAK,BUF"
Mika Zibanejad,1993-04-18,8,2012,2020,"OTT,NYR"
Daniel Bang,1987-04-19,0,2013,2013,NSH
Jesse Blacker,1991-04-19,0,2015,2015,ANA
Garry Blaine,1933-04-19,0,1955,1955,MTL
Randy Carlyle,1956-04-19,16,1977,1993,"TOR,PIT,WIN"
Igor Chibirev,1968-04-19,1,1994,1995,HAR
Steven Fogarty,1993-04-19,2,2018,2020,NYR
Luc Gauthier,1964-04-19,0,1991,1991,MTL
Martin Havlat,1981-04-19,15,2001,2016,"OTT,CHI,MIN,SJS,NJD,STL"
Andre Hinse,1945-04-19,0,1968,1968,TOR
Jarkko Immonen,1982-04-19,1,2006,2007,NYR
Max Kaminsky,1913-04-19,3,1934,1937,"OTS,BOS,STE,MTM"
Patrik Laine,1998-04-19,3,2017,2020,WPG
Ken Leiter,1961-04-19,5,1985,1990,"NYI,MNS"
Rich Lemieux,1951-04-19,4,1972,1976,"VAN,KCS,ATF"
Darwin McCutcheon,1962-04-19,0,1982,1982,TOR
Ilkka Pikkarainen,1981-04-19,0,2010,2010,NJD
Robyn Regehr,1980-04-19,15,2000,2015,"CGY,BUF,LAK"
Rob Robinson,1967-04-19,0,1992,1992,STL
Juuse Saros,1995-04-19,4,2016,2020,NSH
Rickard Wallin,1980-04-19,7,2003,2010,"MIN,TOR"
Blair Atcheynum,1969-04-20,8,1993,2001,"OTT,STL,NSH,CHI"
Nick Bonino,1988-04-20,10,2010,2020,"ANA,VAN,PIT,NSH"
Rick Bourbonnais,1955-04-20,2,1976,1978,STL
Denis Chervyakov,1970-04-20,0,1993,1993,BOS
Guillaume Desbiens,1985-04-20,2,2010,2012,"VAN,CGY"
Adam Erne,1995-04-20,3,2017,2020,"TBL,DET"
Micheal Ferland,1992-04-20,5,2015,2020,"CGY,CAR,VAN"
Viacheslav Fetisov*,1958-04-20,8,1990,1998,"NJD,DET"
Ryan Flinn,1980-04-20,4,2002,2006,LAK
Kurtis Gabriel,1993-04-20,3,2016,2019,"MIN,NJD"
Shayne Gostisbehere,1993-04-20,5,2015,2020,PHI
Derek Grant,1990-04-20,7,2013,2020,"OTT,CGY,BUF,NSH,ANA,PIT,PHI"
Lionel Heinrich,1934-04-20,0,1956,1956,BOS
Jamie Hunt,1984-04-20,0,2007,2007,WSH
Ben Hutton,1993-04-20,4,2016,2020,"VAN,LAK"
Paul Jerrard,1965-04-20,0,1989,1989,MNS
Mike Lampman,1950-04-20,4,1973,1977,"STL,VAN,WSH"
Brian Lavender,1947-04-20,3,1972,1975,"STL,DET,NYI,CGS"
Gilles Lupien,1954-04-20,4,1978,1982,"MTL,HAR,PIT"
Andrey Makarov,1993-04-20,0,2015,2015,BUF
Cameron Mann,1977-04-20,5,1998,2003,"BOS,NSH"
Chris Mason,1976-04-20,14,1999,2013,"NSH,STL,ATL,WPG"
Dylan McIlrath,1992-04-20,6,2014,2020,"NYR,FLA,DET"
Corrado Micalef,1961-04-20,4,1982,1986,DET
Vincent Riendeau,1966-04-20,7,1988,1995,"MTL,STL,DET,BOS"
Colton Sceviour,1989-04-20,9,2011,2020,"DAL,FLA"
Brent Seabrook,1985-04-20,14,2006,2020,CHI
David Van Der Gulik,1983-04-20,6,2009,2015,"CGY,COL,LAK"
Claude Verret,1963-04-20,1,1984,1985,BUF
Doug Barrault,1970-04-21,1,1993,1994,"MNS,FLA"
Ed Belfour*,1965-04-21,18,1989,2007,"CHI,SJS,DAL,TOR,FLA"
Nick Beverley,1947-04-21,13,1967,1980,"BOS,PIT,NYR,MNS,CLR,LAK"
Jacques Caron,1940-04-21,6,1968,1974,"LAK,STL,VAN"
Carl Corazzini,1979-04-21,3,2004,2007,"BOS,CHI"
Thomas Coulter,1911-04-21,0,1934,1934,CBH
Alexander Edler,1986-04-21,13,2007,2020,VAN
Miika Elomo,1977-04-21,0,2000,2000,WSH
Jack Evans,1928-04-21,14,1949,1963,"NYR,CBH"
Reggie Fleming,1936-04-21,11,1960,1971,"MTL,CBH,BOS,NYR,PHI,BUF"
Michel Goulet*,1960-04-21,14,1980,1994,"QUE,CHI"
Scott Langkow,1975-04-21,4,1996,2000,"WIN,PHX,ATL"
Vincent Lecavalier,1980-04-21,17,1999,2016,"TBL,PHI,LAK"
Mark Lofthouse,1957-04-21,5,1978,1983,"WSH,DET"
Stewart Malgunas,1970-04-21,6,1994,2000,"PHI,WIN,WSH,CGY"
Derek Meech,1984-04-21,6,2007,2013,"DET,WPG"
Clayton Pachal,1956-04-21,2,1977,1979,"BOS,CLR"
Todd Simon,1972-04-21,0,1994,1994,BUF
Larry Skinner,1956-04-21,3,1977,1980,CLR
Doug Soetaert,1955-04-21,11,1976,1987,"NYR,WIN,MTL"
Reg Thomas,1953-04-21,0,1980,1980,QUE
Steve Vickers,1951-04-21,9,1973,1982,NYR
Roman Vopat,1976-04-21,3,1996,1999,"STL,LAK,CHI,PHI"
Madison Bowey,1995-04-22,2,2018,2020,"WSH,DET"
Dan Cloutier,1976-04-22,10,1998,2008,"NYR,TBL,VAN,LAK"
Bert Connelly,1909-04-22,3,1935,1938,"NYR,CBH"
Jean-Philippe Cote,1982-04-22,8,2006,2014,"MTL,TBL"
P.C. Drouin,1974-04-22,0,1997,1997,BOS
T.J. Galiardi,1988-04-22,6,2009,2015,"COL,SJS,CGY,WPG"
Mike Gaul,1973-04-22,2,1999,2001,"COL,CBJ"
Al Hill,1955-04-22,11,1977,1988,PHI
Milos Holan,1971-04-22,2,1994,1996,"PHI,MDA"
Doug Jarrett,1944-04-22,12,1965,1977,"CBH,NYR"
Ed Kachur,1934-04-22,1,1957,1958,CBH
Phil Latreille,1938-04-22,0,1961,1961,NYR
Enver Lisin,1986-04-22,3,2007,2010,"PHX,NYR"
Tom Lysiak,1953-04-22,12,1974,1986,"ATF,CBH"
Bob Mason,1961-04-22,7,1984,1991,"WSH,CHI,QUE,VAN"
Bob Paradise,1944-04-22,7,1972,1979,"MNS,ATF,PIT,WSH"
Hal Picketts,1909-04-22,0,1934,1934,NYA
Justin Pogge,1986-04-22,0,2009,2009,TOR
Bryan Rodney,1984-04-22,3,2009,2012,"CAR,EDM"
Glen Sonmor,1929-04-22,1,1954,1955,NYR
Chandler Stephenson,1994-04-22,4,2016,2020,"WSH,VEG"
Eeli Tolvanen,1999-04-22,1,2018,2019,NSH
David Ullstrom,1989-04-22,1,2012,2013,NYI
Alexander Vasyunov,1988-04-22,0,2011,2011,NJD
Zarley Zalapski,1968-04-22,12,1988,2000,"PIT,HAR,CGY,MTL,PHI"
Peter Zezel,1965-04-22,14,1985,1999,"PHI,STL,TOR,WSH,DAL,NJD,VAN"
Dave Amadio,1939-04-23,11,1958,1969,"DET,LAK"
Derek Armstrong,1973-04-23,16,1994,2010,"NYI,OTT,NYR,LAK,STL"
Jock Callander,1961-04-23,5,1988,1993,"PIT,TBL"
Vladimir Chebaturkin,1975-04-23,4,1998,2002,"NYI,STL,CHI"
Alain Chevrier,1961-04-23,5,1986,1991,"NJD,CHI,WIN,PIT,DET"
Patrick Coulombe,1985-04-23,0,2007,2007,VAN
Sylvain Couturier,1968-04-23,3,1989,1992,LAK
Mark Cundari,1990-04-23,1,2013,2014,CGY
Sheldon Dries,1994-04-23,1,2019,2020,COL
Tony Esposito*,1943-04-23,15,1969,1984,"MTL,CBH"
Ryan Hollweg,1983-04-23,5,2006,2011,"NYR,TOR,PHX"
Claude Julien,1960-04-23,1,1985,1986,QUE
Reggie Leach,1950-04-23,12,1971,1983,"BOS,CGS,PHI,DET"
Pat Maroon,1988-04-23,8,2012,2020,"ANA,EDM,NJD,STL,TBL"
Ken McRae,1968-04-23,6,1988,1994,"QUE,TOR"
Wayne Merrick,1952-04-23,11,1973,1984,"STL,CGS,CLE,NYI"
Willie Mitchell,1977-04-23,16,2000,2016,"NJD,MIN,DAL,VAN,LAK,FLA"
Patrick Poulin,1973-04-23,10,1992,2002,"HAR,CHI,TBL,MTL"
Stephane Richer,1966-04-23,2,1993,1995,"BOS,TBL,FLA"
Gregg Sheppard,1949-04-23,9,1973,1982,"BOS,PIT"
Dale Smedsmo,1951-04-23,0,1973,1973,TOR
Greg Smyth,1966-04-23,10,1987,1997,"PHI,QUE,CGY,CHI,FLA,TOR"
Jim Stewart,1957-04-23,0,1980,1980,BOS
Brian Sullivan,1969-04-23,0,1993,1993,NJD
Matt Tennyson,1990-04-23,7,2013,2020,"SJS,CAR,BUF,NJD"
Dana Tyrell,1989-04-23,4,2011,2015,"TBL,CBJ"
Ryan Walter,1958-04-23,14,1979,1993,"WSH,MTL,VAN"
Barry Wilcox,1948-04-23,2,1973,1975,VAN
Dennis Abgrall,1953-04-24,0,1976,1976,LAK
Akim Aliu,1989-04-24,1,2012,2013,CGY
Gus Bodnar,1923-04-24,11,1944,1955,"TOR,CBH,BOS"
Ray Ceresino,1929-04-24,0,1949,1949,TOR
Dale Craigwell,1971-04-24,2,1992,1994,SJS
Philippe Dupuis,1985-04-24,3,2009,2012,"COL,TOR"
Aaron Gagnon,1986-04-24,3,2010,2013,"DAL,WPG"
Jeff Jackson,1965-04-24,7,1985,1992,"TOR,NYR,QUE,CHI"
Patrik Juhlin,1970-04-24,1,1995,1996,PHI
Ken Klee,1971-04-24,14,1995,2009,"WSH,TOR,NJD,COL,ATL,ANA,PHX"
Neil Labatte,1957-04-24,3,1979,1982,STL
Anton Lander,1991-04-24,5,2012,2017,EDM
Mario Larocque,1978-04-24,0,1999,1999,TBL
Kris Letang,1987-04-24,13,2007,2020,PIT
David Maley,1963-04-24,8,1986,1994,"MTL,NJD,EDM,SJS,NYI"
John Newman,1910-04-24,0,1931,1931,DTF
Frans Nielsen,1984-04-24,13,2007,2020,"NYI,DET"
Jakub Petruzalek,1985-04-24,0,2009,2009,CAR
Byron Ritchie,1977-04-24,9,1999,2008,"CAR,FLA,CGY,VAN"
Colby Robak,1990-04-24,3,2012,2015,"FLA,ANA"
Thain Simon,1922-04-24,0,1947,1947,DET
Peter Skudra,1973-04-24,5,1998,2003,"PIT,BOS,BUF,VAN"
Peter Slobodian,1918-04-24,0,1941,1941,NYA
Brett Sterling,1984-04-24,4,2008,2012,"ATL,PIT,STL"
Tyler Toffoli,1992-04-24,7,2013,2020,"LAK,VAN"
Darren Veitch,1960-04-24,10,1981,1991,"WSH,DET,TOR"
Phil Watson,1914-04-24,12,1936,1948,"NYR,MTL"
Scott Wilson,1992-04-24,5,2015,2020,"PIT,BUF,DET"
Andy Chiodo,1983-04-25,0,2004,2004,PIT
Rich Clune,1987-04-25,6,2010,2016,"LAK,NSH,TOR"
Colby Cohen,1989-04-25,0,2011,2011,COL
Yves Courteau,1964-04-25,2,1985,1987,"CGY,HAR"
Bob Dill,1920-04-25,1,1944,1945,NYR
Christian Dube,1977-04-25,2,1997,1999,NYR
Pat Egan,1918-04-25,11,1940,1951,"NYA,BRO,BOS,DET,NYR"
Alexei Emelin,1986-04-25,6,2012,2018,"MTL,NSH"
Gus Forslund,1908-04-25,0,1933,1933,OTS
John Harms,1925-04-25,1,1944,1945,CBH
Rene Joliat,1898-04-25,0,1925,1925,MTL
Don Martineau,1952-04-25,3,1974,1977,"ATF,MNS,DET"
Roger Melin,1956-04-25,1,1981,1982,MNS
James Sheppard,1988-04-25,7,2008,2015,"MIN,SJS,NYR"
Barry Smith,1955-04-25,5,1976,1981,"BOS,CLR"
Glenn Smith,1895-04-25,0,1922,1922,TRS
Alek Stojanov,1973-04-25,2,1995,1997,"VAN,PIT"
Bob Stumpf,1953-04-25,0,1975,1975,"PIT,STL"
Marko Tuomainen,1972-04-25,7,1995,2002,"EDM,LAK,NYI"
Brandon Yip,1985-04-25,4,2010,2014,"COL,NSH,PHX"
Craig Adams,1977-04-26,14,2001,2015,"CAR,CHI,PIT"
Red Almas,1924-04-26,6,1947,1953,"DET,CBH"
Brett Bulmer,1992-04-26,4,2012,2016,MIN
Bobby Butler,1987-04-26,4,2010,2014,"OTT,NJD,NSH,FLA"
Petr Buzek,1977-04-26,5,1998,2003,"DAL,ATL,CGY"
Cecil Dillon,1908-04-26,9,1931,1940,"NYR,DET"
Frederik Gauthier,1995-04-26,4,2016,2020,TOR
Glenn Goldup,1953-04-26,8,1974,1982,"MTL,LAK"
Keith Hanson,1957-04-26,0,1984,1984,CGY
Victor Ignatjev,1970-04-26,0,1999,1999,PIT
Russ Kopak,1924-04-26,0,1944,1944,BOS
Bruce MacGregor,1941-04-26,13,1961,1974,"DET,NYR"
Walt McCartney,1911-04-26,0,1933,1933,MTL
Al Nicholson,1936-04-26,1,1956,1957,BOS
Jonas Nordqvist,1982-04-26,0,2007,2007,CHI
Glenn Patrick,1950-04-26,3,1974,1977,"STL,CGS,CLE"
Steve Pinizzotto,1984-04-26,2,2013,2015,"VAN,EDM"
Pat Ribble,1954-04-26,7,1976,1983,"ATF,CBH,TOR,WSH,CGY"
Jean Savard,1957-04-26,2,1978,1980,"CBH,HAR"
Vaclav Varada,1976-04-26,10,1996,2006,"BUF,OTT"
Vern Ayres,1909-04-27,5,1931,1936,"NYA,MTM,STE,NYR"
Murray Bannerman,1957-04-27,9,1978,1987,"VAN,CBH,CHI"
Drake Batherson,1998-04-27,1,2019,2020,OTT
Pierre-Marc Bouchard,1984-04-27,11,2003,2014,"MIN,NYI"
Mike Brown,1979-04-27,5,2001,2006,"VAN,MDA,CHI"
Paul Byron,1989-04-27,9,2011,2020,"BUF,CGY,MTL"
Dave Campbell,1896-04-27,0,1921,1921,MTL
Alain Caron,1938-04-27,1,1968,1969,"OAK,MTL"
Taylor Chorney,1987-04-27,9,2009,2018,"EDM,STL,PIT,WSH,CBJ"
Mike Condon,1990-04-27,3,2016,2019,"MTL,OTT,PIT"
Bob Dillabough,1941-04-27,8,1962,1970,"DET,BOS,PIT,OAK"
Tyler Graovac,1993-04-27,5,2015,2020,"MIN,WSH,VAN"
Anders Hakansson,1956-04-27,4,1982,1986,"MNS,PIT,LAK"
Yves Heroux,1965-04-27,0,1987,1987,QUE
Matt Keetley,1986-04-27,0,2008,2008,CGY
Vlastimil Kroupa,1975-04-27,4,1994,1998,"SJS,NJD"
Mike Krushelnyski,1960-04-27,13,1982,1995,"BOS,EDM,LAK,TOR,DET"
Ian MacNeil,1977-04-27,0,2003,2003,PHI
Keith Magnuson,1947-04-27,10,1970,1980,CBH
Bob McGill,1962-04-27,12,1982,1994,"TOR,CHI,DET,SJS,HAR,NYI"
Niko Mikkola,1996-04-27,0,2020,2020,STL
Matthew Peca,1993-04-27,3,2017,2020,"TBL,MTL,OTT"
Brendan Perlini,1996-04-27,3,2017,2020,"ARI,CHI,DET"
Mark Stuart,1984-04-27,11,2006,2017,"BOS,ATL,WPG"
Jeff Ulmer,1977-04-27,0,2001,2001,NYR
Semyon Varlamov,1988-04-27,11,2009,2020,"WSH,COL,NYI"
Andy Welinski,1993-04-27,1,2018,2019,ANA
Christian Backman,1980-04-28,6,2003,2009,"STL,NYR,CBJ"
Frank Beaton,1953-04-28,1,1979,1980,NYR
Hank Blade,1920-04-28,1,1947,1948,CBH
Mel Bridgman,1955-04-28,13,1976,1989,"PHI,CGY,NJD,DET,VAN"
Connor Clifton,1995-04-28,1,2019,2020,BOS
Ted Donato,1969-04-28,12,1992,2004,"BOS,NYI,OTT,MDA,DAL,LAK,STL,NYR"
Grant Erickson,1947-04-28,1,1969,1970,"BOS,MNS"
Claude Evans,1933-04-28,3,1955,1958,"MTL,BOS"
Luke Glendening,1989-04-28,6,2014,2020,DET
Henry Harris,1906-04-28,0,1931,1931,BOS
Peter Ing,1969-04-28,4,1990,1994,"TOR,EDM,DET"
Joonas Korpisalo,1994-04-28,4,2016,2020,CBJ
David Krejci,1986-04-28,13,2007,2020,BOS
Jeremy Lauzon,1997-04-28,1,2019,2020,BOS
Nicklas Lidstrom*,1970-04-28,20,1992,2012,DET
Howie Menard,1942-04-28,6,1964,1970,"DET,LAK,CBH,OAK"
Mike Millar,1965-04-28,4,1987,1991,"HAR,WSH,BOS,TOR"
Will O'Neill,1988-04-28,0,2018,2018,PHI
Roman Polak,1986-04-28,13,2007,2020,"STL,TOR,SJS,DAL"
Ken Sabourin,1966-04-28,3,1989,1992,"CGY,WSH"
Brad Shaw,1964-04-28,13,1986,1999,"HAR,OTT,STL,WSH"
Wally Stanowski,1919-04-28,11,1940,1951,"TOR,NYR"
Anders Steen,1955-04-28,0,1981,1981,WIN
Bud Stefanski,1955-04-28,0,1978,1978,NYR
Brad Tapper,1978-04-28,2,2001,2003,ATL
Daniel Taylor,1986-04-28,10,2008,2018,"LAK,CGY,OTT"
Jarkko Varvio,1972-04-28,1,1994,1995,DAL
Jim Wiley,1950-04-28,4,1973,1977,"PIT,VAN"
Pete Backor,1919-04-29,0,1945,1945,TOR
Jim Benning,1963-04-29,8,1982,1990,"TOR,VAN"
Serge Bernier,1947-04-29,12,1969,1981,"PHI,LAK,QUE"
Mathieu Biron,1980-04-29,6,2000,2006,"NYI,TBL,FLA,WSH"
Lyle Carter,1945-04-29,0,1972,1972,CGS
Steve Clippingdale,1956-04-29,3,1977,1980,"LAK,WSH"
Thomas Di Pauli,1994-04-29,0,2020,2020,PIT
Bruce Driver,1962-04-29,14,1984,1998,"NJD,NYR"
Brandon Dubinsky,1986-04-29,12,2007,2019,"NYR,CBJ"
Denny Felsner,1970-04-29,3,1992,1995,STL
David Fenyves,1960-04-29,8,1983,1991,"BUF,PHI"
Benn Ferriero,1987-04-29,4,2010,2014,"SJS,NYR,VAN"
Wilf Field,1915-04-29,8,1937,1945,"NYA,BRO,CBH,MTL"
Jean Gauthier,1937-04-29,9,1961,1970,"MTL,PHI,BOS"
Dan Girardi,1984-04-29,12,2007,2019,"NYR,TBL"
Reg Hamilton,1914-04-29,11,1936,1947,"TOR,CBH"
Jean-Francois Jacques,1985-04-29,6,2006,2012,"EDM,ANA"
Tristan Jarry,1995-04-29,3,2017,2020,PIT
Tomas Jelinek,1962-04-29,0,1993,1993,OTT
Curtis Joseph,1967-04-29,19,1990,2009,"STL,EDM,TOR,DET,PHX,CGY"
Niko Kapanen,1978-04-29,6,2002,2008,"DAL,ATL,PHX"
Jacob Larsson,1997-04-29,3,2017,2020,ANA
Dean Magee,1955-04-29,0,1978,1978,MNS
John McIntyre,1969-04-29,5,1990,1995,"TOR,LAK,NYR,VAN"
Mel Pearson,1938-04-29,8,1960,1968,"NYR,PIT"
George Servinis,1962-04-29,0,1988,1988,MNS
Dan Sexton,1987-04-29,1,2010,2011,ANA
Doug Shedden,1961-04-29,9,1982,1991,"PIT,DET,QUE,TOR"
Jonathan Toews,1988-04-29,12,2008,2020,CHI
Niklas Treutle,1991-04-29,0,2016,2016,ARI
Spencer Abbott,1988-04-30,3,2014,2017,"TOR,CHI"
Kenny Agostino,1992-04-30,5,2014,2019,"CGY,STL,BOS,MTL,NJD"
Jeff Brown,1966-04-30,12,1986,1998,"QUE,STL,VAN,HAR,CAR,TOR,WSH"
Marcel Cousineau,1973-04-30,3,1997,2000,"TOR,NYI,LAK"
Morgan Ellis,1992-04-30,0,2016,2016,MTL
Jason Holland,1976-04-30,7,1997,2004,"NYI,BUF,LAK"
Aaron Johnson,1983-04-30,9,2004,2013,"CBJ,NYI,CHI,CGY,EDM,BOS"
Tim Kennedy,1986-04-30,5,2009,2014,"BUF,FLA,SJS,PHX"
Chris Kreider,1991-04-30,7,2013,2020,NYR
Timothy Liljegren,1999-04-30,0,2020,2020,TOR
Fleming MacKell,1929-04-30,12,1948,1960,"TOR,BOS"
Sean Malone,1995-04-30,0,2017,2017,BUF
Matt Martin,1971-04-30,3,1994,1997,TOR
Bill McDonagh,1928-04-30,0,1950,1950,NYR
Mike McDougal,1958-04-30,4,1979,1983,"NYR,HAR"
Don McKenney,1934-04-30,13,1955,1968,"BOS,NYR,TOR,DET,STL"
Jackie McLeod,1930-04-30,5,1950,1955,NYR
Andrej Nedorost,1980-04-30,2,2002,2004,CBJ
Dave Parro,1957-04-30,3,1981,1984,WSH
Rich Pilon,1968-04-30,13,1989,2002,"NYI,NYR,STL"
Dale Rolfe,1940-04-30,15,1960,1975,"BOS,LAK,DET,NYR"
Shane Sims,1988-04-30,0,2011,2011,NYI
Steve Smith,1963-04-30,16,1985,2001,"EDM,CHI,CGY"
Harijs Vitolinsh,1968-04-30,0,1994,1994,WIN
Peter Wallin,1957-04-30,1,1981,1982,NYR
Steve Webb,1975-04-30,7,1997,2004,"NYI,PIT"
Jeremy Welsh,1988-04-30,4,2012,2016,"CAR,VAN,STL"
Rob Whistle,1961-04-30,2,1986,1988,"NYR,STL"
Arch Wilder,1917-04-30,0,1941,1941,DET
Miles Zaharko,1957-04-30,4,1978,1982,"ATF,CBH"
David Backes,1984-05-01,13,2007,2020,"STL,BOS,ANA"
Antoine Bibeau,1994-05-01,3,2017,2020,"TOR,COL"
Pat Conacher,1959-05-01,16,1980,1996,"NYR,EDM,NJD,LAK,CGY,NYI"
Rob Davison,1980-05-01,7,2003,2010,"SJS,NYI,VAN,NJD"
Dylan DeMelo,1993-05-01,4,2016,2020,"SJS,OTT,WPG"
Patrick Eaves,1984-05-01,13,2006,2019,"OTT,CAR,DET,NSH,DAL,ANA"
Sid Finney,1929-05-01,2,1952,1954,CBH
Larry Floyd,1961-05-01,1,1983,1984,NJD
Frederick Gaudreau,1993-05-01,2,2017,2019,NSH
Ben Hankinson,1969-05-01,2,1993,1995,"NJD,TBL"
Bob Hurlburt,1950-05-01,0,1975,1975,VAN
Connor Knapp,1990-05-01,0,2014,2014,BUF
Tomas Kubalik,1990-05-01,1,2011,2012,CBJ
Jim Lorentz,1947-05-01,9,1969,1978,"BOS,STL,BUF,NYR"
Olivier Magnan,1986-05-01,0,2011,2011,NJD
Clint Malarchuk,1961-05-01,10,1982,1992,"QUE,WSH,BUF"
Bryan Marchment,1969-05-01,17,1989,2006,"WIN,CHI,HAR,EDM,SJS,TBL,COL,TOR,CGY"
Frank Martin,1933-05-01,5,1953,1958,"BOS,CBH"
Dick Mattiussi,1938-05-01,3,1968,1971,"PIT,OAK,CGS"
Max McCormick,1992-05-01,3,2016,2019,OTT
Eric Meloche,1976-05-01,5,2002,2007,"PIT,PHI"
William Nylander,1996-05-01,4,2016,2020,TOR
Mickey Roach,1895-05-01,7,1920,1927,"TRS,HAM,NYA"
Reggie Savage,1970-05-01,3,1991,1994,"WSH,QUE"
Jaccob Slavin,1994-05-01,4,2016,2020,CAR
Rod Willard,1960-05-01,0,1983,1983,TOR
Scott Bailey,1972-05-02,1,1996,1997,BOS
Frank Caprice,1962-05-02,5,1983,1988,VAN
Real Chevrefils,1932-05-02,7,1952,1959,"BOS,DET"
Jason Chimera,1979-05-02,17,2001,2018,"EDM,CBJ,WSH,NYI,ANA"
Brett Connolly,1992-05-02,8,2012,2020,"TBL,BOS,WSH,FLA"
Paul Evans,1954-05-02,4,1979,1983,PHI
Jim Hargreaves,1950-05-02,2,1971,1973,VAN
Dave Hutchison,1952-05-02,9,1975,1984,"LAK,TOR,CBH,NJD"
Roman Lyashenko,1979-05-02,3,2000,2003,"DAL,NYR"
Tomas Mojzis,1982-05-02,3,2006,2009,"VAN,STL,MIN"
Brad Richards,1980-05-02,15,2001,2016,"TBL,DAL,NYR,CHI,DET"
Kris Russell,1987-05-02,12,2008,2020,"CBJ,STL,CGY,DAL,EDM"
Ryan Russell,1987-05-02,0,2012,2012,CBJ
Steve Stoyanovich,1957-05-02,0,1984,1984,HAR
Greg Terrion,1960-05-02,7,1981,1988,"LAK,TOR"
Kirk Tomlinson,1968-05-02,0,1988,1988,MNS
Mike Weaver,1978-05-02,13,2002,2015,"ATL,LAK,VAN,STL,FLA,MTL"
Adam Werner,1997-05-02,0,2020,2020,COL
Eric Beaudoin,1980-05-03,2,2002,2004,FLA
Reg Bentley,1914-05-03,0,1943,1943,CBH
Paul Boutilier,1963-05-03,7,1982,1989,"NYI,BOS,MNS,NYR,WIN"
John Carter,1963-05-03,7,1986,1993,"BOS,SJS"
Jeff Chychrun,1966-05-03,7,1987,1994,"PHI,LAK,PIT,EDM"
Alain Cote,1957-05-03,9,1980,1989,QUE
Troy Crowder,1968-05-03,7,1990,1997,"NJD,DET,LAK,VAN"
Ted Crowley,1970-05-03,5,1994,1999,"HAR,COL,NYI"
Bob Dailey,1953-05-03,8,1974,1982,"VAN,PHI"
Scott Fraser,1972-05-03,3,1996,1999,"MTL,EDM,NYR"
Joe Hall*,1881-05-03,1,1918,1919,MTL
Jeff Halpern,1976-05-03,14,2000,2014,"WSH,DAL,TBL,LAK,MTL,NYR,PHX"
Teemu Hartikainen,1990-05-03,2,2011,2013,EDM
Jukka Hentunen,1974-05-03,0,2002,2002,"CGY,NSH"
Ron Hextall,1964-05-03,12,1987,1999,"PHI,QUE,NYI"
Peter Ihnacak,1957-05-03,7,1983,1990,TOR
Jack Jackson,1925-05-03,0,1947,1947,CBH
David Jensen,1961-05-03,2,1984,1986,MNS
Kevin Kemp,1954-05-03,0,1981,1981,HAR
Vyacheslav Kozlov,1972-05-03,18,1992,2010,"DET,BUF,ATL"
Dick Lamby,1955-05-03,2,1979,1981,STL
Rod Langway*,1957-05-03,14,1979,1993,"MTL,WSH"
Anders Lindback,1988-05-03,5,2011,2016,"NSH,TBL,BUF,DAL,ARI"
Don MacIver,1955-05-03,0,1980,1980,WIN
Fern Majeau,1916-05-03,1,1944,1945,MTL
Brad Mills,1983-05-03,3,2011,2014,"NJD,CHI"
Robbie Moore,1954-05-03,4,1979,1983,"PHI,WSH"
Brendan Ranford,1992-05-03,0,2015,2015,DAL
Nico Sturm,1995-05-03,1,2019,2020,MIN
Billy Taylor,1919-05-03,8,1940,1948,"TOR,DET,BOS,NYR"
R.J. Umberger,1982-05-03,10,2006,2016,"PHI,CBJ"
Colton White,1997-05-03,1,2019,2020,NJD
Micah Aivazoff,1969-05-04,2,1994,1996,"DET,EDM,NYI"
Matthew Barnaby,1973-05-04,14,1993,2007,"BUF,PIT,TBL,NYR,COL,CHI,DAL"
Kyle Baun,1992-05-04,1,2015,2016,CHI
Aaron Dell,1989-05-04,3,2017,2020,SJS
Devan Dubnyk,1986-05-04,10,2010,2020,"EDM,NSH,ARI,MIN"
David Gove,1978-05-04,1,2006,2007,CAR
Joe Hicketts,1996-05-04,2,2018,2020,DET
Kent Huskins,1979-05-04,6,2007,2013,"ANA,SJS,STL,DET,PHI"
George Konik,1937-05-04,0,1968,1968,PIT
Larry Landon,1958-05-04,1,1984,1985,"MTL,TOR"
John Madden,1973-05-04,13,1999,2012,"NJD,CHI,MIN,FLA"
Seth Martin,1933-05-04,0,1968,1968,STL
Art Michaluk,1923-05-04,0,1948,1948,CBH
Andrew Raycroft,1980-05-04,11,2001,2012,"BOS,TOR,COL,VAN,DAL"
Leon Rochefort,1939-05-04,15,1961,1976,"NYR,MTL,PHI,LAK,DET,ATF,VAN"
Derek Roy,1983-05-04,11,2004,2015,"BUF,DAL,VAN,STL,EDM,NSH"
Thomas Rundqvist,1960-05-04,0,1985,1985,MTL
Don Smith,1929-05-04,0,1950,1950,NYR
Fred Stanfield,1944-05-04,13,1965,1978,"CBH,BOS,MNS,BUF"
John Stevens,1966-05-04,7,1987,1994,"PHI,HAR"
Kevin Todd,1968-05-04,9,1989,1998,"NJD,EDM,CHI,LAK,MDA"
John Tripp,1977-05-04,1,2003,2004,"NYR,LAK"
James van Riemsdyk,1989-05-04,10,2010,2020,"PHI,TOR"
Sean Whyte,1970-05-04,1,1992,1993,LAK
Russ Adam,1961-05-05,0,1983,1983,TOR
John Adams,1920-05-05,0,1941,1941,MTL
Bruce Affleck,1954-05-05,9,1975,1984,"STL,VAN,NYI"
Brad Bombardir,1972-05-05,6,1998,2004,"NJD,MIN,NSH"
Dmitri Bykov,1977-05-05,0,2003,2003,DET
Jim Conacher,1921-05-05,7,1946,1953,"DET,CBH,NYR"
Kyle Criscuolo,1992-05-05,0,2018,2018,BUF
Johan Hedberg,1973-05-05,12,2001,2013,"PIT,VAN,DAL,ATL,NJD"
Grant Jennings,1965-05-05,7,1989,1996,"HAR,PIT,TOR,BUF"
Justin Johnson,1981-05-05,0,2014,2014,NYI
Duane Joyce,1965-05-05,0,1994,1994,DAL
Klim Kostin,1999-05-05,0,2020,2020,STL
Darcy Kuemper,1990-05-05,7,2013,2020,"MIN,ARI,LAK"
Jordan Kyrou,1998-05-05,1,2019,2020,STL
Willy Lindstrom,1951-05-05,7,1980,1987,"WIN,EDM,PIT"
Matt Luff,1997-05-05,1,2019,2020,LAK
Josh Mahura,1998-05-05,1,2019,2020,ANA
Mitch Marner,1997-05-05,3,2017,2020,TOR
Joshua Norris,1999-05-05,0,2020,2020,OTT
Ziggy Palffy,1972-05-05,12,1994,2006,"NYI,LAK,PIT"
Andrew Peters,1980-05-05,6,2004,2010,"BUF,NJD"
Rickard Rakell,1993-05-05,7,2013,2020,ANA
Mikael Renberg,1972-05-05,10,1994,2004,"PHI,TBL,PHX,TOR"
Florent Robidoux,1960-05-05,3,1981,1984,CBH
Randy Skarda,1968-05-05,2,1990,1992,STL
Radovan Somik,1977-05-05,1,2003,2004,PHI
Mike Stapleton,1966-05-05,14,1987,2001,"CHI,PIT,EDM,WIN,PHX,ATL,NYI,VAN"
Pavel Vorobiev,1982-05-05,2,2004,2006,CHI
Anton Babchuk,1984-05-06,9,2004,2013,"CHI,CAR,CGY"
Steve Baker,1957-05-06,3,1980,1983,NYR
Bob Bassen,1965-05-06,14,1986,2000,"NYI,CHI,STL,QUE,DAL,CGY"
Eric Boguniecki,1975-05-06,7,2000,2007,"FLA,STL,PIT,NYI"
Tim Bothwell,1955-05-06,10,1979,1989,"NYR,STL,HAR"
Martin Brodeur*,1972-05-06,23,1992,2015,"NJD,STL"
Adam Brooks,1996-05-06,0,2020,2020,TOR
Keith Brown,1960-05-06,15,1980,1995,"CBH,CHI,FLA"
Marc Chouinard,1977-05-06,6,2001,2007,"MDA,MIN,VAN"
Norm Collings,1910-05-06,0,1935,1935,MTL
Mark Eaton,1977-05-06,13,2000,2013,"PHI,NSH,PIT,NYI"
Garry Edmundson,1932-05-06,9,1952,1961,"MTL,TOR"
Brendan Gallagher,1992-05-06,7,2013,2020,MTL
Fred Gordon,1900-05-06,1,1927,1928,"DTC,BOS"
Bob Gryp,1950-05-06,2,1974,1976,"BOS,WSH"
Bert McInenly,1906-05-06,5,1931,1936,"DTF,NYA,OTS,BOS"
Jon Morris,1966-05-06,5,1989,1994,"NJD,SJS,BOS"
Ryan Savoia,1973-05-06,0,1999,1999,PIT
Jonas Siegenthaler,1997-05-06,1,2019,2020,WSH
Fredrik Sjostrom,1983-05-06,7,2004,2011,"PHX,NYR,CGY,TOR"
Jack Stewart*,1917-05-06,13,1939,1952,"DET,CBH"
Harry Watson*,1923-05-06,15,1942,1957,"BRO,DET,TOR,CBH"
Josh Anderson,1994-05-07,5,2015,2020,CBJ
Tony Cassolato,1956-05-07,2,1980,1982,WSH
Tim Connolly,1981-05-07,12,2000,2012,"NYI,BUF,TOR"
Tom Cook,1907-05-07,8,1930,1938,"CBH,MTM"
Del Hall,1949-05-07,2,1972,1974,CGS
Brad Isbister,1977-05-07,10,1998,2008,"PHX,NYI,EDM,BOS,NYR,VAN"
Dave Karpa,1971-05-07,11,1992,2003,"QUE,MDA,CAR,NYR"
Anton Khudobin,1986-05-07,10,2010,2020,"MIN,BOS,CAR,ANA,DAL"
Guillaume Lefebvre,1981-05-07,8,2002,2010,"PHI,PIT,BOS"
Reg Mackey,1900-05-07,0,1927,1927,NYR
Ian McKegney,1947-05-07,0,1977,1977,CBH
Lars Molin,1956-05-07,2,1982,1984,VAN
Filip Novak,1982-05-07,1,2006,2007,"OTT,CBJ"
Lawrence Nycholat,1979-05-07,5,2004,2009,"NYR,OTT,WSH,COL,VAN"
Serge Payer,1979-05-07,6,2001,2007,"FLA,OTT"
Nate Prosser,1986-05-07,9,2010,2019,"MIN,STL"
Jesse Puljujarvi,1998-05-07,2,2017,2019,EDM
Steve Reinprecht,1976-05-07,11,2000,2011,"LAK,COL,CGY,PHX,FLA"
Terry Richardson,1953-05-07,5,1974,1979,"DET,STL"
Chad Ruhwedel,1990-05-07,7,2013,2020,"BUF,PIT"
David Schlemko,1987-05-07,10,2009,2019,"PHX,ARI,CGY,DAL,NJD,SJS,MTL"
Ted Tucker,1949-05-07,0,1974,1974,CGS
Vitaly Abramov,1998-05-08,1,2019,2020,OTT
Chris Allen,1978-05-08,1,1998,1999,FLA
Ed Chadwick,1933-05-08,6,1956,1962,"TOR,BOS"
Lars Eller,1989-05-08,10,2010,2020,"STL,MTL,WSH"
Herb Gardiner*,1891-05-08,2,1927,1929,"MTL,CBH"
Eric Gelinas,1991-05-08,4,2013,2017,"NJD,COL"
Casey Hankinson,1976-05-08,3,2001,2004,"CHI,MDA"
Kevin Hayes,1992-05-08,5,2015,2020,"NYR,WPG,PHI"
Eddie Joyal,1940-05-08,9,1963,1972,"DET,TOR,LAK,PHI"
Corey Locke,1984-05-08,3,2008,2011,"MTL,NYR,OTT"
John Mariucci*,1916-05-08,7,1941,1948,CBH
Jussi Markkanen,1975-05-08,5,2002,2007,"EDM,NYR"
Matt Martin,1989-05-08,10,2010,2020,"NYI,TOR"
Peter McNab,1952-05-08,13,1974,1987,"BUF,BOS,VAN,NJD"
Marcus Pettersson,1996-05-08,2,2018,2020,"ANA,PIT"
Jack Price,1932-05-08,2,1952,1954,CBH
Darren Reid,1983-05-08,1,2006,2007,"TBL,PHI"
Cully Simon,1918-05-08,2,1943,1945,"DET,CBH"
Ken Smith,1924-05-08,6,1945,1951,BOS
Dave Tomlinson,1969-05-08,3,1992,1995,"TOR,WIN,FLA"
Ray Whitney,1972-05-08,22,1992,2014,"SJS,EDM,FLA,CBJ,DET,CAR,PHX,DAL"
Rick Zombo,1963-05-08,11,1985,1996,"DET,STL,BOS"
Danny Belisle,1937-05-09,0,1961,1961,NYR
Stan Brown,1898-05-09,1,1927,1928,"NYR,DTC"
Gordie Bruce,1919-05-09,5,1941,1946,BOS
Bruce Bullock,1949-05-09,4,1973,1977,VAN
Ben Chiarot,1991-05-09,6,2014,2020,"WPG,MTL"
Joe Cirella,1963-05-09,14,1982,1996,"CLR,NJD,QUE,NYR,FLA,OTT"
Calvin de Haan,1991-05-09,8,2012,2020,"NYI,CAR,CHI"
Matt Donovan,1990-05-09,7,2012,2019,"NYI,NSH"
Vernon Fiddler,1980-05-09,14,2003,2017,"NSH,PHX,DAL,NJD"
Tony Graboski,1916-05-09,2,1941,1943,MTL
Bruce Greig,1953-05-09,1,1974,1975,CGS
Brent Grieve,1969-05-09,3,1994,1997,"EDM,NYI,CHI,LAK"
Jordan Gross,1995-05-09,0,2020,2020,ARI
Dillon Heatherington,1995-05-09,1,2018,2019,DAL
Mark Katic,1989-05-09,0,2011,2011,NYI
Riley Nash,1989-05-09,8,2012,2020,"CAR,BOS,CBJ"
Kraig Nienhuis,1961-05-09,2,1986,1988,BOS
Alex Plante,1989-05-09,2,2010,2012,EDM
Andrej Podkonicky,1978-05-09,3,2001,2004,"FLA,WSH"
John Schella,1947-05-09,1,1971,1972,VAN
Steve Self,1950-05-09,0,1977,1977,WSH
Ken Strong,1963-05-09,2,1983,1985,TOR
Mark Tinordi,1966-05-09,11,1988,1999,"NYR,MNS,DAL,WSH"
Tony Twist,1968-05-09,9,1990,1999,"STL,QUE"
Brian Wesenberg,1977-05-09,0,1999,1999,PHI
Archie Wilcox,1903-05-09,5,1930,1935,"MTM,BOS,STE"
Stephane Yelle,1974-05-09,14,1996,2010,"COL,CGY,BOS,CAR"
Steve Yzerman*,1965-05-09,22,1984,2006,DET
Mikael Andersson,1966-05-10,14,1986,2000,"BUF,HAR,TBL,PHI,NYI"
Nicolas Aube-Kubel,1996-05-10,1,2019,2020,PHI
Pete Babando,1925-05-10,5,1948,1953,"BOS,DET,CBH,NYR"
Randy Cunneyworth,1961-05-10,18,1981,1999,"BUF,PIT,HAR,WIN,CHI,OTT"
Adam Deadmarsh,1975-05-10,8,1995,2003,"QUE,COL,LAK"
Mark Dekanich,1986-05-10,0,2011,2011,NSH
Ab DeMarco,1916-05-10,8,1939,1947,"CBH,BOS,TOR,NYR"
Murray Eaves,1960-05-10,9,1981,1990,"WIN,DET"
Ryan Getzlaf,1985-05-10,14,2006,2020,"MDA,ANA"
Steve Gotaas,1967-05-10,3,1988,1991,"PIT,MNS"
Lloyd Gronsdahl,1921-05-10,0,1942,1942,BOS
Richard Hajdu,1965-05-10,1,1986,1987,BUF
Denis Hamel,1977-05-10,7,2000,2007,"BUF,OTT,ATL,PHI"
Tim Harrer,1957-05-10,0,1983,1983,CGY
Gordie Nelson,1947-05-10,0,1970,1970,TOR
Charlie Phillips,1917-05-10,0,1943,1943,MTL
Carter Rowney,1989-05-10,3,2017,2020,"PIT,ANA"
Al Shields,1907-05-10,10,1928,1938,"OTS,PHQ,NYA,MTM,BOS"
Alex Tuch,1996-05-10,3,2017,2020,"MIN,VEG"
Lloyd Ailsby,1917-05-11,0,1952,1952,NYR
Francis Breault,1967-05-11,2,1991,1993,LAK
Kevin Brown,1974-05-11,5,1995,2000,"LAK,HAR,CAR,EDM"
Joe Day,1968-05-11,2,1992,1994,"HAR,NYI"
Per Djoos,1968-05-11,2,1991,1993,"DET,NYR"
Jim Fahey,1979-05-11,4,2003,2007,"SJS,NJD"
Anatoli Fedotov,1966-05-11,1,1993,1994,"WIN,MDA"
Farrand Gillie,1905-05-11,0,1929,1929,DTC
Adin Hill,1996-05-11,2,2018,2020,ARI
Dutch Hiller,1915-05-11,8,1938,1946,"NYR,BOS,DET,MTL"
Billy Inglis,1943-05-11,3,1968,1971,"LAK,BUF"
Ian Kidd,1964-05-11,1,1988,1989,VAN
Dieter Kochan,1974-05-11,3,2000,2003,"TBL,MIN"
Tim Lenardon,1962-05-11,3,1987,1990,"NJD,VAN"
Brad Marchand,1988-05-11,10,2010,2020,BOS
Jean Marois,1924-05-11,10,1944,1954,"TOR,CBH"
Tom Martin,1964-05-11,5,1985,1990,"WIN,HAR,MNS"
Joe McDonnell,1961-05-11,4,1982,1986,"VAN,PIT"
Todd Nelson,1969-05-11,2,1992,1994,"PIT,WSH"
Ulf Nilsson,1950-05-11,4,1979,1983,NYR
Colin Patterson,1960-05-11,9,1984,1993,"CGY,BUF"
Janne Pesonen,1982-05-11,0,2009,2009,PIT
Mike Rathje,1974-05-11,13,1994,2007,"SJS,PHI"
Craig Reichert,1974-05-11,0,1997,1997,MDA
George Robertson,1928-05-11,1,1948,1949,MTL
Bryan Rust,1992-05-11,5,2015,2020,PIT
Jimmy Schuldt,1995-05-11,0,2019,2019,VEG
Jordan Smotherman,1986-05-11,1,2008,2009,ATL
Greg Tebbutt,1957-05-11,4,1980,1984,"QUE,PIT"
Ryan Thang,1987-05-11,0,2012,2012,NSH
Rinat Valiev,1995-05-11,2,2016,2018,"TOR,MTL"
Ben Walter,1984-05-11,4,2006,2010,"BOS,NYI,NJD"
Jim Watt,1950-05-11,0,1974,1974,STL
Dmitry Afanasenkov,1980-05-12,6,2001,2007,"TBL,PHI"
Tim Armstrong,1967-05-12,0,1989,1989,TOR
Gavin Bayreuther,1994-05-12,0,2019,2019,DAL
John Bucyk*,1935-05-12,22,1956,1978,"DET,BOS"
Cummy Burton,1936-05-12,3,1956,1959,DET
Darcy Campbell,1984-05-12,0,2007,2007,CBJ
Dave Christian,1959-05-12,14,1980,1994,"WIN,WSH,BOS,STL,CHI"
Richie Dunn,1957-05-12,11,1978,1989,"BUF,CGY,HAR"
Bernie Federko*,1956-05-12,13,1977,1990,"STL,DET"
Samuel Girard,1998-05-12,2,2018,2020,"COL,NSH"
Bob Goldham,1922-05-12,14,1942,1956,"TOR,CBH,DET"
James Hughes,1906-05-12,0,1930,1930,DTC
Jakub Jerabek,1991-05-12,1,2018,2019,"MTL,WSH,STL"
Bracken Kearns,1981-05-12,5,2012,2017,"FLA,SJS,NYI"
David Koci,1981-05-12,4,2007,2011,"CHI,STL,TBL,COL"
Dwight Mathiasen,1963-05-12,2,1986,1988,PIT
Sonny Milano,1996-05-12,4,2016,2020,"CBJ,ANA"
Colton Parayko,1993-05-12,4,2016,2020,STL
Antti Raanta,1989-05-12,6,2014,2020,"CHI,NYR,ARI"
Warren Rychel,1967-05-12,10,1989,1999,"CHI,LAK,TOR,COL,MDA"
Daniel Shank,1967-05-12,2,1990,1992,"DET,HAR"
Chris Snell,1971-05-12,1,1994,1995,"TOR,LAK"
Dollard St. Laurent,1929-05-12,11,1951,1962,"MTL,CBH"
Viktor Tikhonov,1988-05-12,7,2009,2016,"PHX,ARI,CHI"
Derrick Walser,1978-05-12,5,2002,2007,CBJ
Sherman White,1923-05-12,3,1947,1950,NYR
Jamie Allison,1975-05-13,11,1995,2006,"CGY,CHI,CBJ,NSH,FLA"
Michael Amadio,1996-05-13,2,2018,2020,LAK
Bill Arnold,1992-05-13,0,2014,2014,CGY
Mark Beaufait,1970-05-13,0,1993,1993,SJS
Taylor Beck,1991-05-13,4,2013,2017,"NSH,NYI,EDM,NYR"
Jared Boll,1986-05-13,10,2008,2018,"CBJ,ANA"
Mike Chernoff,1946-05-13,0,1969,1969,MNS
Jozef Cierny,1974-05-13,0,1994,1994,EDM
Babe Dye*,1898-05-13,11,1920,1931,"TRS,HAM,CBH,NYA,TOR"
John English,1966-05-13,0,1988,1988,LAK
Jeff Frazee,1987-05-13,0,2013,2013,NJD
Matt Greene,1983-05-13,11,2006,2017,"EDM,LAK"
Jaroslav Halak,1985-05-13,13,2007,2020,"MTL,STL,WSH,NYI,BOS"
Bill Heindl,1946-05-13,2,1971,1973,"MNS,NYR"
Albert Hughes,1901-05-13,1,1931,1932,NYA
Tomas Malec,1982-05-13,4,2003,2007,"CAR,OTT"
Anton Slepyshev,1994-05-13,2,2016,2018,EDM
D.J. Smith,1977-05-13,6,1997,2003,"TOR,COL"
Trevor Stienburg,1966-05-13,3,1986,1989,QUE
Mark Stone,1992-05-13,7,2013,2020,"OTT,VEG"
P.K. Subban,1989-05-13,10,2010,2020,"MTL,NSH,NJD"
Darryl Sydor,1972-05-13,18,1992,2010,"LAK,DAL,CBJ,TBL,PIT,STL"
Ryan Tobler,1976-05-13,0,2002,2002,TBL
Petri Varis,1969-05-13,0,1998,1998,CHI
Kris Versteeg,1986-05-13,10,2008,2018,"CHI,PHI,TOR,FLA,CAR,LAK,CGY"
Hub Wilson,1909-05-13,0,1932,1932,NYA
Ron Wilson,1956-05-13,14,1980,1994,"WIN,STL,MTL"
Jamie Wright,1976-05-13,5,1998,2003,"DAL,CGY,PHI"
Travis Zajac,1985-05-13,13,2007,2020,NJD
Peter Ahola,1968-05-14,2,1992,1994,"LAK,PIT,SJS,CGY"
Justin Auger,1994-05-14,0,2018,2018,LAK
Ken Belanger,1974-05-14,11,1995,2006,"TOR,NYI,BOS,LAK"
Louis Belpedio,1996-05-14,1,2018,2019,MIN
Don Blackburn,1938-05-14,10,1963,1973,"BOS,PHI,NYR,MNS,NYI"
Ed Cristofoli,1967-05-14,0,1990,1990,MTL
Morgan Frost,1999-05-14,0,2020,2020,PHI
Danny Gare,1954-05-14,12,1975,1987,"BUF,DET,EDM"
Jack Hughes,2001-05-14,0,2020,2020,NJD
Cory Larose,1975-05-14,0,2004,2004,NYR
Pierre Plante,1951-05-14,8,1972,1980,"PHI,STL,CBH,NYR,QUE"
Steve Seftel,1968-05-14,0,1991,1991,WSH
Jordan Szwarz,1991-05-14,6,2014,2020,"PHX,ARI,BOS,OTT"
Steve Tambellini,1958-05-14,9,1979,1988,"NYI,CLR,NJD,CGY,VAN"
Rick Vaive,1959-05-14,12,1980,1992,"TOR,VAN,CHI,BUF"
Mike Van Ryn,1979-05-14,8,2001,2009,"STL,FLA,TOR"
Alain Vigneault,1961-05-14,1,1982,1983,STL
Gump Worsley*,1929-05-14,21,1953,1974,"NYR,MTL,MNS"
Doug Acomb,1949-05-15,0,1970,1970,TOR
Bill Boyd,1898-05-15,3,1927,1930,"NYR,NYA"
Turk Broda*,1914-05-15,15,1937,1952,TOR
Cam Brown,1969-05-15,0,1991,1991,VAN
Brett Callighen,1953-05-15,2,1980,1982,EDM
Andre Corriveau,1928-05-15,0,1954,1954,MTL
Jeff Deslauriers,1984-05-15,3,2009,2012,"EDM,ANA"
Jordan Eberle,1990-05-15,9,2011,2020,"EDM,NYI"
Mark Fayne,1987-05-15,6,2011,2017,"NJD,EDM"
Mike Halmo,1991-05-15,0,2014,2014,NYI
Johan Harju,1986-05-15,0,2011,2011,TBL
Jim Hay,1931-05-15,2,1953,1955,DET
Tony Hemmerling,1914-05-15,1,1936,1937,NYA
Pat Hickey,1953-05-15,9,1976,1985,"NYR,CLR,TOR,QUE,STL"
Jim Hiller,1969-05-15,1,1993,1994,"DET,LAK,NYR"
Nick Holden,1987-05-15,9,2011,2020,"CBJ,COL,NYR,BOS,VEG"
Dave Langevin,1954-05-15,7,1980,1987,"NYI,MNS,LAK"
Drew Larman,1985-05-15,3,2007,2010,"FLA,BOS"
Jim Mair,1946-05-15,4,1971,1975,"PHI,NYI,VAN"
Jack Markle,1907-05-15,0,1936,1936,TOR
Chris O'Sullivan,1974-05-15,6,1997,2003,"CGY,VAN,MDA"
Dave Reid,1964-05-15,17,1984,2001,"BOS,TOR,DAL,COL"
Jaroslav Sevcik,1965-05-15,0,1990,1990,QUE
Patrick Sieloff,1994-05-15,2,2016,2018,"CGY,OTT"
Wes Walz,1970-05-15,18,1990,2008,"BOS,PHI,CGY,DET,MIN"
Paul Ysebaert,1966-05-15,10,1989,1999,"NJD,DET,CHI,WIN,TBL"
Valentin Zykov,1995-05-15,3,2017,2020,"CAR,EDM,VEG"
Les Auge,1953-05-16,0,1981,1981,CLR
Robin Bartel,1961-05-16,1,1986,1987,"CGY,VAN"
Adam Berkhoel,1981-05-16,0,2006,2006,ATL
Tomas Fleischmann,1984-05-16,10,2006,2016,"WSH,COL,FLA,ANA,CHI,MTL"
Scott Garland,1952-05-16,3,1976,1979,"TOR,LAK"
Jean-Sebastien Giguere,1977-05-16,17,1997,2014,"HAR,CGY,MDA,ANA,TOR,COL"
Mikhail Grigorenko,1994-05-16,4,2013,2017,"BUF,COL"
Matt Hervey,1968-05-16,4,1989,1993,"WIN,BOS,TBL"
John Jakopin,1975-05-16,5,1998,2003,"FLA,PIT,SJS"
Matt Koalska,1980-05-16,0,2006,2006,NYI
Steve Lyon,1952-05-16,0,1977,1977,PIT
Jeff Mitchell,1975-05-16,0,1998,1998,DAL
Corey Perry,1985-05-16,14,2006,2020,"MDA,ANA,DAL"
Hugh Plaxton,1904-05-16,0,1933,1933,MTM
Michael Ryan,1980-05-16,2,2007,2009,"BUF,CAR"
Rick Rypien,1984-05-16,5,2006,2011,VAN
Jeff Skinner,1992-05-16,9,2011,2020,"CAR,BUF"
Floyd Smith,1935-05-16,17,1955,1972,"BOS,NYR,DET,TOR,BUF"
John Stewart,1950-05-16,4,1971,1975,"PIT,ATF,CGS"
Kyle Wellwood,1983-05-16,9,2004,2013,"TOR,VAN,SJS,WPG"
Jeff Allan,1957-05-17,0,1978,1978,CLE
Andy Andreoff,1991-05-17,5,2015,2020,"LAK,PHI"
George Brown,1912-05-17,2,1937,1939,MTL
Al Buchanan,1927-05-17,1,1949,1950,TOR
Martin Cibak,1980-05-17,4,2002,2006,TBL
Jim Cummins,1970-05-17,12,1992,2004,"DET,PHI,TBL,CHI,PHX,MTL,MDA,NYI,COL"
Daniel Gauthier,1970-05-17,0,1995,1995,CHI
John Gilmour,1993-05-17,2,2018,2020,"NYR,BUF"
Dane Jackson,1970-05-17,4,1994,1998,"VAN,BUF,NYI"
Claude Larose,1955-05-17,0,1980,1980,NYR
Bill Lindsay,1971-05-17,12,1992,2004,"QUE,FLA,CGY,SJS,MTL,ATL"
Carl Liscombe,1915-05-17,8,1938,1946,DET
Ed Panagabko,1934-05-17,1,1956,1957,BOS
Mike Prokopec,1974-05-17,1,1996,1997,CHI
Nate Raduns,1984-05-17,0,2009,2009,PHI
Brent Regner,1989-05-17,0,2016,2016,FLA
Doug Smith,1963-05-17,8,1982,1990,"LAK,BUF,EDM,VAN,PIT"
Per Svartvadet,1975-05-17,3,2000,2003,ATL
Brent Ashton,1960-05-18,13,1980,1993,"VAN,CLR,NJD,MNS,QUE,DET,WIN,BOS,CGY"
John Baby,1957-05-18,1,1978,1979,"CLE,MNS"
Bobby Benson,1894-05-18,0,1925,1925,BOS
Rick Boh,1964-05-18,0,1988,1988,MNS
Rene Boileau,1904-05-18,0,1926,1926,NYA
John Chabot,1962-05-18,7,1984,1991,"MTL,PIT,DET"
Kaspars Daugavins,1988-05-18,3,2010,2013,"OTT,BOS"
Chris Driedger,1994-05-18,5,2015,2020,"OTT,FLA"
Justin Florek,1990-05-18,0,2014,2014,BOS
Tom Fowler,1924-05-18,0,1947,1947,CBH
Jim Fox,1960-05-18,9,1981,1990,LAK
Matt Foy,1983-05-18,2,2006,2008,MIN
Dan Fridgen,1959-05-18,1,1982,1983,HAR
Ron Hurst,1931-05-18,1,1956,1957,TOR
Bob Janecyk,1957-05-18,5,1984,1989,"CBH,LAK"
Jason Kasdorf,1992-05-18,0,2016,2016,BUF
Jari Kurri*,1960-05-18,17,1981,1998,"EDM,LAK,NYR,MDA,COL"
Manny Malhotra,1980-05-18,16,1999,2015,"NYR,DAL,CBJ,SJS,VAN,CAR,MTL"
Marty McSorley,1963-05-18,16,1984,2000,"PIT,EDM,LAK,NYR,SJS,BOS"
Dave Michayluk,1962-05-18,1,1982,1983,PHI
Aaron Ness,1990-05-18,8,2012,2020,"NYI,WSH,ARI"
Stuart Percy,1993-05-18,1,2015,2016,TOR
John Persson,1992-05-18,0,2014,2014,NYI
Dave Pulkkinen,1949-05-18,0,1973,1973,NYI
Errol Rausse,1959-05-18,2,1980,1982,WSH
Turner Stevenson,1972-05-18,13,1993,2006,"MTL,NJD,PHI"
Hannu Toivonen,1984-05-18,2,2006,2008,"BOS,STL"
Oleg Tverdovsky,1976-05-18,12,1995,2007,"MDA,WIN,PHX,NJD,CAR,LAK"
Darren Van Impe,1973-05-18,8,1995,2003,"MDA,BOS,FLA,NYI,NYR,CBJ"
Jay Wells,1959-05-18,17,1980,1997,"LAK,PHI,BUF,NYR,STL,TBL"
Rod Zaine,1946-05-18,1,1971,1972,"PIT,BUF"
Denis Arkhipov,1979-05-19,6,2001,2007,"NSH,CHI"
Ivan Baranka,1985-05-19,0,2008,2008,NYR
Jason Botterill,1976-05-19,6,1998,2004,"DAL,ATL,CGY,BUF"
Marc Bureau,1966-05-19,10,1990,2000,"CGY,MNS,TBL,MTL,PHI"
Spencer Foo,1994-05-19,0,2018,2018,CGY
Connor Hellebuyck,1993-05-19,4,2016,2020,WPG
Bob Hess,1955-05-19,9,1975,1984,"STL,BUF,HAR"
Mark Janssens,1968-05-19,13,1988,2001,"NYR,MNS,HAR,MDA,NYI,PHX,CHI"
Hannu Jarvenpaa,1963-05-19,2,1987,1989,WIN
Andreas Johansson,1973-05-19,8,1996,2004,"NYI,PIT,OTT,CGY,TBL,NYR,NSH"
Evgeny Kuznetsov,1992-05-19,6,2014,2020,WSH
Oliver Kylington,1997-05-19,4,2016,2020,CGY
Milan Kytnar,1989-05-19,0,2012,2012,EDM
Bob LaForest,1963-05-19,0,1984,1984,LAK
Michael Leighton,1981-05-19,14,2003,2017,"CHI,NSH,PHI,CAR"
Brendan Leipsic,1994-05-19,4,2016,2020,"TOR,VAN,VEG,LAK,WSH"
Murray Murdoch,1904-05-19,10,1927,1937,NYR
Alex Shibicky,1914-05-19,10,1936,1946,NYR
Jack Skille,1987-05-19,9,2008,2017,"CHI,FLA,CBJ,COL,VAN"
Wayne Van Dorp,1961-05-19,5,1987,1992,"EDM,PIT,CHI,QUE"
Jeff Ware,1977-05-19,2,1997,1999,"TOR,FLA"
Dave Watson,1958-05-19,1,1980,1981,CLR
Carey Wilson,1962-05-19,9,1984,1993,"CGY,HAR,NYR"
Ty Wishart,1988-05-19,3,2009,2012,"TBL,NYI"
Niklas Andersson,1971-05-20,8,1993,2001,"QUE,NYI,SJS,NSH,CGY"
Bob Beers,1967-05-20,7,1990,1997,"BOS,TBL,EDM,NYI"
Dan Blackburn,1983-05-20,1,2002,2003,NYR
Lonny Bohonos,1973-05-20,3,1996,1999,"VAN,TOR"
Bruce Cassidy,1965-05-20,6,1984,1990,"CBH,CHI"
Jacob de La Rose,1995-05-20,5,2015,2020,"MTL,DET,STL"
Matt Fraser,1990-05-20,3,2012,2015,"DAL,BOS,EDM"
Stu Grimson,1965-05-20,13,1989,2002,"CGY,CHI,MDA,DET,HAR,CAR,LAK,NSH"
Dave Hoyda,1957-05-20,3,1978,1981,"PHI,WIN"
Cody Kunyk,1990-05-20,0,2014,2014,TBL
Yvon Lambert,1950-05-20,9,1973,1982,"MTL,BUF"
Brad Malone,1989-05-20,7,2012,2019,"COL,CAR,EDM"
Stan Mikita*,1940-05-20,21,1959,1980,CBH
Craig Patrick*,1946-05-20,7,1972,1979,"CGS,STL,KCS,WSH"
Jim Ross,1926-05-20,1,1952,1953,NYR
Kevin Roy,1993-05-20,1,2018,2019,ANA
David Saunders,1966-05-20,0,1988,1988,VAN
Vesa Toskala,1977-05-20,8,2002,2010,"SJS,TOR,CGY"
Jason York,1970-05-20,14,1993,2007,"DET,MDA,OTT,NSH,BOS"
Tommy Albelin,1964-05-21,18,1988,2006,"QUE,NJD,CGY"
Craig Anderson,1981-05-21,17,2003,2020,"CHI,FLA,COL,OTT"
Sylvain Blouin,1974-05-21,6,1997,2003,"NYR,MTL,MIN"
Niko Dimitrakos,1979-05-21,4,2003,2007,"SJS,PHI"
Alex Faulkner,1936-05-21,2,1962,1964,"TOR,DET"
Ryan Graves,1995-05-21,1,2019,2020,COL
Roman Horak,1991-05-21,2,2012,2014,"CGY,EDM"
Matt Hunwick,1985-05-21,11,2008,2019,"BOS,COL,NYR,TOR,PIT,BUF"
Udo Kiessling,1955-05-21,0,1982,1982,MNS
Kristian Kudroc,1981-05-21,3,2001,2004,"TBL,FLA"
Pat Lundy,1924-05-21,5,1946,1951,"DET,CBH"
John Marino,1997-05-21,0,2020,2020,PIT
Derek Mayer,1967-05-21,0,1994,1994,OTT
Bill Mikkelson,1948-05-21,5,1972,1977,"LAK,NYI,WSH"
Graham Mink,1979-05-21,5,2004,2009,WSH
Pat Neaton,1971-05-21,0,1994,1994,PIT
Kevin Rooney,1993-05-21,3,2017,2020,NJD
Luke Sellars,1981-05-21,0,2002,2002,ATL
Reid Simpson,1969-05-21,12,1992,2004,"PHI,MNS,NJD,CHI,TBL,STL,MTL,NSH,PIT"
Greg Stewart,1986-05-21,2,2008,2010,MTL
Roman Turek,1970-05-21,7,1997,2004,"DAL,STL,CGY"
Patrick Wey,1991-05-21,0,2014,2014,WSH
Todd White,1975-05-21,13,1998,2011,"CHI,PHI,OTT,MIN,ATL,NYR"
Alexei Yegorov,1975-05-21,1,1996,1997,SJS
Lude Check,1918-05-22,1,1944,1945,"DET,CBH"
Chuck Corrigan,1916-05-22,3,1938,1941,"TOR,NYA"
Wayne Hall,1939-05-22,0,1961,1961,NYR
Greg Jacina,1982-05-22,1,2006,2007,FLA
Pete Kelly,1913-05-22,7,1935,1942,"STE,DET,NYA,BRO"
Evan McEneny,1994-05-22,0,2017,2017,VAN
Barrie Moore,1975-05-22,4,1996,2000,"BUF,EDM,WSH"
Andrei Nazarov,1974-05-22,12,1994,2006,"SJS,TBL,CGY,BOS,MDA,PHX,MIN"
Janne Niinimaa,1975-05-22,10,1997,2007,"PHI,EDM,NYI,DAL,MTL"
George Patterson,1906-05-22,8,1927,1935,"TOR,MTL,NYA,BOS,DET,STE"
Perry Pelensky,1962-05-22,0,1984,1984,CBH
Jim Playfair,1964-05-22,5,1984,1989,"EDM,CHI"
Marc Pouliot,1985-05-22,6,2006,2012,"EDM,TBL,PHX"
Rich Preston,1952-05-22,7,1980,1987,"CBH,NJD,CHI"
Jussi Rynnas,1987-05-22,3,2012,2015,"TOR,DAL"
Roman Will,1992-05-22,0,2016,2016,COL
Dave Babych,1961-05-23,18,1981,1999,"WIN,HAR,VAN,PHI,LAK"
Jeff Buchanan,1971-05-23,0,1999,1999,COL
Brian Campbell,1979-05-23,17,2000,2017,"BUF,SJS,CHI,FLA"
Dolly Dolson,1897-05-23,2,1929,1931,"DTC,DTF"
Ed Finnigan,1913-05-23,1,1935,1936,"STE,BOS"
Jansen Harkins,1997-05-23,0,2020,2020,WPG
Bryan Hextall,1941-05-23,13,1963,1976,"NYR,PIT,ATF,DET,MNS"
John Hilworth,1957-05-23,2,1978,1980,DET
Rick Hodgson,1956-05-23,0,1980,1980,HAR
David LeNeveu,1983-05-23,5,2006,2011,"PHX,CBJ"
Esa Lindell,1994-05-23,4,2016,2020,DAL
Pete LoPresti,1954-05-23,6,1975,1981,"MNS,EDM"
Curtis McElhinney,1983-05-23,12,2008,2020,"CGY,ANA,OTT,PHX,CBJ,TOR,CAR,TBL"
Nicholas Merkley,1997-05-23,2,2018,2020,"ARI,NJD"
Adam Pineault,1986-05-23,0,2008,2008,CBJ
Ken Quinney,1965-05-23,4,1987,1991,QUE
Gary Roberts,1966-05-23,22,1987,2009,"CGY,CAR,TOR,FLA,PIT,TBL"
Tom Rowe,1956-05-23,6,1977,1983,"WSH,HAR,DET"
Vic Stasiuk,1929-05-23,13,1950,1963,"CBH,DET,BOS"
Johnathan Aitken,1978-05-24,4,2000,2004,"BOS,CHI"
Kent-Erik Andersson,1951-05-24,6,1978,1984,"MNS,NYR"
Artem Anisimov,1988-05-24,11,2009,2020,"NYR,CBJ,CHI,OTT"
Edmond Bouchard,1892-05-24,7,1922,1929,"MTL,HAM,NYA,PTP"
Jack Church,1915-05-24,7,1939,1946,"TOR,BRO,BOS"
Lionel Conacher*,1901-05-24,11,1926,1937,"PTP,NYA,MTM,CBH"
Xavier Delisle,1977-05-24,2,1999,2001,"TBL,MTL"
John Doran,1911-05-24,6,1934,1940,"NYA,DET,MTL"
Kris Draper,1971-05-24,20,1991,2011,"WIN,DET"
Cody Eakin,1991-05-24,8,2012,2020,"WSH,DAL,VEG,WPG"
Mattias Ekholm,1990-05-24,8,2012,2020,NSH
Brian Eklund,1980-05-24,0,2006,2006,TBL
Bruce Gamble,1938-05-24,13,1959,1972,"NYR,BOS,TOR,PHI"
Dan Hinton,1953-05-24,0,1977,1977,CBH
Johan Holmqvist,1978-05-24,7,2001,2008,"NYR,TBL,DAL"
Guillaume Latendresse,1987-05-24,6,2007,2013,"MTL,MIN,OTT"
Alain Lemieux,1961-05-24,5,1982,1987,"STL,QUE,PIT"
Pelle Lindbergh,1959-05-24,4,1982,1986,PHI
Norm Locking,1911-05-24,1,1935,1936,CBH
Brennan Menell,1997-05-24,0,2020,2020,MIN
Maxim Noreau,1987-05-24,1,2010,2011,MIN
Vladimir Orszagh,1977-05-24,8,1998,2006,"NYI,NSH,STL"
Ville Peltonen,1973-05-24,13,1996,2009,"SJS,NSH,FLA"
Merlyn Phillips,1899-05-24,7,1926,1933,"MTM,NYA"
Zach Sill,1988-05-24,2,2014,2016,"PIT,TOR,WSH"
Viktor Svedberg,1991-05-24,0,2016,2016,CHI
Pat Verbeek,1964-05-24,19,1983,2002,"NJD,HAR,NYR,DAL,DET"
Russ Walker,1953-05-24,1,1977,1978,LAK
Michael Anderson,1999-05-25,0,2020,2020,LAK
Matt Benning,1994-05-25,3,2017,2020,EDM
Kyle Brodziak,1984-05-25,13,2006,2019,"EDM,MIN,STL"
Wayne Dillon,1955-05-25,4,1976,1980,"NYR,WIN"
Nikita Filatov,1990-05-25,3,2009,2012,"CBJ,OTT"
Nick Fotiu,1952-05-25,12,1977,1989,"NYR,HAR,CGY,PHI,EDM"
Pat Graham,1961-05-25,2,1982,1984,"PIT,TOR"
Jon Kalinski,1987-05-25,1,2009,2010,PHI
Dan Keczmer,1968-05-25,9,1991,2000,"MNS,HAR,CGY,DAL,NSH"
Joel Kellman,1994-05-25,0,2020,2020,SJS
Janne Kuokkanen,1998-05-25,2,2018,2020,"CAR,NJD"
Michael Latta,1991-05-25,2,2014,2016,WSH
Mickey MacKay*,1894-05-25,3,1927,1930,"CBH,BOS,PTP"
Morris Mott,1946-05-25,2,1973,1975,CGS
Matt Murray,1994-05-25,4,2016,2020,PIT
Ric Nattress,1962-05-25,10,1983,1993,"MTL,STL,CGY,TOR,PHI"
David Pastrnak,1996-05-25,5,2015,2020,BOS
Robert Picard,1957-05-25,12,1978,1990,"WSH,MTL,TOR,WIN,QUE,DET"
Jim Riley,1895-05-25,0,1927,1927,"CBH,DTC"
David Shaw,1964-05-25,15,1983,1998,"QUE,NYR,EDM,MNS,BOS,TBL"
Brad Turner,1968-05-25,0,1992,1992,NYI
Rick Wamsley,1959-05-25,12,1981,1993,"MTL,STL,CGY,TOR"
Wally Wilson,1921-05-25,0,1948,1948,BOS
Andy Wozniewski,1980-05-25,4,2006,2010,"TOR,STL,BOS"
Mathew Barzal,1997-05-26,3,2017,2020,NYI
Louis Berlinguette,1887-05-26,8,1918,1926,"MTL,MTM,PTP"
Chad Billins,1989-05-26,0,2014,2014,CGY
Chris Clifford,1966-05-26,4,1985,1989,"CBH,CHI"
Lorne Ferguson,1930-05-26,9,1950,1959,"BOS,DET,CBH"
Steven Goertzen,1984-05-26,4,2006,2010,"CBJ,PHX,CAR"
Matt Herr,1976-05-26,4,1999,2003,"WSH,FLA,BOS"
Josh Leivo,1993-05-26,6,2014,2020,"TOR,VAN"
Junior Lessard,1980-05-26,2,2006,2008,"DAL,TBL"
Ron Meighan,1963-05-26,1,1982,1983,"MNS,PIT"
Ralph Nattrass,1925-05-26,3,1947,1950,CBH
Steven Rice,1971-05-26,7,1991,1998,"NYR,EDM,HAR,CAR"
Pat Riggin,1959-05-26,8,1980,1988,"ATF,CGY,WSH,BOS,PIT"
P.J. Stock,1975-05-26,6,1998,2004,"NYR,MTL,PHI,BOS"
Christian Thomas,1992-05-26,3,2013,2016,"NYR,MTL,ARI"
Mike Vernace,1986-05-26,2,2009,2011,"COL,TBL"
Jimmy Vesey,1993-05-26,3,2017,2020,"NYR,BUF"
Jim Bartlett,1932-05-27,6,1955,1961,"MTL,NYR,BOS"
Bob Charlebois,1944-05-27,0,1968,1968,MNS
Bobby Crawford,1960-05-27,2,1981,1983,"CLR,DET"
Evgeny Davydov,1967-05-27,3,1992,1995,"WIN,FLA,OTT"
Nic Dowd,1990-05-27,4,2016,2020,"LAK,VAN,WSH"
Chris Felix,1964-05-27,2,1989,1991,WSH
Jonathan Girard,1980-05-27,4,1999,2003,BOS
Adam Hauser,1980-05-27,0,2006,2006,LAK
Ike Hildebrand,1927-05-27,1,1954,1955,"CBH,NYR"
Darren Jensen,1960-05-27,1,1985,1986,PHI
Marcus Kruger,1990-05-27,8,2011,2019,"CHI,CAR"
Rick McCann,1944-05-27,7,1968,1975,DET
Nelson Nogier,1996-05-27,2,2017,2019,WPG
Ellard O'Brien,1930-05-27,0,1956,1956,BOS
Richard Park,1976-05-27,17,1995,2012,"PIT,MDA,PHI,MIN,VAN,NYI"
Ashton Sautner,1994-05-27,2,2018,2020,VAN
Andre Savage,1975-05-27,4,1999,2003,"BOS,PHI"
Ray Sheppard,1966-05-27,12,1988,2000,"BUF,NYR,DET,FLA,SJS,CAR"
Gaston Therrien,1960-05-27,2,1981,1983,QUE
Ed Van Impe,1940-05-27,10,1967,1977,"CBH,PHI,PIT"
Herbert Vasiljevs,1976-05-27,3,1999,2002,"FLA,ATL,VAN"
Ed Vokes,1909-05-27,0,1931,1931,CBH
Chris Wagner,1991-05-27,5,2015,2020,"ANA,COL,NYI,BOS"
Clarence Abel,1900-05-28,7,1927,1934,"NYR,CBH"
Reid Bailey,1956-05-28,3,1981,1984,"PHI,TOR,HAR"
Bob Bodak,1961-05-28,2,1988,1990,"CGY,HAR"
Conrad Bourcier,1915-05-28,0,1936,1936,MTL
Erik Cernak,1997-05-28,1,2019,2020,TBL
Terry Crisp,1943-05-28,11,1966,1977,"BOS,STL,NYI,PHI"
Marcel Fillion,1923-05-28,0,1945,1945,BOS
Doug Hicks,1955-05-28,8,1975,1983,"MNS,CBH,EDM,WSH"
Red Horner*,1909-05-28,11,1929,1940,TOR
Mark Howe*,1955-05-28,15,1980,1995,"HAR,PHI,DET"
Jim Hrivnak,1968-05-28,4,1990,1994,"WSH,WIN,STL"
Matt Hussey,1979-05-28,3,2004,2007,"PIT,DET"
Gary Inness,1949-05-28,7,1974,1981,"PIT,PHI,WSH"
Jack Lynch,1952-05-28,6,1973,1979,"PIT,DET,WSH"
Lou Marcon,1935-05-28,4,1959,1963,DET
Jim Moxey,1953-05-28,2,1975,1977,"CGS,CLE,LAK"
Kevin O'Shea,1947-05-28,2,1971,1973,"BUF,STL"
Pat Peake,1973-05-28,4,1994,1998,WSH
David Perron,1988-05-28,12,2008,2020,"STL,EDM,PIT,ANA,VEG"
Jean-Francois Quintin,1969-05-28,1,1992,1993,SJS
Jonathan Racine,1993-05-28,0,2014,2014,FLA
Brogan Rafferty,1995-05-28,0,2019,2019,VAN
Damian Rhodes,1969-05-28,11,1991,2002,"TOR,OTT,ATL"
David Roberts,1970-05-28,4,1994,1998,"STL,EDM,VAN"
Claudio Scremin,1968-05-28,1,1992,1993,SJS
Todd Simpson,1973-05-28,10,1996,2006,"CGY,FLA,PHX,MDA,OTT,CHI,MTL"
Ted Snell,1946-05-28,1,1974,1975,"PIT,DET,KCS"
Gord Strate,1935-05-28,2,1957,1959,DET
Errol Thompson,1950-05-28,10,1971,1981,"TOR,DET,PIT"
Ron Wilson,1955-05-28,10,1978,1988,"TOR,MNS"
Petteri Wirtanen,1986-05-28,0,2008,2008,ANA
Jason Allison,1975-05-29,12,1994,2006,"WSH,BOS,LAK,TOR"
Bob Bailey,1931-05-29,4,1954,1958,"TOR,CBH,DET"
Willie Brossart,1949-05-29,5,1971,1976,"PHI,TOR,WSH"
Patrick Brown,1992-05-29,5,2015,2020,"CAR,VEG"
Bill Carse,1914-05-29,3,1939,1942,"NYR,CBH"
Art Chapman,1906-05-29,9,1931,1940,"BOS,NYA"
Marc D'Amour,1961-05-29,3,1986,1989,"CGY,PHI"
Jason Dawe,1973-05-29,8,1994,2002,"BUF,NYI,MTL,NYR"
Nathan Horton,1985-05-29,10,2004,2014,"FLA,BOS,CBJ"
Mike Keane,1967-05-29,15,1989,2004,"MTL,COL,DAL,NYR,STL,VAN"
Claude Loiselle,1963-05-29,12,1982,1994,"DET,NJD,QUE,TOR,NYI"
Saku Maenalanen,1994-05-29,0,2019,2019,CAR
Steve Mason,1988-05-29,9,2009,2018,"CBJ,PHI,WPG"
Alyn McCauley,1977-05-29,9,1998,2007,"TOR,SJS,LAK"
Jim McCrimmon,1953-05-29,0,1975,1975,STL
Steve McKichan,1967-05-29,0,1991,1991,VAN
Jarmo Myllys,1965-05-29,3,1989,1992,"MNS,SJS"
Brian Noonan,1965-05-29,11,1988,1999,"CHI,NYR,STL,VAN,PHX"
Chris Porter,1984-05-29,7,2009,2016,"STL,MIN"
Moe Robinson,1957-05-29,0,1980,1980,MTL
Alex Smart,1918-05-29,0,1943,1943,MTL
Ken Thompson,1881-05-29,0,1918,1918,MTW
Nikolai Tsulygin,1975-05-29,0,1997,1997,MDA
Mike Bishai,1979-05-30,0,2004,2004,EDM
Kevin Boyle,1992-05-30,0,2019,2019,ANA
Rick Heinz,1955-05-30,4,1981,1985,"STL,VAN"
Wes Jarvis,1958-05-30,8,1980,1988,"WSH,MNS,LAK,TOR"
Greg Joly,1954-05-30,8,1975,1983,"WSH,DET"
Scott Laughton,1994-05-30,7,2013,2020,PHI
Jackie Leclair,1929-05-30,2,1955,1957,MTL
Francis Lessard,1979-05-30,9,2002,2011,"ATL,OTT"
Andrei Loktionov,1990-05-30,4,2010,2014,"LAK,NJD,CAR"
Eddie McCalmon,1902-05-30,3,1928,1931,"CBH,PHQ"
Vic Ripley,1906-05-30,6,1929,1935,"CBH,BOS,NYR,STE"
Jiri Slegr,1971-05-30,13,1993,2006,"VAN,EDM,PIT,ATL,DET,BOS"
Vern Smith,1964-05-30,0,1985,1985,NYI
Alexander Sulzer,1984-05-30,5,2009,2014,"NSH,FLA,BUF,VAN"
Jeff Teal,1960-05-30,0,1985,1985,MTL
Gilles Villemure,1940-05-30,13,1964,1977,"NYR,CBH"
Aaron Volpatti,1985-05-30,4,2011,2015,"VAN,WSH"
David Warsofsky,1990-05-30,4,2014,2018,"BOS,NJD,PIT,COL"
David Wilkie,1974-05-30,6,1995,2001,"MTL,TBL,NYR"
Greg Adams,1960-05-31,9,1981,1990,"PHI,HAR,WSH,EDM,VAN,DET,QUE"
Joel Armia,1993-05-31,5,2015,2020,"BUF,WPG,MTL"
Bill Bennett,1953-05-31,1,1979,1980,"BOS,HAR"
Nicolas Blanchard,1987-05-31,0,2013,2013,CAR
Michael Bournival,1992-05-31,4,2014,2018,"MTL,TBL"
Jim Carey,1974-05-31,4,1995,1999,"WSH,BOS,STL"
Gordie Clark,1952-05-31,1,1975,1976,BOS
Ray Cote,1961-05-31,1,1984,1985,EDM
Art Coulter*,1909-05-31,10,1932,1942,"CBH,NYR"
Jim Craig,1957-05-31,4,1980,1984,"ATF,BOS,MNS"
Doug Doull,1974-05-31,2,2004,2006,"BOS,WSH"
Pierre Engvall,1996-05-31,0,2020,2020,TOR
Erik Karlsson,1990-05-31,10,2010,2020,"OTT,SJS"
Greg Leeb,1977-05-31,0,2001,2001,DAL
Jean Lemieux,1952-05-31,4,1974,1978,"ATF,WSH"
Marquis Mathieu,1973-05-31,2,1999,2001,BOS
Sam McAdam,1908-05-31,0,1931,1931,NYR
Jared McCann,1996-05-31,4,2016,2020,"VAN,FLA,PIT"
Jeff Odgers,1969-05-31,11,1992,2003,"SJS,BOS,COL,ATL"
Rick Shinske,1955-05-31,2,1977,1979,"CLE,STL"
Bob Sneddon,1944-05-31,0,1971,1971,CGS
Corey Spring,1971-05-31,1,1998,1999,TBL
Petr Tenkrat,1977-05-31,6,2001,2007,"MDA,NSH,BOS"
Tiny Thompson*,1903-05-31,11,1929,1940,"BOS,DET"
Murray Baron,1967-06-01,14,1990,2004,"PHI,STL,MTL,PHX,VAN"
Emil Bemstrom,1999-06-01,0,2020,2020,CBJ
Danny Bois,1983-06-01,0,2007,2007,OTT
Serge Boisvert,1959-06-01,5,1983,1988,"TOR,MTL"
Henry Boucha,1951-06-01,5,1972,1977,"DET,MNS,KCS,CLR"
Paul Coffey*,1961-06-01,20,1981,2001,"EDM,PIT,LAK,DET,HAR,PHI,CAR,CHI,BOS"
Mike Dunham,1972-06-01,10,1997,2007,"NJD,NSH,NYR,ATL,NYI"
Cory Emmerton,1988-06-01,3,2011,2014,DET
Mark Fistric,1986-06-01,7,2008,2015,"DAL,EDM,ANA"
Michal Grosek,1975-06-01,10,1994,2004,"WIN,BUF,CHI,NYR,BOS"
Jeff Hackett,1968-06-01,15,1989,2004,"NYI,SJS,CHI,MTL,BOS,PHI"
Matt Halischuk,1988-06-01,7,2009,2016,"NJD,NSH,WPG"
Gizzy Hart,1902-06-01,6,1927,1933,"DTC,MTL"
Roman Josi,1990-06-01,8,2012,2020,NSH
Hannu Kamppuri,1957-06-01,0,1985,1985,NJD
Vladimir Krutov,1960-06-01,0,1990,1990,VAN
Morris Lukowich,1956-06-01,7,1980,1987,"WIN,BOS,LAK"
Johnny Matz,1891-06-01,0,1925,1925,MTL
Ladislav Nagy,1979-06-01,8,2000,2008,"STL,PHX,DAL,LAK"
Brian O'Neill,1988-06-01,0,2016,2016,NJD
Michel Plasse,1948-06-01,11,1971,1982,"STL,MTL,KCS,PIT,CLR,QUE"
Don Poile,1932-06-01,3,1955,1958,DET
Dan Quinn,1965-06-01,13,1984,1997,"CGY,PIT,VAN,STL,PHI,MNS,OTT,LAK"
Leo Reise,1892-06-01,9,1921,1930,"HAM,NYA,NYR"
Dan Renouf,1994-06-01,0,2017,2017,DET
Dylan Sikura,1995-06-01,2,2018,2020,CHI
Ryan Stewart,1967-06-01,0,1986,1986,WIN
Jaroslav Svoboda,1980-06-01,4,2002,2006,"CAR,DAL"
Ron Talakoski,1962-06-01,1,1987,1988,NYR
Kristian Vesalainen,1999-06-01,0,2019,2019,WPG
Mattias Weinhandl,1980-06-01,4,2003,2007,"NYI,MIN"
Larry Zeidel,1928-06-01,17,1952,1969,"DET,CBH,PHI"
Mike Berger,1967-06-02,1,1988,1989,MNS
Patrik Berglund,1988-06-02,10,2009,2019,"STL,BUF"
Scott Bjugstad,1961-06-02,8,1984,1992,"MNS,PIT,LAK"
Dick Butler,1926-06-02,0,1948,1948,CBH
Russ Courtnall,1965-06-02,15,1984,1999,"TOR,MTL,MNS,DAL,VAN,NYR,LAK"
Adam Creighton,1965-06-02,13,1984,1997,"BUF,CHI,NYI,TBL,STL"
Don Deacon,1913-06-02,3,1937,1940,DET
Gilles Dube,1927-06-02,0,1950,1950,MTL
Robbie Earl,1985-06-02,3,2008,2011,"TOR,MIN"
Jeff Eatough,1963-06-02,0,1982,1982,BUF
Doug Evans,1963-06-02,7,1986,1993,"STL,WIN,PHI"
Jake Evans,1996-06-02,0,2020,2020,MTL
Dan Frawley,1962-06-02,5,1984,1989,"CBH,PIT"
John Gibson,1959-06-02,3,1981,1984,"LAK,TOR,WIN"
Jack Hamilton,1925-06-02,3,1943,1946,TOR
Ott Heller,1910-06-02,14,1932,1946,NYR
Chris Higgins,1983-06-02,12,2004,2016,"MTL,CGY,NYR,FLA,VAN"
Charlie Huddy,1959-06-02,16,1981,1997,"EDM,LAK,BUF,STL"
Randy Johnston,1958-06-02,0,1980,1980,NYI
Josef Marha,1976-06-02,5,1996,2001,"COL,MDA,CHI"
Marty McInnis,1970-06-02,11,1992,2003,"NYI,CGY,MDA,BOS"
Lou Nanne,1941-06-02,10,1968,1978,MNS
Larry Robinson*,1951-06-02,19,1973,1992,"MTL,LAK"
Brett Sutter,1987-06-02,6,2009,2015,"CGY,CAR,MIN"
Don Sylvestri,1961-06-02,0,1985,1985,BOS
Lance Ward,1978-06-02,3,2001,2004,"FLA,MDA"
Jason Akeson,1990-06-03,2,2013,2015,PHI
Barry Beck,1957-06-03,12,1978,1990,"CLR,NYR,LAK"
Doug Berry,1957-06-03,1,1980,1981,CLR
Eddie Burke,1907-06-03,3,1932,1935,"BOS,NYA"
George Carroll,1897-06-03,0,1925,1925,"BOS,MTM"
Frantisek Cernik,1953-06-03,0,1985,1985,DET
Filip Chlapik,1997-06-03,2,2018,2020,OTT
Armand Delmonte,1927-06-03,0,1946,1946,BOS
Len Esau,1968-06-03,3,1992,1995,"TOR,QUE,CGY,EDM"
Brian Ferlin,1992-06-03,0,2015,2015,BOS
Pavel Francouz,1990-06-03,1,2019,2020,COL
Doug Houda,1966-06-03,17,1986,2003,"DET,HAR,LAK,BUF,NYI,MDA"
Walter Jackson,1908-06-03,3,1933,1936,"NYA,BOS"
Rick Jodzio,1954-06-03,0,1978,1978,"CLE,CLR"
Jim McBurney,1933-06-03,0,1953,1953,CBH
Gord McTavish,1954-06-03,1,1979,1980,"STL,WIN"
Sergei Plotnikov,1990-06-03,0,2016,2016,"ARI,PIT"
Nick Ricci,1959-06-03,3,1980,1983,PIT
Nick Seeler,1993-06-03,2,2018,2020,"MIN,CHI"
Don Smith,1888-06-03,0,1920,1920,MTL
Chris Thorburn,1983-06-03,13,2006,2019,"BUF,PIT,ATL,WPG,STL"
Sami Vatanen,1991-06-03,7,2013,2020,"ANA,NJD"
Wally Weir,1954-06-03,5,1980,1985,"QUE,HAR,PIT"
Philippe Audet,1977-06-04,0,1999,1999,DET
Len Barrie,1969-06-04,11,1990,2001,"PHI,FLA,PIT,LAK"
Matt Bartkowski,1988-06-04,8,2011,2019,"BOS,VAN,CGY,MIN"
Francois Beauchemin,1980-06-04,15,2003,2018,"MTL,CBJ,MDA,ANA,TOR,COL"
Laurie Boschman,1960-06-04,13,1980,1993,"TOR,EDM,WIN,NJD,OTT"
Tod Campeau,1923-06-04,5,1944,1949,MTL
Taylor Fedun,1988-06-04,6,2014,2020,"EDM,SJS,VAN,BUF,DAL"
John Gruden,1970-06-04,10,1994,2004,"BOS,OTT,WSH"
Derian Hatcher,1972-06-04,16,1992,2008,"MNS,DAL,DET,PHI"
Jonathan Huberdeau,1993-06-04,7,2013,2020,FLA
Tom Koivisto,1974-06-04,0,2003,2003,STL
Alan Kuntz,1919-06-04,4,1942,1946,NYR
Nick Kypreos,1966-06-04,7,1990,1997,"WSH,HAR,NYR,TOR"
Pierre-Luc Letourneau-Leblond,1985-06-04,5,2009,2014,"NJD,CGY,PIT"
Brandon Manning,1990-06-04,8,2012,2020,"PHI,CHI,EDM"
Jack McVicar,1904-06-04,1,1931,1932,MTM
Alexander Pechurski,1990-06-04,0,2010,2010,PIT
Wayne Primeau,1976-06-04,15,1995,2010,"BUF,TBL,PIT,SJS,BOS,CGY,TOR"
Jeff Toms,1974-06-04,7,1996,2003,"TBL,WSH,NYI,NYR,PIT,FLA"
Ian White,1984-06-04,7,2006,2013,"TOR,CGY,CAR,SJS,DET"
Cam Atkinson,1989-06-05,8,2012,2020,CBJ
Dave Bolland,1986-06-05,9,2007,2016,"CHI,TOR,FLA"
Leo Carbol,1908-06-05,0,1943,1943,CBH
Kale Clague,1998-06-05,0,2020,2020,LAK
Mike Fisher,1980-06-05,18,2000,2018,"OTT,NSH"
Pierre Gagne,1940-06-05,0,1960,1960,BOS
Martin Gelinas,1970-06-05,19,1989,2008,"EDM,QUE,VAN,CAR,CGY,FLA,NSH"
Radko Gudas,1990-06-05,7,2013,2020,"TBL,PHI,WSH"
Andre Hidi,1960-06-05,1,1984,1985,WSH
Chris Holt,1985-06-05,3,2006,2009,"NYR,STL"
Brady Keeper,1996-06-05,0,2019,2019,FLA
Jakub Klepis,1984-06-05,1,2006,2007,WSH
Andre Lacroix,1945-06-05,12,1968,1980,"PHI,CBH,HAR"
Brian Lundberg,1960-06-05,0,1983,1983,PIT
Shawn McCosh,1969-06-05,3,1992,1995,"LAK,NYR"
Greg Nemisz,1990-06-05,1,2011,2012,CGY
Frank Peters,1905-06-05,0,1931,1931,NYR
Bob Probert,1965-06-05,16,1986,2002,"DET,CHI"
Alfie Turcotte,1965-06-05,7,1984,1991,"MTL,WIN,WSH"
Tyler Weiman,1984-06-05,0,2008,2008,COL
Cully Wilson,1892-06-05,7,1920,1927,"TRS,MTL,HAM,CBH"
Greg Zanon,1980-06-05,7,2006,2013,"NSH,MIN,BOS,COL"
Jim Archibald,1961-06-06,2,1985,1987,MNS
Wayne Babych,1958-06-06,8,1979,1987,"STL,PIT,HAR,QUE"
Les Binkley,1934-06-06,4,1968,1972,PIT
Anson Carter,1974-06-06,10,1997,2007,"BOS,WSH,EDM,NYR,LAK,VAN,CAR,CBJ"
Jack Coughlin,1892-06-06,3,1918,1921,"TRA,MTL,QBC,HAM"
Mike Craig,1971-06-06,11,1991,2002,"MNS,DAL,TOR,SJS"
Victor Ejdsell,1995-06-06,0,2018,2018,CHI
Dave Gans,1964-06-06,3,1983,1986,LAK
Ed Giacomin*,1939-06-06,12,1966,1978,"NYR,DET"
Art Giroux,1908-06-06,3,1933,1936,"MTL,BOS,DET"
Aldo Guidolin,1932-06-06,3,1953,1956,NYR
Per Gustafsson,1970-06-06,1,1997,1998,"FLA,OTT,TOR"
Jean Hamel,1952-06-06,11,1973,1984,"STL,DET,QUE,MTL"
Niklas Hjalmarsson,1987-06-06,12,2008,2020,"CHI,ARI"
Dean Hopkins,1959-06-06,9,1980,1989,"LAK,EDM,QUE"
Marshall Johnston,1941-06-06,6,1968,1974,"MNS,CGS"
Caleb Jones,1997-06-06,1,2019,2020,EDM
Bob Kelly,1946-06-06,5,1974,1979,"PIT,STL,CBH"
Marko Kiprusoff,1972-06-06,6,1996,2002,"MTL,NYI"
Gary Laskoski,1959-06-06,1,1983,1984,LAK
Al McDonough,1950-06-06,7,1971,1978,"LAK,PIT,ATF,DET"
Cam Neely*,1965-06-06,12,1984,1996,"VAN,BOS"
Markus Nutivaara,1994-06-06,3,2017,2020,CBJ
Vladimir Ruzicka,1963-06-06,4,1990,1994,"EDM,BOS,OTT"
Ben Sexton,1991-06-06,0,2018,2018,OTT
Niklas Sundstrom,1975-06-06,10,1996,2006,"NYR,SJS,MTL"
Matt Beleskey,1988-06-07,10,2009,2019,"ANA,BOS,NYR"
T.J. Brodie,1990-06-07,9,2011,2020,CGY
Lulu Denis,1928-06-07,1,1950,1951,MTL
Ron Grahame,1950-06-07,3,1978,1981,"BOS,LAK,QUE"
Denis Gurianov,1997-06-07,3,2017,2020,DAL
Hugh Harris,1948-06-07,0,1973,1973,BUF
Milan Jurcina,1983-06-07,6,2006,2012,"BOS,WSH,CBJ,NYI"
Andrei Kovalenko,1970-06-07,8,1993,2001,"QUE,COL,MTL,EDM,CAR,PHI,BOS"
Milan Lucic,1988-06-07,12,2008,2020,"BOS,LAK,EDM,CGY"
Gilles Marotte,1945-06-07,11,1966,1977,"BOS,CBH,LAK,NYR,STL"
Victor Mete,1998-06-07,2,2018,2020,MTL
Mike Modano*,1970-06-07,21,1990,2011,"MNS,DAL,DET"
Terry O'Reilly,1951-06-07,13,1972,1985,BOS
Willi Plett,1955-06-07,12,1976,1988,"ATF,CGY,MNS,BOS"
Leo Reise,1922-06-07,8,1946,1954,"CBH,DET,NYR"
Stephane Richer,1966-06-07,17,1985,2002,"MTL,NJD,TBL,STL,PIT"
Pavel Rosa,1977-06-07,5,1999,2004,LAK
Dan Seguin,1948-06-07,3,1971,1974,"MNS,VAN"
Michael Stone,1990-06-07,8,2012,2020,"PHX,ARI,CGY"
Anthony Beauvillier,1997-06-08,3,2017,2020,NYI
Phil Bourque,1962-06-08,12,1984,1996,"PIT,NYR,OTT"
Doug Brindley,1949-06-08,0,1971,1971,TOR
Mike Cammalleri,1982-06-08,15,2003,2018,"LAK,CGY,MTL,NJD,EDM"
Johnny Gagnon,1905-06-08,9,1931,1940,"MTL,BOS,NYA"
Francois Guay,1968-06-08,0,1990,1990,BUF
Herb Hamel,1904-06-08,0,1931,1931,TOR
Joel Hanley,1991-06-08,4,2016,2020,"MTL,ARI,DAL"
Peter Harrold,1983-06-08,8,2007,2015,"LAK,NJD"
Michael Holmqvist,1979-06-08,3,2004,2007,"MDA,CHI"
Patrick Kaleta,1986-06-08,8,2007,2015,BUF
Quintin Laing,1979-06-08,6,2004,2010,"CHI,WSH"
Spencer Martin,1995-06-08,0,2017,2017,COL
Bryan McCabe,1975-06-08,15,1996,2011,"NYI,VAN,CHI,TOR,FLA,NYR"
Grant McNeill,1983-06-08,0,2004,2004,FLA
Bryan Muir,1973-06-08,11,1996,2007,"EDM,CHI,NJD,TBL,COL,LAK,WSH"
George O'Grady,1891-06-08,0,1918,1918,MTW
Jim Pavese,1962-06-08,7,1982,1989,"STL,DET,NYR,HAR"
Vaclav Pletka,1979-06-08,0,2002,2002,PHI
Tucker Poolman,1993-06-08,2,2018,2020,WPG
Rob Ray,1968-06-08,14,1990,2004,"BUF,OTT"
Jim Roberts,1956-06-08,2,1977,1979,MNS
Andrej Sekera,1986-06-08,13,2007,2020,"BUF,CAR,LAK,EDM,DAL"
Conor Sheary,1992-06-08,4,2016,2020,"PIT,BUF"
Thomas Steen,1960-06-08,13,1982,1995,WIN
Jake Bean,1998-06-09,0,2019,2019,CAR
Jason Demers,1988-06-09,10,2010,2020,"SJS,DAL,FLA,ARI"
Michael Dipietro,1999-06-09,1,2019,2020,VAN
Barrett Hayton,2000-06-09,0,2020,2020,ARI
Zach Hyman,1992-06-09,4,2016,2020,TOR
Dan Labraaten,1951-06-09,3,1979,1982,"DET,CGY"
Patrick Leahy,1979-06-09,3,2004,2007,"BOS,NSH"
Grant Marshall,1973-06-09,11,1995,2006,"DAL,CBJ,NJD"
Don McSween,1964-06-09,8,1988,1996,"BUF,MDA"
Ryan O'Marra,1987-06-09,2,2010,2012,"EDM,ANA"
John Paddock,1954-06-09,7,1976,1983,"WSH,PHI,QUE"
Andre Racicot,1969-06-09,4,1990,1994,MTL
Russell Romaniuk,1970-06-09,4,1992,1996,"WIN,PHI"
Kyle Rossiter,1980-06-09,2,2002,2004,"FLA,ATL"
Trevor Sim,1970-06-09,0,1990,1990,EDM
Brian Tutt,1962-06-09,0,1990,1990,WSH
Jeff Zatkoff,1987-06-09,3,2014,2017,"PIT,LAK"
Thomas Ziegler,1978-06-09,0,2001,2001,TBL
Billy Bell,1891-06-10,6,1918,1924,"MTL,MTW,OTS"
Kieffer Bellows,1998-06-10,0,2020,2020,NYI
Brian Benning,1966-06-10,10,1985,1995,"STL,LAK,PHI,EDM,FLA"
Lionel Bouvrette,1914-06-10,0,1943,1943,NYR
Murray Davison,1938-06-10,0,1966,1966,BOS
Tom Dewar,1913-06-10,0,1944,1944,NYR
Mike Eaves,1956-06-10,6,1979,1985,"MNS,CGY"
Leo Gravelle,1925-06-10,4,1947,1951,"MTL,DET"
Chad Johnson,1986-06-10,9,2010,2019,"NYR,PHX,BOS,NYI,BUF,CGY,ANA,STL"
Ian MacIntosh,1927-06-10,0,1953,1953,NYR
Greg Mauldin,1982-06-10,7,2004,2011,"CBJ,NYI,COL"
Dennis O'Brien,1949-06-10,9,1971,1980,"MNS,BOS,CLE,CLR"
Jiri Sekac,1992-06-10,1,2015,2016,"ANA,MTL,ARI,CHI"
Timofei Shishkanov,1983-06-10,2,2004,2006,"NSH,STL"
Rob Skrlac,1976-06-10,0,2004,2004,NJD
Brent Sutter,1962-06-10,17,1981,1998,"NYI,CHI"
Daniel Tkaczuk,1979-06-10,0,2001,2001,CGY
Kurt Walker,1954-06-10,2,1976,1978,TOR
Mika Alatalo,1971-06-11,1,2000,2001,PHX
Keith Aulie,1989-06-11,4,2011,2015,"TOR,TBL,EDM"
Noah Clarke,1979-06-11,4,2004,2008,"LAK,NJD"
Herb Dickenson,1931-06-11,1,1952,1953,NYR
Fedor Fedorov,1981-06-11,3,2003,2006,"VAN,NYR"
Bryan Fogarty,1969-06-11,5,1990,1995,"QUE,PIT,MTL"
Frank Fredrickson*,1895-06-11,4,1927,1931,"BOS,DTC,PTP,DTF"
Hec Kilrea,1907-06-11,14,1926,1940,"OTS,DTF,TOR,DET"
Serge Lajeunesse,1950-06-11,4,1971,1975,"DET,PHI"
Ted Lanyon,1939-06-11,0,1968,1968,PIT
Derek MacKenzie,1981-06-11,17,2002,2019,"ATL,CBJ,FLA"
Jack Marks,1885-06-11,2,1918,1920,"MTW,TRA,QBC"
Scott Mellanby,1966-06-11,21,1986,2007,"PHI,EDM,FLA,STL,ATL"
Jim Mikol,1938-06-11,2,1963,1965,"TOR,NYR"
Kip Miller,1969-06-11,13,1991,2004,"QUE,MNS,SJS,NYI,CHI,PIT,MDA,WSH"
Brendan Woods,1992-06-11,1,2015,2016,CAR
Michal Barinka,1984-06-12,2,2004,2006,CHI
Doug Brown,1964-06-12,14,1987,2001,"NJD,PIT,DET"
Frederic Cassivi,1975-06-12,5,2002,2007,"ATL,WSH"
Bill Cowley*,1912-06-12,12,1935,1947,"STE,BOS"
Bob DeCourcy,1927-06-12,0,1948,1948,NYR
Gustav Forsling,1996-06-12,2,2017,2019,CHI
Mark Holden,1957-06-12,3,1982,1985,"MTL,WIN"
Ryan Kuffner,1996-06-12,0,2019,2019,DET
Greg Kuznik,1978-06-12,0,2001,2001,CAR
Mikko Lehtonen,1978-06-12,0,2007,2007,NSH
Dan Mandich,1960-06-12,3,1983,1986,MNS
Dave Morrison,1962-06-12,4,1981,1985,"LAK,VAN"
Wade Redden,1977-06-12,16,1997,2013,"OTT,NYR,BOS,STL"
Paul Ronty,1928-06-12,7,1948,1955,"BOS,NYR,MTL"
Mathieu Schneider,1969-06-12,22,1988,2010,"MTL,NYI,TOR,NYR,LAK,DET,ANA,ATL,PHX,VAN"
Marc Tardif,1949-06-12,13,1970,1983,"MTL,QUE"
Ron Areshenkoff,1957-06-13,0,1980,1980,EDM
Ace Bailey,1948-06-13,9,1969,1978,"BOS,DET,STL,WSH"
J.P. Bordeleau,1949-06-13,8,1972,1980,CBH
Matt Bradley,1978-06-13,11,2001,2012,"SJS,PIT,WSH,FLA"
Valeri Bure,1974-06-13,9,1995,2004,"MTL,CGY,FLA,STL,DAL"
Viacheslav Butsayev,1970-06-13,7,1993,2000,"PHI,SJS,MDA,FLA,OTT,TBL"
Brian Carlin,1950-06-13,0,1972,1972,LAK
Blair Chapman,1956-06-13,6,1977,1983,"PIT,STL"
Doug Crossman,1960-06-13,13,1981,1994,"CBH,PHI,LAK,NYI,DET,HAR,STL,TBL"
Randy Gilhen,1963-06-13,13,1983,1996,"HAR,WIN,PIT,LAK,NYR,TBL,FLA"
Dale Kushner,1966-06-13,2,1990,1992,"NYI,PHI"
David Littman,1967-06-13,2,1991,1993,"BUF,TBL"
Andreas Martinsen,1990-06-13,3,2016,2019,"COL,MTL,CHI"
Duke McCurry,1900-06-13,3,1926,1929,PTP
Ryan McDonagh,1989-06-13,9,2011,2020,"NYR,TBL"
Dave Roche,1975-06-13,6,1996,2002,"PIT,CGY,NYI"
Jason Spezza,1983-06-13,17,2003,2020,"OTT,DAL,TOR"
Danny Syvret,1985-06-13,5,2006,2011,"EDM,PHI,ANA"
Radim Vrbata,1981-06-13,16,2002,2018,"COL,CAR,CHI,PHX,TBL,VAN,ARI,FLA"
Oliver Wahlstrom,2000-06-13,0,2020,2020,NYI
Shane Willis,1977-06-13,5,1999,2004,"CAR,TBL"
Jack Adams*,1894-06-14,9,1918,1927,"TRA,TRS,OTS"
Steve Begin,1978-06-14,15,1998,2013,"CGY,MTL,DAL,BOS,NSH"
Tony Cimellaro,1971-06-14,0,1993,1993,OTT
Andrew Cogliano,1987-06-14,12,2008,2020,"EDM,ANA,DAL"
Patrice Cormier,1990-06-14,5,2011,2016,"ATL,WPG"
Hap Day*,1901-06-14,13,1925,1938,"TRS,TOR,NYA"
Eric Desjardins,1969-06-14,17,1989,2006,"MTL,PHI"
Gary Geldart,1950-06-14,0,1971,1971,MNS
Rick Hampton,1956-06-14,5,1975,1980,"CGS,CLE,LAK"
Ryan Johnson,1976-06-14,13,1998,2011,"FLA,TBL,STL,VAN,CHI"
Ryan Jones,1984-06-14,5,2009,2014,"NSH,EDM"
Bing Juckes,1926-06-14,2,1948,1950,NYR
Sami Kapanen,1973-06-14,12,1996,2008,"HAR,CAR,PHI"
Jordan Krestanovich,1981-06-14,2,2002,2004,COL
Jack Lancien,1923-06-14,4,1947,1951,NYR
Parker MacDonald,1933-06-14,16,1953,1969,"TOR,NYR,DET,BOS,MNS"
James Patrick,1963-06-14,20,1984,2004,"NYR,CGY,HAR,BUF"
Geoff Powis,1945-06-14,0,1968,1968,CBH
Yves Preston,1956-06-14,2,1979,1981,PHI
Matt Read,1986-06-14,7,2012,2019,"PHI,MIN"
Joel Rechlicz,1987-06-14,3,2009,2012,"NYI,WSH"
Eric Robinson,1995-06-14,2,2018,2020,CBJ
Ben Simon,1978-06-14,4,2002,2006,"ATL,CBJ"
Devante Smith-Pelly,1992-06-14,7,2012,2019,"ANA,MTL,NJD,WSH"
Floyd Thomson,1949-06-14,8,1972,1980,STL
Johnny Wilson,1929-06-14,12,1950,1962,"DET,CBH,TOR,NYR"
Jesse Belanger,1969-06-15,9,1992,2001,"MTL,FLA,VAN,EDM,NYI"
Ryan Caldwell,1981-06-15,2,2006,2008,"NYI,PHX"
Ed Carpenter,1890-06-15,1,1920,1921,"QBC,HAM"
Bart Crashley,1946-06-15,10,1966,1976,"DET,KCS,LAK"
Mario Gosselin,1963-06-15,10,1984,1994,"QUE,LAK,HAR"
Radek Hamr,1974-06-15,1,1993,1994,OTT
Pete Horeck,1923-06-15,7,1945,1952,"CBH,DET,BOS"
Dan Jancevski,1981-06-15,3,2006,2009,"DAL,TBL"
Boone Jenner,1993-06-15,6,2014,2020,CBJ
Sheldon Kennedy,1969-06-15,7,1990,1997,"DET,CGY,BOS"
Jean-Francois Labbe,1972-06-15,3,2000,2003,"NYR,CBJ"
Pat MacLeod,1969-06-15,5,1991,1996,"MNS,SJS,DAL"
Dean McAmmond,1973-06-15,18,1992,2010,"CHI,EDM,PHI,CGY,COL,STL,OTT,NYI,NJD"
Sandy McCarthy,1972-06-15,10,1994,2004,"CGY,TBL,PHI,CAR,NYR,BOS"
Warren Miller,1954-06-15,3,1980,1983,"NYR,HAR"
Danny O'Shea,1945-06-15,4,1969,1973,"MNS,CBH,STL"
Marcel Pronovost*,1930-06-15,19,1951,1970,"DET,TOR"
Leo Quenneville,1900-06-15,0,1930,1930,NYR
Tyler Randell,1991-06-15,0,2016,2016,BOS
Zac Rinaldo,1990-06-15,8,2012,2020,"PHI,BOS,ARI,NSH,CGY"
Mackenzie Skapski,1994-06-15,0,2015,2015,NYR
Don Spring,1959-06-15,3,1981,1984,WIN
Petr Straka,1992-06-15,0,2015,2015,PHI
Todd Strueby,1963-06-15,2,1982,1984,EDM
Claire Alexander,1945-06-16,3,1975,1978,"TOR,VAN"
Brady Austin,1993-06-16,0,2017,2017,BUF
Kevin Bieksa,1981-06-16,12,2006,2018,"VAN,ANA"
Travis Brigley,1977-06-16,6,1998,2004,"CGY,COL"
Kelly Burnett,1926-06-16,0,1953,1953,NYR
Barry Cullen,1935-06-16,4,1956,1960,"TOR,DET"
Emerson Etem,1992-06-16,4,2013,2017,"ANA,NYR,VAN"
Gordie Fashoway,1926-06-16,0,1951,1951,CBH
Tom Fergus,1962-06-16,11,1982,1993,"BOS,TOR,VAN"
Zack Fitzgerald,1985-06-16,0,2008,2008,VAN
Alexandre Giroux,1981-06-16,6,2006,2012,"NYR,WSH,EDM,CBJ"
Dean Kolstad,1968-06-16,4,1989,1993,"MNS,SJS"
Steve Larmer,1961-06-16,14,1981,1995,"CBH,CHI,NYR"
Jean-Louis Levasseur,1949-06-16,0,1980,1980,MNS
Chris McAllister,1975-06-16,6,1998,2004,"VAN,TOR,PHI,COL,NYR"
Stan McCabe,1908-06-16,4,1930,1934,"DTC,DTF,MTM"
Mike Moller,1962-06-16,6,1981,1987,"BUF,EDM"
Rick Nash,1984-06-16,15,2003,2018,"CBJ,NYR,BOS"
Nikita Nikitin,1986-06-16,5,2011,2016,"STL,CBJ,EDM"
Pascal Pelletier,1983-06-16,6,2008,2014,"BOS,CHI,VAN"
Jame Pollock,1979-06-16,0,2004,2004,STL
Derek Sanderson,1946-06-16,12,1966,1978,"BOS,NYR,STL,VAN,PIT"
Frank Sullivan,1929-06-16,6,1950,1956,"TOR,CBH"
Tony White,1954-06-16,5,1975,1980,"WSH,MNS"
Dainius Zubrus,1978-06-16,19,1997,2016,"PHI,MTL,WSH,BUF,NJD,SJS"
Bob Barlow,1935-06-17,1,1970,1971,MNS
Sammy Blais,1996-06-17,2,2018,2020,STL
Stephane Fiset,1970-06-17,12,1990,2002,"QUE,COL,LAK,MTL"
Dave Fortier,1951-06-17,4,1973,1977,"TOR,NYI,VAN"
John Garrett,1951-06-17,5,1980,1985,"HAR,QUE,VAN"
Dougie Hamilton,1993-06-17,7,2013,2020,"BOS,CGY,CAR"
Tavis Hansen,1975-06-17,6,1995,2001,"WIN,PHX"
Matt Hendricks,1981-06-17,10,2009,2019,"COL,WSH,EDM,NSH,WPG,MIN"
Brent Hughes,1943-06-17,7,1968,1975,"LAK,PHI,STL,DET,KCS"
Henri Jokiharju,1999-06-17,1,2019,2020,"CHI,BUF"
Patric Kjellberg,1969-06-17,10,1993,2003,"MTL,NSH,MDA"
Ville Koistinen,1982-06-17,2,2008,2010,"NSH,FLA"
Nikita Kucherov,1993-06-17,6,2014,2020,TBL
Larry Kwong,1923-06-17,0,1948,1948,NYR
Greg McKegg,1992-06-17,6,2014,2020,"TOR,FLA,TBL,PIT,CAR,NYR"
Al McLeod,1949-06-17,0,1974,1974,DET
Mike Milbury,1952-06-17,11,1976,1987,BOS
Mika Noronen,1979-06-17,5,2001,2006,"BUF,VAN"
Maxime Ouellet,1981-06-17,5,2001,2006,"PHI,WSH,VAN"
George Pesut,1953-06-17,1,1975,1976,CGS
Tomi Pettinen,1977-06-17,3,2003,2006,NYI
Travis Roche,1978-06-17,6,2001,2007,"MIN,PHX"
Joakim Ryan,1993-06-17,2,2018,2020,"SJS,LAK"
Bob Sauve,1955-06-17,12,1977,1989,"BUF,DET,CBH,CHI,NJD"
Marek Svatos,1982-06-17,7,2004,2011,"COL,NSH,OTT"
Trent Whitfield,1977-06-17,11,2001,2012,"WSH,NYR,STL,BOS"
Rik Wilson,1962-06-17,6,1982,1988,"STL,CGY,CHI"
Allen York,1989-06-17,0,2012,2012,CBJ
Luke Adam,1990-06-18,4,2011,2015,"BUF,CBJ"
Joseph Blandisi,1994-06-18,4,2016,2020,"NJD,ANA,PIT"
Doug Bodger,1966-06-18,15,1985,2000,"PIT,BUF,SJS,NJD,LAK,VAN"
Andreas Borgman,1995-06-18,0,2018,2018,TOR
Nobby Clark,1897-06-18,0,1928,1928,BOS
David Hale,1981-06-18,7,2004,2011,"NJD,CGY,PHX,TBL,OTT"
Josh Harding,1984-06-18,8,2006,2014,MIN
Jan Hejda,1978-06-18,8,2007,2015,"EDM,CBJ,COL"
Denis Herron,1952-06-18,13,1973,1986,"PIT,KCS,MTL"
Joe Lamb,1906-06-18,10,1928,1938,"MTM,OTS,NYA,BOS,MTL,STE,DET"
Larry Leach,1936-06-18,3,1959,1962,BOS
Mason Marchment,1995-06-18,0,2020,2020,TOR
Mike McKee,1969-06-18,0,1994,1994,QUE
Kyle McLaren,1977-06-18,12,1996,2008,"BOS,SJS"
Scott Morrow,1969-06-18,0,1995,1995,CGY
Chris Neil,1979-06-18,15,2002,2017,OTT
Antero Niittymaki,1980-06-18,7,2004,2011,"PHI,TBL,SJS"
Bob Rouse,1964-06-18,16,1984,2000,"MNS,WSH,TOR,DET,SJS"
Martin St. Louis*,1975-06-18,16,1999,2015,"CGY,TBL,NYR"
Derek Stepan,1990-06-18,9,2011,2020,"NYR,ARI"
David Volek,1966-06-18,5,1989,1994,NYI
Ross Yates,1959-06-18,0,1984,1984,HAR
Joey Anderson,1998-06-19,1,2019,2020,NJD
Jonny Brodzinski,1993-06-19,3,2017,2020,"LAK,SJS"
Jim Corsi,1954-06-19,0,1980,1980,EDM
Dan Ellis,1980-06-19,11,2004,2015,"DAL,NSH,ANA,TBL,CAR,FLA"
Stewart Evans,1908-06-19,8,1931,1939,"DTF,DET,MTM,MTL"
Alex Frolov,1982-06-19,8,2003,2011,"LAK,NYR"
Kyosti Karjalainen,1967-06-19,0,1992,1992,LAK
Sergei Makarov*,1958-06-19,7,1990,1997,"CGY,SJS,DAL"
Keith McCreary,1940-06-19,10,1965,1975,"MTL,PIT,ATF"
Walt McKechnie,1947-06-19,15,1968,1983,"MNS,CGS,BOS,DET,CLE,WSH,TOR,CLR"
Ed Reigle,1924-06-19,0,1951,1951,BOS
Laurie Scott,1900-06-19,1,1927,1928,"NYA,NYR"
Jack Shewchuk,1917-06-19,6,1939,1945,BOS
Sam Bennett,1996-06-20,5,2015,2020,CGY
Ralph Bowman,1911-06-20,6,1934,1940,"OTS,DET,STE"
Drake Caggiula,1994-06-20,3,2017,2020,"EDM,CHI"
Joe Corvo,1977-06-20,11,2003,2014,"LAK,OTT,CAR,WSH,BOS"
Jacques Cossette,1954-06-20,3,1976,1979,PIT
Nick Cousins,1993-06-20,5,2015,2020,"PHI,ARI,MTL,VEG"
Gary Croteau,1946-06-20,11,1969,1980,"LAK,DET,CGS,KCS,CLR"
Michael Dal Colle,1996-06-20,2,2018,2020,NYI
Collin Delia,1994-06-20,1,2018,2019,CHI
Dante Fabbro,1998-06-20,1,2019,2020,NSH
Jeff Giuliano,1979-06-20,2,2006,2008,LAK
Jean-Paul Gladu,1921-06-20,0,1945,1945,BOS
Pat Jablonski,1967-06-20,8,1990,1998,"STL,TBL,MTL,PHX,CAR"
Alex Motter,1913-06-20,8,1935,1943,"BOS,DET"
John Ogrodnick,1959-06-20,13,1980,1993,"DET,QUE,NYR"
Greg Pateryn,1990-06-20,7,2013,2020,"MTL,DAL,MIN"
Jimmy Peters,1944-06-20,10,1965,1975,"DET,LAK"
Craig Sarner,1949-06-20,0,1975,1975,BOS
Colin Smith,1993-06-20,0,2015,2015,COL
Dave Snuggerud,1966-06-20,3,1990,1993,"BUF,SJS,PHI"
Petr Svoboda,1980-06-20,0,2001,2001,TOR
Daniil Tarasov,1991-06-20,0,2015,2015,SJS
Bill Thomas,1983-06-20,6,2006,2012,"PHX,PIT,FLA"
Ken Berry,1960-06-21,7,1982,1989,"EDM,VAN"
Bob Bourne,1954-06-21,13,1975,1988,"NYI,LAK"
Fredrik Bremberg,1973-06-21,0,1999,1999,EDM
Paul Brydges,1965-06-21,0,1987,1987,BUF
Yann Danis,1981-06-21,10,2006,2016,"MTL,NYI,NJD,EDM"
Lucien DeBlois,1957-06-21,14,1978,1992,"NYR,CLR,WIN,MTL,QUE,TOR"
Denis Dup√©r√©,1948-06-21,7,1971,1978,"TOR,STL,WSH,KCS,CLR"
Alex Gray,1899-06-21,1,1928,1929,"NYR,TOR"
Derek Gustafson,1979-06-21,1,2001,2002,MIN
Jochen Hecht,1977-06-21,14,1999,2013,"STL,EDM,BUF"
Jack Ingoldsby,1924-06-21,1,1943,1944,TOR
Reed Low,1976-06-21,6,2001,2007,"STL,CHI"
Ron Low,1950-06-21,12,1973,1985,"TOR,WSH,DET,EDM,QUE,NJD"
Jeff Madill,1965-06-21,0,1991,1991,NJD
Steve Martinson,1959-06-21,4,1988,1992,"DET,MTL,MNS"
Max McNab,1924-06-21,2,1948,1950,DET
Anssi Melametsa,1961-06-21,0,1986,1986,WIN
Marc Methot,1985-06-21,12,2007,2019,"CBJ,OTT,DAL"
Buddy O'Connor*,1916-06-21,9,1942,1951,"MTL,NYR"
Eric O'Dell,1990-06-21,1,2014,2015,WPG
Pascal Rheaume,1973-06-21,9,1997,2006,"NJD,STL,ATL,CHI,NYR,PHX"
Bernie Saunders,1956-06-21,1,1980,1981,QUE
Darryl Shannon,1968-06-21,12,1989,2001,"TOR,WIN,BUF,ATL,CGY,MTL"
Mike Amodeo,1952-06-22,0,1980,1980,WIN
Andrei Bashkirov,1970-06-22,2,1999,2001,MTL
Chris Beckford-Tseu,1984-06-22,0,2008,2008,STL
Fred Bergdinon,1906-06-22,0,1926,1926,BOS
Ilya Bryzgalov,1980-06-22,13,2002,2015,"MDA,ANA,PHX,PHI,EDM,MIN"
Scott Campbell,1957-06-22,2,1980,1982,"WIN,STL"
Patrick Dwyer,1983-06-22,6,2009,2015,CAR
Steve Gatzos,1961-06-22,3,1982,1985,PIT
David Gosselin,1977-06-22,2,2000,2002,NSH
Dwight Helminen,1983-06-22,1,2009,2010,"CAR,SJS"
Matt Henderson,1974-06-22,3,1999,2002,"NSH,CHI"
Adam Johnson,1994-06-22,1,2019,2020,PIT
Charles Linglet,1982-06-22,0,2010,2010,EDM
Mikko Luoma,1976-06-22,0,2004,2004,EDM
Brendan Mikkelson,1987-06-22,4,2009,2013,"ANA,CGY,TBL"
Roger Pelletier,1945-06-22,0,1968,1968,PHI
Darroll Powe,1985-06-22,5,2009,2014,"PHI,MIN,NYR"
Paul Stanton,1967-06-22,4,1991,1995,"PIT,BOS,NYI"
Alexei Tezikov,1978-06-22,3,1999,2002,"WSH,VAN"
Dean Turner,1958-06-22,4,1979,1983,"NYR,CLR,LAK"
Derek Boogaard,1982-06-23,5,2006,2011,"MIN,NYR"
Lawson Crouse,1997-06-23,3,2017,2020,ARI
Ken Doraty,1906-06-23,11,1927,1938,"CBH,TOR,DET"
David Haas,1968-06-23,3,1991,1994,"EDM,CGY"
Charles Hudon,1994-06-23,4,2016,2020,MTL
Ernie Laforce,1916-06-23,0,1943,1943,MTL
Brooks Laich,1983-06-23,14,2004,2018,"OTT,WSH,TOR,LAK"
Hal Laycoe,1922-06-23,10,1946,1956,"NYR,MTL,BOS"
Tony Martensson,1980-06-23,0,2004,2004,MDA
Reg Noble*,1896-06-23,15,1918,1933,"TRA,TRS,MTM,DTC,DTF,DET"
Jordan Nolan,1989-06-23,7,2012,2019,"LAK,BUF,STL"
Larry Playfair,1958-06-23,11,1979,1990,"BUF,LAK"
Felix Potvin,1971-06-23,12,1992,2004,"TOR,NYI,VAN,LAK,BOS"
John Ross Roach,1900-06-23,13,1922,1935,"TRS,TOR,NYR,DET"
Gaye Stewart,1923-06-23,10,1943,1953,"TOR,CBH,DET,NYR,MTL"
Kari Takko,1962-06-23,5,1986,1991,"MNS,EDM"
Austin Wagner,1997-06-23,1,2019,2020,LAK
Mike Brown,1985-06-24,8,2008,2016,"VAN,ANA,TOR,EDM,SJS,MTL"
Wayne Cashman,1945-06-24,18,1965,1983,BOS
Shane Churla,1965-06-24,10,1987,1997,"HAR,CGY,MNS,DAL,LAK,NYR"
Dave Creighton,1930-06-24,11,1949,1960,"BOS,CBH,TOR,NYR"
Jeff Daniels,1968-06-24,12,1991,2003,"PIT,FLA,HAR,CAR,NSH"
Michael Del Zotto,1990-06-24,10,2010,2020,"NYR,NSH,PHI,VAN,ANA,STL"
Pierre-Luc Dubois,1998-06-24,2,2018,2020,CBJ
Johnny Gottselig,1905-06-24,16,1929,1945,CBH
Bill Huard,1967-06-24,7,1993,2000,"BOS,OTT,QUE,DAL,EDM,LAK"
Uwe Krupp,1965-06-24,16,1987,2003,"BUF,NYI,QUE,COL,DET,ATL"
Jere Lehtinen,1973-06-24,14,1996,2010,DAL
Jean-Yves Leroux,1976-06-24,4,1997,2001,CHI
Drew MacIntyre,1983-06-24,6,2008,2014,"VAN,BUF,TOR"
Marek Malik,1975-06-24,14,1995,2009,"HAR,CAR,VAN,NYR,TBL"
Perry Miller,1952-06-24,3,1978,1981,DET
Bernie Nicholls,1961-06-24,17,1982,1999,"LAK,NYR,EDM,NJD,CHI,SJS"
Alain Raymond,1965-06-24,0,1988,1988,WSH
Tom Reid,1946-06-24,10,1968,1978,"CBH,MNS"
Wade Skolney,1981-06-24,0,2006,2006,PHI
Jarret Stoll,1982-06-24,13,2003,2016,"EDM,LAK,MIN,NYR"
Gary Suter,1964-06-24,16,1986,2002,"CGY,CHI,SJS"
Bill Armstrong,1966-06-25,0,1991,1991,PHI
Brett Bellemore,1988-06-25,2,2013,2015,CAR
Sebastien Caron,1980-06-25,9,2003,2012,"PIT,ANA,CHI,TBL"
Rene Corbet,1973-06-25,7,1994,2001,"QUE,COL,CGY,PIT"
Ernie Dickens,1921-06-25,9,1942,1951,"TOR,CBH"
Jhonas Enroth,1988-06-25,7,2010,2017,"BUF,DAL,LAK,TOR"
Doug Gilmour*,1963-06-25,19,1984,2003,"STL,CGY,TOR,NJD,CHI,BUF,MTL"
Hugh Harvey,1949-06-25,1,1975,1976,KCS
Brian Hayward,1960-06-25,10,1983,1993,"WIN,MTL,MNS,SJS"
Milan Hnilicka,1973-06-25,4,2000,2004,"NYR,ATL,LAK"
Ken Hodge,1944-06-25,13,1965,1978,"CBH,BOS,NYR"
Scott King,1967-06-25,1,1991,1992,DET
Mario Lessard,1954-06-25,5,1979,1984,LAK
Justin Mercier,1987-06-25,0,2010,2010,COL
Glen Metropolit,1974-06-25,10,2000,2010,"WSH,TBL,ATL,STL,BOS,MTL,PHI"
Greg Millen,1957-06-25,13,1979,1992,"PIT,HAR,STL,CHI,QUE,DET"
Jordan Oesterle,1992-06-25,5,2015,2020,"EDM,CHI,ARI"
Ben Ondrus,1982-06-25,3,2006,2009,TOR
Joe Paterson,1960-06-25,8,1981,1989,"DET,PHI,LAK,NYR"
Robert Reichel,1971-06-25,13,1991,2004,"CGY,NYI,PHX,TOR"
Todd Reirden,1971-06-25,5,1999,2004,"EDM,STL,ATL,PHX"
Jaden Schwartz,1992-06-25,8,2012,2020,STL
Mikhail Sergachev,1998-06-25,3,2017,2020,"MTL,TBL"
Martin Simard,1966-06-25,2,1991,1993,"CGY,TBL"
Dave Trottier,1906-06-25,10,1929,1939,"MTM,DET"
Chris Armstrong,1975-06-26,3,2001,2004,"MIN,MDA"
Ethan Bear,1997-06-26,2,2018,2020,EDM
Alexandre Bolduc,1985-06-26,6,2009,2015,"VAN,PHX,ARI"
John Erskine,1980-06-26,12,2002,2014,"DAL,NYI,WSH"
Eric Germain,1966-06-26,0,1988,1988,LAK
Danny Gruen,1952-06-26,4,1973,1977,"DET,CLR"
George Hainsworth*,1895-06-26,10,1927,1937,"MTL,TOR"
Brad Jones,1965-06-26,5,1987,1992,"WIN,LAK,PHI"
Ed Jovanovski,1976-06-26,18,1996,2014,"FLA,VAN,PHX"
Steve Junker,1972-06-26,0,1994,1994,NYI
Kirk McLean,1966-06-26,15,1986,2001,"NJD,VAN,CAR,FLA,NYR"
Cody McLeod,1984-06-26,11,2008,2019,"COL,NSH,NYR"
Tex White,1900-06-26,5,1926,1931,"PTP,NYA,PHQ"
Mike Angelidis,1985-06-27,4,2012,2016,TBL
Eric Cairns,1974-06-27,10,1997,2007,"NYR,NYI,FLA,PIT"
Stephane Charbonneau,1970-06-27,0,1992,1992,QUE
Rich Costello,1963-06-27,2,1984,1986,TOR
Justin Hodgman,1988-06-27,0,2015,2015,ARI
Bruce Holloway,1963-06-27,0,1985,1985,VAN
George Horne,1904-06-27,3,1926,1929,"MTM,TOR"
Lou Jankowski,1931-06-27,4,1951,1955,"DET,CBH"
D.J. King,1984-06-27,5,2007,2012,"STL,WSH"
Don Laurence,1957-06-27,1,1979,1980,"ATF,STL"
Oleg Mikulchik,1964-06-27,2,1994,1996,"WIN,MDA"
Armand Mondou,1905-06-27,11,1929,1940,MTL
Vojtech Polak,1985-06-27,1,2006,2007,DAL
Yip Radley,1908-06-27,6,1931,1937,"NYA,MTM"
Don Raleigh,1926-06-27,12,1944,1956,NYR
German Rubtsov,1998-06-27,0,2020,2020,PHI
Tommi Santala,1979-06-27,3,2004,2007,"ATL,VAN"
Doug Shelton,1945-06-27,0,1968,1968,CBH
Calvin Thurkauf,1997-06-27,0,2020,2020,CBJ
Sean Toomey,1965-06-27,0,1987,1987,MNS
Mark Visheau,1973-06-27,5,1994,1999,"WIN,LAK"
Joel Edmundson,1993-06-28,4,2016,2020,"STL,CAR"
George Gee,1922-06-28,8,1946,1954,"CBH,DET"
Joe Ironstone,1898-06-28,2,1926,1928,"NYA,TOR"
Ric Jackman,1978-06-28,7,2000,2007,"DAL,BOS,TOR,PIT,FLA,ANA"
Bill Jennings,1916-06-28,4,1941,1945,"DET,BOS"
Earl Johnson,1931-06-28,0,1954,1954,DET
Brad Larsen,1977-06-28,10,1998,2008,"COL,ATL"
Patrice Lefebvre,1967-06-28,0,1999,1999,WSH
Norm McAtee,1921-06-28,0,1947,1947,BOS
Roland Melanson,1960-06-28,11,1981,1992,"NYI,MNS,LAK,NJD,MTL"
Lance Nethery,1957-06-28,1,1981,1982,"NYR,EDM"
Niklas Nordgren,1979-06-28,0,2006,2006,"CAR,PIT"
George Parsons,1914-06-28,2,1937,1939,TOR
Muzz Patrick,1915-06-28,8,1938,1946,NYR
Steve Rooney,1962-06-28,4,1985,1989,"MTL,WIN,NJD"
Brett Skinner,1983-06-28,0,2009,2009,NYI
Garret Sparks,1993-06-28,4,2016,2020,"TOR,VEG"
Gary Veneruzzo,1943-06-28,4,1968,1972,STL
Tony Virta,1972-06-28,0,2002,2002,MIN
Jim Watson,1943-06-28,8,1964,1972,"DET,BUF"
Ty Arbour,1896-06-29,4,1927,1931,"PTP,CBH"
Christopher Breen,1989-06-29,0,2014,2014,CGY
Doug Buhr,1949-06-29,0,1975,1975,KCS
Joe Finley,1987-06-29,1,2012,2013,"BUF,NYI"
Theoren Fleury,1968-06-29,14,1989,2003,"CGY,COL,NYR,CHI"
Craig Hartsburg,1959-06-29,9,1980,1989,MNS
Petr Kalus,1987-06-29,3,2007,2010,"BOS,MIN"
Brian Lawton,1965-06-29,9,1984,1993,"MNS,HAR,NYR,BOS,QUE,SJS"
Drew LeBlanc,1989-06-29,0,2013,2013,CHI
Joey Mormina,1982-06-29,0,2008,2008,CAR
Tyler Moss,1975-06-29,5,1998,2003,"CGY,CAR,VAN"
John Pohl,1979-06-29,4,2004,2008,"STL,TOR"
Stephane Roy,1967-06-29,0,1988,1988,MNS
Prestin Ryan,1980-06-29,0,2006,2006,VAN
Peter Sidorkiewicz,1963-06-29,10,1988,1998,"HAR,OTT,NJD"
Mike Sillinger,1971-06-29,18,1991,2009,"DET,MDA,VAN,PHI,TBL,FLA,OTT,CBJ,PHX,STL,NSH,NYI"
Rick Smith,1948-06-29,12,1969,1981,"BOS,CGS,STL,DET,WSH"
Kai Suikkanen,1959-06-29,1,1982,1983,BUF
Jussi Timonen,1983-06-29,0,2007,2007,PHI
Andrew Alberts,1981-06-30,8,2006,2014,"BOS,PHI,CAR,VAN"
Jack Caffery,1934-06-30,3,1955,1958,"TOR,BOS"
Jonathan Delisle,1977-06-30,0,1999,1999,MTL
Steve Duchesne,1965-06-30,15,1987,2002,"LAK,PHI,QUE,STL,OTT,DET"
Ted Fauss,1961-06-30,1,1987,1988,TOR
Craig Fisher,1970-06-30,7,1990,1997,"PHI,WIN,FLA"
Karl Friesen,1958-06-30,0,1987,1987,NJD
Bob Froese,1958-06-30,7,1983,1990,"PHI,NYR"
Ken Gernander,1969-06-30,8,1996,2004,NYR
Ron Harris,1942-06-30,13,1963,1976,"DET,OAK,ATF,NYR"
Don Head,1933-06-30,0,1962,1962,BOS
Taro Hirose,1996-06-30,1,2019,2020,DET
Ted Hodgson,1945-06-30,0,1967,1967,BOS
Jason Jaffray,1981-06-30,4,2008,2012,"VAN,CGY,WPG"
Randy Ladouceur,1960-06-30,13,1983,1996,"DET,HAR,MDA"
Jamie McLennan,1971-06-30,13,1994,2007,"NYI,STL,MIN,CGY,NYR,FLA"
Jim Montgomery,1969-06-30,9,1994,2003,"STL,MTL,PHI,SJS,DAL"
Chris Pusey,1965-06-30,0,1986,1986,DET
Bert Robertsson,1974-06-30,3,1998,2001,"VAN,EDM,NYR"
Dalton Smith,1992-06-30,0,2020,2020,BUF
Karl Stewart,1983-06-30,4,2004,2008,"ATL,CHI,PIT,TBL"
Orval Tessier,1933-06-30,6,1955,1961,"MTL,BOS"
Rob Tudor,1956-06-30,4,1979,1983,"VAN,STL"
Steve Weeks,1958-06-30,12,1981,1993,"NYR,HAR,VAN,LAK,NYI,OTT"
Justin Bailey,1995-07-01,4,2016,2020,"BUF,PHI,VAN"
John Barrett,1958-07-01,7,1981,1988,"DET,WSH,MNS"
Adam Berti,1986-07-01,0,2008,2008,CHI
Bill Beveridge,1909-07-01,13,1930,1943,"DTC,OTS,STE,MTM,NYR"
Shawn Burr,1966-07-01,15,1985,2000,"DET,TBL,SJS"
Mike Eastwood,1967-07-01,12,1992,2004,"TOR,WIN,NYR,PHX,STL,CHI,PIT"
Scott Fankhouser,1975-07-01,1,2000,2001,ATL
Rod Gilbert*,1941-07-01,17,1961,1978,NYR
Corey Hirsch,1972-07-01,10,1993,2003,"NYR,VAN,WSH,DAL"
Jarome Iginla*,1977-07-01,20,1997,2017,"CGY,PIT,BOS,COL,LAK"
Claude Laforge,1936-07-01,11,1958,1969,"MTL,DET,PHI"
Dan McGillis,1972-07-01,9,1997,2006,"EDM,PHI,BOS,SJS,NJD"
Karri Ramo,1986-07-01,9,2007,2016,"TBL,CGY"
Les Ramsay,1920-07-01,0,1945,1945,CBH
Brett Ritchie,1993-07-01,5,2015,2020,"DAL,BOS"
Rob Schremp,1986-07-01,4,2007,2011,"EDM,NYI,ATL"
Steve Shutt*,1952-07-01,12,1973,1985,"MTL,LAK"
Martin Spanhel,1977-07-01,1,2001,2002,CBJ
Maxim Sushinsky,1974-07-01,0,2001,2001,MIN
Iiro Tarkki,1985-07-01,0,2012,2012,ANA
Chris Tierney,1994-07-01,5,2015,2020,"SJS,OTT"
Fred Williams,1956-07-01,0,1977,1977,DET
Danil Yurtaykin,1997-07-01,0,2020,2020,SJS
J.T. Brown,1990-07-02,7,2012,2019,"TBL,ANA,MIN"
Lorne Carr,1910-07-02,12,1934,1946,"NYR,NYA,TOR"
Eric Daze,1975-07-02,11,1995,2006,CHI
Roger Hagglund,1961-07-02,0,1985,1985,QUE
Brett Harkins,1970-07-02,7,1995,2002,"BOS,FLA,CBJ"
Ryan Huska,1975-07-02,0,1998,1998,CHI
Dominik Kahun,1995-07-02,1,2019,2020,"CHI,BUF,PIT"
Paul Lawless,1964-07-02,7,1983,1990,"HAR,PHI,VAN,TOR"
Dave Logan,1954-07-02,5,1976,1981,"CBH,VAN"
George McPhee,1958-07-02,5,1984,1989,"NYR,NJD"
Vladimir Sobotka,1987-07-02,12,2008,2020,"BOS,STL,BUF"
Robert Thomas,1999-07-02,1,2019,2020,STL
Joe Thornton,1979-07-02,22,1998,2020,"BOS,SJS"
Tomas Vokoun,1976-07-02,16,1997,2013,"MTL,NSH,FLA,WSH,PIT"
Aaron Voros,1981-07-02,3,2008,2011,"MIN,NYR,ANA"
Kenny Wharram,1933-07-02,17,1952,1969,CBH
Adrian Aucoin,1973-07-03,18,1995,2013,"VAN,TBL,NYI,CHI,CGY,PHX,CBJ"
Ace Bailey*,1903-07-03,7,1927,1934,TOR
Wade Belak,1976-07-03,14,1997,2011,"COL,CGY,TOR,FLA,NSH"
Andy Bellemer,1903-07-03,0,1933,1933,MTM
Ryan Christie,1978-07-03,2,2000,2002,"DAL,CGY"
Mike Connolly,1989-07-03,0,2012,2012,COL
Cully Dahlstrom,1912-07-03,7,1938,1945,CBH
Jarmo Kekalainen,1966-07-03,4,1990,1994,"BOS,OTT"
Anders Lee,1990-07-03,7,2013,2020,NYI
Dave Lewis,1953-07-03,14,1974,1988,"NYI,LAK,NJD,DET"
Hakan Loob,1960-07-03,5,1984,1989,CGY
Matthew Lorito,1990-07-03,0,2017,2017,DET
Warren Luhning,1975-07-03,2,1998,2000,"NYI,DAL"
Antti Miettinen,1980-07-03,9,2004,2013,"DAL,MIN,WPG"
Teppo Numminen,1968-07-03,20,1989,2009,"WIN,PHX,DAL,BUF"
Andrey Pedan,1993-07-03,0,2016,2016,VAN
Dennis Rasmussen,1990-07-03,2,2016,2018,"CHI,ANA"
Teemu Selanne*,1970-07-03,21,1993,2014,"WIN,MDA,SJS,COL,ANA"
Don Webster,1924-07-03,0,1944,1944,TOR
John Bednarski,1952-07-04,5,1975,1980,"NYR,EDM"
Trevor Carrick,1994-07-04,4,2016,2020,"CAR,SJS"
Milan Chalupa,1953-07-04,0,1985,1985,DET
Mike Crowley,1975-07-04,3,1998,2001,MDA
Wilf Cude,1910-07-04,10,1931,1941,"PHQ,BOS,CBH,DET,MTL"
Vic Desjardins,1900-07-04,1,1931,1932,"CBH,NYR"
Jason Dickinson,1995-07-04,4,2016,2020,DAL
Reinhard Divis,1975-07-04,4,2002,2006,STL
Art Duncan,1891-07-04,4,1927,1931,"DTC,TOR"
Joe Fisher,1916-07-04,3,1940,1943,DET
Jake Forbes,1897-07-04,13,1920,1933,"TRS,HAM,NYA,PHQ"
Jake Gardiner,1990-07-04,8,2012,2020,"TOR,CAR"
Keith Kinkaid,1989-07-04,7,2013,2020,"NJD,MTL"
Mike Knuble,1972-07-04,16,1997,2013,"DET,NYR,BOS,PHI,WSH"
Artturi Lehkonen,1995-07-04,3,2017,2020,MTL
Kevin McClelland,1962-07-04,12,1982,1994,"PIT,EDM,DET,TOR,WIN"
Bjorn Melin,1981-07-04,0,2007,2007,ANA
Steve Rucchin,1971-07-04,12,1995,2007,"MDA,NYR,ATL"
Pat Stapleton,1940-07-04,11,1962,1973,"BOS,CBH"
Marcel Tremblay,1915-07-04,0,1939,1939,MTL
Juha Widing,1947-07-04,7,1970,1977,"LAK,NYR,CLE"
Todd Bidner,1961-07-05,0,1982,1982,WSH
Christoph Brandner,1975-07-05,0,2004,2004,MIN
Lucas Carlsson,1997-07-05,0,2020,2020,CHI
Gene Carrigan,1907-07-05,4,1931,1935,"NYR,STE"
Michael Caruso,1988-07-05,0,2013,2013,FLA
Frank Eddolls,1921-07-05,7,1945,1952,"MTL,NYR"
Chris Gratton,1975-07-05,15,1994,2009,"TBL,PHI,BUF,PHX,COL,FLA,CBJ"
Chris Hajt,1978-07-05,3,2001,2004,"EDM,WSH"
Danton Heinen,1995-07-05,3,2017,2020,"BOS,ANA"
Trent Hunter,1980-07-05,9,2003,2012,"NYI,LAK"
Ron Ingram,1933-07-05,8,1957,1965,"CBH,DET,NYR"
Dwight King,1989-07-05,6,2011,2017,"LAK,MTL"
John LeClair,1969-07-05,16,1991,2007,"MTL,PHI,PIT"
Alexandre Picard,1985-07-05,6,2006,2012,"PHI,TBL,OTT,CAR,MTL,PIT"
Joe Piskula,1984-07-05,8,2007,2015,"LAK,CGY,NSH"
Alexander Radulov,1986-07-05,13,2007,2020,"NSH,MTL,DAL"
Michal Sykora,1973-07-05,7,1994,2001,"SJS,CHI,TBL,PHI"
Cam Talbot,1987-07-05,6,2014,2020,"NYR,EDM,PHI,CGY"
Brad Tiley,1971-07-05,3,1998,2001,"PHX,PHI"
Sparky Vail,1906-07-05,1,1929,1930,NYR
Doug Wilson*,1957-07-05,15,1978,1993,"CBH,CHI,SJS"
Dwayne Zinger,1976-07-05,0,2004,2004,WSH
George Armstrong*,1930-07-06,21,1950,1971,TOR
Carter Camper,1988-07-06,0,2012,2012,BOS
Eric Comrie,1995-07-06,3,2017,2020,"WPG,DET"
Greg Crozier,1976-07-06,0,2001,2001,PIT
Klas Dahlbeck,1991-07-06,3,2015,2018,"ARI,CHI,CAR"
Chris Dingman,1976-07-06,8,1998,2006,"CGY,COL,CAR,TBL"
Ron Duguay,1957-07-06,11,1978,1989,"NYR,DET,PIT,LAK"
Christian Ehrhoff,1982-07-06,12,2004,2016,"SJS,VAN,BUF,PIT,CHI,LAK"
Anders Kallur,1952-07-06,5,1980,1985,NYI
Vitali Karamnov,1968-07-06,2,1993,1995,STL
Jesperi Kotkaniemi,2000-07-06,1,2019,2020,MTL
Andrew McKim,1970-07-06,2,1993,1995,"BOS,DET"
Hal Murphy,1927-07-06,0,1953,1953,MTL
Rob O'Gara,1993-07-06,1,2017,2018,"BOS,NYR"
Ted Ouimet,1947-07-06,0,1969,1969,STL
Brad Park*,1948-07-06,16,1969,1985,"NYR,BOS,DET"
Bill Plager,1945-07-06,8,1968,1976,"MNS,STL,ATF"
Justin Schultz,1990-07-06,7,2013,2020,"EDM,PIT"
Harold Starr,1906-07-06,6,1930,1936,"OTS,MTM,MTL,NYR"
Steve Sullivan,1974-07-06,17,1996,2013,"NJD,TOR,CHI,NSH,PIT,PHX"
Joe Watson,1943-07-06,14,1965,1979,"BOS,PHI,CLR"
Darryl Boyce,1984-07-07,4,2008,2012,"TOR,CBJ"
Gerry Brown,1917-07-07,4,1942,1946,DET
Jack Capuano,1966-07-07,2,1990,1992,"TOR,VAN,BOS"
Eriah Hayes,1988-07-07,1,2014,2015,SJS
Tony Hrkac,1966-07-07,15,1988,2003,"STL,QUE,CHI,SJS,DAL,EDM,MDA,NYI,ATL"
Patrick Lalime,1974-07-07,14,1997,2011,"PIT,OTT,STL,CHI,BUF"
Mickey McGuire,1898-07-07,1,1927,1928,PTP
Hunter Miska,1995-07-07,0,2019,2019,ARI
Rumun Ndur,1975-07-07,3,1997,2000,"BUF,NYR,ATL"
Timo Pielmeier,1989-07-07,0,2011,2011,ANA
Lynn Powis,1949-07-07,1,1974,1975,"CBH,KCS"
Joe Sakic*,1969-07-07,20,1989,2009,"QUE,COL"
Randy Smith,1965-07-07,1,1986,1987,MNS
Ed Staniowski,1955-07-07,9,1976,1985,"STL,WIN,HAR"
Larry Trader,1963-07-07,5,1983,1988,"DET,STL,MTL"
Travis Turnbull,1986-07-07,0,2012,2012,BUF
Eric Chouinard,1980-07-08,5,2001,2006,"MTL,PHI,MIN"
Gary Coalter,1950-07-08,1,1974,1975,"CGS,KCS"
Andrew Copp,1994-07-08,5,2015,2020,WPG
Mike Duco,1987-07-08,2,2010,2012,"FLA,VAN"
Michel Dumas,1949-07-08,2,1975,1977,CBH
Karl Dykhuis,1972-07-08,12,1992,2004,"CHI,PHI,TBL,MTL"
Jan Erixon,1962-07-08,9,1984,1993,NYR
Glen Featherstone,1968-07-08,8,1989,1997,"STL,BOS,HAR,NYR,CGY"
Haydn Fleury,1996-07-08,2,2018,2020,CAR
Alexei Gusarov,1964-07-08,10,1991,2001,"QUE,COL,NYR,STL"
Nikita Gusev,1992-07-08,0,2020,2020,NJD
Dale Hoganson,1949-07-08,12,1970,1982,"LAK,MTL,QUE"
Larry Huras,1955-07-08,0,1977,1977,NYR
Dean Kukan,1993-07-08,4,2016,2020,CBJ
Johan Lindbom,1971-07-08,0,1998,1998,NYR
Zack MacEwen,1996-07-08,1,2019,2020,VAN
Brad Maxwell,1957-07-08,9,1978,1987,"MNS,QUE,TOR,NYR,VAN"
Hubie McDonough,1963-07-08,4,1989,1993,"LAK,NYI,SJS"
Dave Pasin,1966-07-08,3,1986,1989,"BOS,LAK"
Rich Peverley,1982-07-08,7,2007,2014,"NSH,ATL,BOS,DAL"
John Polich,1916-07-08,1,1940,1941,NYR
Mike Ridley,1963-07-08,11,1986,1997,"NYR,WSH,TOR,VAN"
Doug Rombough,1950-07-08,3,1973,1976,"BUF,NYI,MNS"
Len Ronson,1936-07-08,8,1961,1969,"NYR,OAK"
Greg Smith,1955-07-08,12,1976,1988,"CGS,CLE,MNS,DET,WSH"
Colin Stuart,1982-07-08,4,2008,2012,"ATL,BUF"
Leif Svensson,1951-07-08,1,1979,1980,WSH
Tom Anderson,1910-07-09,7,1935,1942,"DET,NYA,BRO"
Chris Campoli,1984-07-09,6,2006,2012,"NYI,OTT,CHI,MTL"
Steve Dubinsky,1970-07-09,9,1994,2003,"CHI,CGY,NSH,STL"
Frank Finnigan,1903-07-09,13,1924,1937,"OTS,TOR,STE"
Jim Harrison,1947-07-09,11,1969,1980,"BOS,TOR,CBH,EDM"
Phil Hergesheimer,1914-07-09,3,1940,1943,"CBH,BOS"
Red Kelly*,1927-07-09,19,1948,1967,"DET,TOR"
Geordie Kinnear,1973-07-09,0,2000,2000,ATL
Randy MacGregor,1953-07-09,0,1982,1982,HAR
Mike Mitchell,1893-07-09,2,1920,1922,TRS
Larry Molyneaux,1912-07-09,1,1938,1939,NYR
Gavin Morgan,1976-07-09,0,2004,2004,DAL
Andre Pronovost,1936-07-09,11,1957,1968,"MTL,BOS,DET,MNS"
Mike Richard,1966-07-09,2,1988,1990,WSH
Karlis Skrastins,1974-07-09,12,1999,2011,"NSH,COL,FLA,DAL"
Tim Stapleton,1982-07-09,3,2009,2012,"TOR,ATL,WPG"
Bill Summerhill,1915-07-09,3,1939,1942,"MTL,BRO"
John Wilkinson,1911-07-09,0,1944,1944,BOS
Robert Wood,1930-07-09,0,1951,1951,NYR
Ron Andruff,1953-07-10,4,1975,1979,"MTL,CLR"
B.J. Crombeen,1985-07-10,7,2008,2015,"DAL,STL,TBL,ARI"
Nick Damore,1916-07-10,0,1942,1942,BOS
Jim Ennis,1967-07-10,0,1988,1988,EDM
Kevin Evans,1965-07-10,1,1991,1992,"MNS,SJS"
Adam Foote,1971-07-10,19,1992,2011,"QUE,COL,CBJ"
Shane Gersich,1996-07-10,0,2018,2018,WSH
Egor Korshkov,1996-07-10,0,2020,2020,TOR
Mark LaForest,1962-07-10,8,1986,1994,"DET,PHI,TOR,OTT"
J.C. Lipon,1993-07-10,0,2016,2016,WPG
George Massecar,1904-07-10,2,1930,1932,NYA
Marcel Mueller,1988-07-10,0,2011,2011,TOR
Alain Nasreddine,1975-07-10,9,1999,2008,"CHI,MTL,NYI,PIT"
Warren Peters,1982-07-10,3,2009,2012,"CGY,DAL,MIN"
Geoff Platt,1985-07-10,2,2006,2008,"CBJ,ANA"
Glenn Resch,1948-07-10,13,1974,1987,"NYI,CLR,NJD,PHI"
Ilkka Sinisalo,1958-07-10,10,1982,1992,"PHI,LAK,MNS"
Blake Wesley,1959-07-10,6,1980,1986,"PHI,HAR,QUE,TOR"
Bill Barber*,1952-07-11,11,1973,1984,PHI
Todd Bergen,1963-07-11,0,1985,1985,PHI
Jordan Binnington,1993-07-11,4,2016,2020,STL
Andrew Bodnarchuk,1988-07-11,6,2010,2016,"BOS,CBJ,COL"
Eddie Bush,1918-07-11,3,1939,1942,DET
Dave Chyzowski,1971-07-11,7,1990,1997,"NYI,CHI"
Stephane Da Costa,1989-07-11,3,2011,2014,OTT
Gaetan Duchesne,1962-07-11,13,1982,1995,"WSH,QUE,MNS,SJS,FLA"
Bill Folk,1927-07-11,1,1952,1953,DET
Brett Hauer,1971-07-11,6,1996,2002,"EDM,NSH"
Terry Holbrook,1950-07-11,1,1973,1974,MNS
Bob Joyce,1966-07-11,5,1988,1993,"BOS,WSH,WIN"
Al MacInnis*,1963-07-11,22,1982,2004,"CGY,STL"
Clarence MacKenzie,1909-07-11,0,1933,1933,CBH
Mark Mancari,1985-07-11,5,2007,2012,"BUF,VAN"
Mike Morrison,1979-07-11,1,2006,2007,"EDM,OTT,PHX"
Joe Pavelski,1984-07-11,13,2007,2020,"SJS,DAL"
Nicholas Petrecki,1989-07-11,0,2013,2013,SJS
Jorgen Pettersson,1956-07-11,5,1981,1986,"STL,HAR,WSH"
Ben Smith,1988-07-11,6,2011,2017,"CHI,SJS,TOR,COL"
Sid Smith,1925-07-11,11,1947,1958,TOR
Ron Stewart,1932-07-11,20,1953,1973,"TOR,BOS,NYR,STL,VAN,NYI"
Ryan Strome,1993-07-11,6,2014,2020,"NYI,EDM,NYR"
Jean-Guy Talbot,1932-07-11,16,1955,1971,"MTL,DET,MNS,STL,BUF"
Vincent Trocheck,1993-07-11,6,2014,2020,"FLA,CAR"
Sandy Beadle,1960-07-12,0,1981,1981,WIN
Mark Borowiecki,1989-07-12,8,2012,2020,OTT
Dan Boyle,1976-07-12,17,1999,2016,"FLA,TBL,SJS,NYR"
Jonas Brodin,1993-07-12,7,2013,2020,MIN
Don Campbell,1925-07-12,0,1944,1944,CBH
Nels Crutchfield,1911-07-12,0,1935,1935,MTL
Peter Eriksson,1965-07-12,0,1990,1990,EDM
Bob Fillion,1921-07-12,6,1944,1950,MTL
Paul Hurley,1946-07-12,0,1969,1969,BOS
Pete Leswick,1916-07-12,8,1937,1945,"NYA,BOS"
Gilles Meloche,1950-07-12,17,1971,1988,"CBH,CGS,CLE,MNS,PIT"
Craig Millar,1976-07-12,4,1997,2001,"EDM,NSH,TBL"
Samuel Morin,1995-07-12,3,2017,2020,PHI
Nick Palmieri,1989-07-12,2,2010,2012,"NJD,MIN"
Tom Price,1954-07-12,4,1975,1979,"CGS,CLE,PIT"
Matt Ravlich,1938-07-12,10,1963,1973,"BOS,CBH,DET,LAK"
Mark Rycroft,1978-07-12,5,2002,2007,"STL,COL"
Peter Schaefer,1977-07-12,12,1999,2011,"VAN,OTT,BOS"
Brandon Segal,1983-07-12,4,2009,2013,"TBL,DAL,LAK,NYR"
Dave Semenko,1957-07-12,8,1980,1988,"EDM,HAR,TOR"
Jean-Francois Berube,1991-07-13,2,2016,2018,"NYI,CHI"
Punch Broadbent*,1892-07-13,10,1919,1929,"OTS,MTM,NYA"
Bob Carpenter,1963-07-13,17,1982,1999,"WSH,LAK,NYR,BOS,NJD"
Rick Chartraw,1954-07-13,9,1975,1984,"MTL,LAK,NYR,EDM"
Bill Collins,1943-07-13,10,1968,1978,"MNS,DET,MTL,STL,NYR,PHI,WSH"
Brian Finley,1981-07-13,4,2003,2007,"NSH,BOS"
Dan Fritsche,1985-07-13,5,2004,2009,"CBJ,MIN,NYR"
Andreas Lilja,1975-07-13,12,2001,2013,"LAK,FLA,DET,ANA,PHI"
Larry McIntyre,1949-07-13,3,1970,1973,TOR
Ken Mosdell,1922-07-13,16,1942,1958,"BRO,MTL,CBH"
Josh Olson,1981-07-13,0,2004,2004,FLA
Mika Pyorala,1981-07-13,0,2010,2010,PHI
Mike Reilly,1993-07-13,4,2016,2020,"MIN,MTL,OTT"
Rasmus Rissanen,1991-07-13,0,2015,2015,CAR
Shaun Sabol,1966-07-13,0,1990,1990,PHI
Sheldon Souray,1976-07-13,15,1998,2013,"NJD,MTL,EDM,DAL,ANA"
Bill Terry,1961-07-13,0,1988,1988,MNS
Darcy Verot,1976-07-13,0,2004,2004,WSH
Brian Wiseman,1971-07-13,0,1997,1997,TOR
Lubos Bartecko,1976-07-14,4,1999,2003,"STL,ATL"
Nathan Dempsey,1974-07-14,10,1997,2007,"TOR,CHI,LAK,BOS"
Mark Freer,1968-07-14,7,1987,1994,"PHI,OTT,CGY"
Armand Gaudreault,1921-07-14,0,1945,1945,BOS
John Gibson,1993-07-14,6,2014,2020,ANA
Benny Grant,1908-07-14,15,1929,1944,"TOR,NYA,BOS"
Ray Hannigan,1927-07-14,0,1949,1949,TOR
Ron Hudson,1911-07-14,2,1938,1940,DET
Josh Jooris,1990-07-14,3,2015,2018,"CGY,ARI,NYR,CAR,PIT"
Nikolai Kulemin,1986-07-14,9,2009,2018,"TOR,NYI"
Kevin McCarthy,1957-07-14,9,1978,1987,"PHI,VAN,PIT"
Mike McPhee,1960-07-14,10,1984,1994,"MTL,MNS,DAL"
Don Morrison,1923-07-14,3,1948,1951,"DET,CBH"
Harold Phillipoff,1956-07-14,2,1978,1980,"ATF,CBH"
Bobby Reynolds,1967-07-14,0,1990,1990,TOR
Matt Zaba,1983-07-14,0,2010,2010,NYR
Chuck Arnason,1951-07-15,7,1972,1979,"MTL,ATF,PIT,KCS,CLR,CLE,MNS,WSH"
Anthony Bitetto,1990-07-15,5,2015,2020,"NSH,MIN,WPG"
Zach Bogosian,1990-07-15,11,2009,2020,"ATL,WPG,BUF,TBL"
Jonathan Cheechoo,1980-07-15,7,2003,2010,"SJS,OTT"
Peter Ciavaglia,1969-07-15,1,1992,1993,BUF
Anthony Cirelli,1997-07-15,2,2018,2020,TBL
Adam Cracknell,1985-07-15,8,2011,2019,"STL,CBJ,EDM,VAN,DAL,NYR,ANA"
Kevin Doell,1979-07-15,0,2008,2008,ATL
Gary Donaldson,1952-07-15,0,1974,1974,CBH
John Flesch,1953-07-15,5,1975,1980,"MNS,PIT,CLR"
Bryan Helmer,1972-07-15,10,1999,2009,"PHX,STL,VAN,WSH"
Andrew Joudrey,1984-07-15,0,2012,2012,CBJ
Rick Kehoe,1951-07-15,13,1972,1985,"TOR,PIT"
Tyler Kennedy,1986-07-15,8,2008,2016,"PIT,SJS,NYI,NJD"
Eric Lacroix,1971-07-15,7,1994,2001,"TOR,LAK,COL,NYR,OTT"
Mikko Leinonen,1955-07-15,3,1982,1985,"NYR,WSH"
Ed Litzenberger,1932-07-15,11,1953,1964,"MTL,CBH,DET,TOR"
John McKinnon,1902-07-15,5,1926,1931,"MTL,PTP,PHQ"
Barry Melrose,1956-07-15,6,1980,1986,"WIN,TOR,DET"
Bill Muckalt,1974-07-15,4,1999,2003,"VAN,NYI,OTT,MIN"
Steve Thomas,1963-07-15,19,1985,2004,"TOR,CHI,NYI,NJD,MDA,DET"
Bill Wylie,1928-07-15,0,1951,1951,NYR
Will Acton,1987-07-16,1,2014,2015,EDM
Dustin Boyd,1986-07-16,4,2007,2011,"CGY,NSH,MTL"
Archie Briden,1898-07-16,3,1927,1930,"BOS,DTC,PTP"
Kevan Guy,1965-07-16,5,1987,1992,"CGY,VAN"
Duncan Keith,1983-07-16,14,2006,2020,CHI
Julian Klymkiw,1933-07-16,0,1959,1959,NYR
Brian Lashoff,1990-07-16,7,2013,2020,DET
Claude Lemieux,1965-07-16,25,1984,2009,"MTL,NJD,COL,PHX,DAL,SJS"
Jyrki Lumme,1966-07-16,14,1989,2003,"MTL,VAN,PHX,DAL,TOR"
Jay Miller,1960-07-16,6,1986,1992,"BOS,LAK"
Bob Murray,1948-07-16,3,1974,1977,"ATF,VAN"
Jay Rosehill,1985-07-16,4,2010,2014,"TOR,PHI"
Nate Schmidt,1991-07-16,6,2014,2020,"WSH,VEG"
Paxton Schulte,1972-07-16,3,1994,1997,"QUE,CGY"
Maynard Schurman,1957-07-16,0,1980,1980,HAR
Mikhail Tatarinov,1966-07-16,3,1991,1994,"WSH,QUE,BOS"
Spence Tatchell,1924-07-16,0,1943,1943,NYR
Bob Whitlock,1949-07-16,0,1970,1970,MNS
Nick Bjugstad,1992-07-17,7,2013,2020,"FLA,PIT"
Joachim Blichfeld,1998-07-17,0,2020,2020,SJS
Jay Caufield,1960-07-17,6,1987,1993,"NYR,MNS,PIT"
Carson Cooper,1899-07-17,7,1925,1932,"BOS,MTL,DTC,DTF"
Hank D'Amore,1919-07-17,0,1944,1944,NYR
Darren Dietz,1993-07-17,0,2016,2016,MTL
Oliver Ekman-Larsson,1991-07-17,9,2011,2020,"PHX,ARI"
Loui Eriksson,1985-07-17,13,2007,2020,"DAL,BOS,VAN"
Shorty Green*,1896-07-17,3,1924,1927,"HAM,NYA"
Ben Guite,1978-07-17,4,2006,2010,"BOS,COL,NSH"
Michal Jordan,1990-07-17,3,2013,2016,CAR
Josh Langfeld,1977-07-17,6,2002,2008,"OTT,BOS,SJS,DET,NSH"
Jack Laviolette*,1879-07-17,0,1918,1918,MTL
Ryan Miller,1980-07-17,17,2003,2020,"BUF,STL,VAN,ANA"
Marc Moro,1977-07-17,4,1998,2002,"MDA,NSH,TOR"
Trevor Murphy,1995-07-17,0,2018,2018,ARI
Ron Plumb,1950-07-17,0,1980,1980,HAR
Marc Savard,1977-07-17,13,1998,2011,"NYR,CGY,ATL,BOS"
Tommy Soderstrom,1969-07-17,4,1993,1997,"PHI,NYI"
Jason Strudwick,1975-07-17,15,1996,2011,"NYI,VAN,CHI,NYR,EDM"
Dave Tataryn,1950-07-17,0,1977,1977,NYR
Skip Teal,1933-07-17,0,1955,1955,BOS
Bryan Trottier*,1956-07-17,18,1976,1994,"NYI,PIT"
Alexander True,1997-07-17,0,2020,2020,SJS
Linden Vey,1991-07-17,3,2014,2017,"LAK,VAN,CGY"
Don Awrey,1943-07-18,15,1964,1979,"BOS,STL,MTL,PIT,NYR,CLR"
Jamie Benn,1989-07-18,10,2010,2020,DAL
Glen Currie,1958-07-18,8,1980,1988,"WSH,LAK"
Ted Harris,1936-07-18,11,1964,1975,"MTL,MNS,DET,STL,PHI"
Miro Heiskanen,1999-07-18,1,2019,2020,DAL
Ian Herbers,1967-07-18,6,1994,2000,"EDM,NYI,TBL"
Risto Jalo,1962-07-18,0,1986,1986,EDM
Melker Karlsson,1990-07-18,5,2015,2020,SJS
Mikko Koskinen,1988-07-18,9,2011,2020,"NYI,EDM"
John Mahaffy,1919-07-18,1,1943,1944,"MTL,NYR"
Marek Mazanec,1991-07-18,3,2014,2017,NSH
Gord McFarlane,1901-07-18,0,1927,1927,CBH
Jan Mertzig,1970-07-18,0,1999,1999,NYR
Casey Nelson,1992-07-18,3,2016,2019,BUF
Brandon Nolan,1983-07-18,0,2008,2008,CAR
Victor Olofsson,1995-07-18,1,2019,2020,BUF
Tony Savage,1906-07-18,0,1935,1935,"BOS,MTL"
Dennis Seidenberg,1981-07-18,15,2003,2018,"PHI,PHX,CAR,BOS,FLA,NYI"
Jean-Sebastien Aubin,1977-07-19,9,1999,2008,"PIT,TOR,LAK"
Craig Cameron,1945-07-19,9,1967,1976,"DET,STL,MNS,NYI"
Bob Carse,1919-07-19,8,1940,1948,"CBH,MTL"
Abbie Cox,1904-07-19,6,1930,1936,"MTM,DET,NYA,MTL"
Tomas Divisek,1979-07-19,1,2001,2002,PHI
Benoit Gosselin,1957-07-19,0,1978,1978,NYR
Dick Irvin*,1892-07-19,2,1927,1929,CBH
Jamie Linden,1972-07-19,0,1995,1995,FLA
Craig Muni,1962-07-19,16,1982,1998,"TOR,EDM,CHI,BUF,WIN,PIT,DAL"
Ryan O'Byrne,1984-07-19,5,2008,2013,"MTL,COL,TOR"
Steve Shields,1972-07-19,10,1996,2006,"BUF,SJS,MDA,BOS,FLA,ATL"
Devin Shore,1994-07-19,4,2016,2020,"DAL,ANA,CBJ"
Gary Simmons,1944-07-19,3,1975,1978,"CGS,CLE,LAK"
David Tanabe,1980-07-19,8,2000,2008,"CAR,PHX,BOS"
Allan Tuer,1963-07-19,4,1986,1990,"LAK,MNS,HAR"
Fedor Tyutin,1983-07-19,13,2004,2017,"NYR,CBJ,COL"
Scott Walker,1973-07-19,15,1995,2010,"VAN,NSH,CAR,WSH"
Zach Werenski,1997-07-19,3,2017,2020,CBJ
Keith Aldridge,1973-07-20,0,2000,2000,DAL
Dean Arsene,1980-07-20,0,2010,2010,EDM
Jimmy Carson,1968-07-20,9,1987,1996,"LAK,EDM,DET,VAN,HAR"
Murray Craven,1964-07-20,17,1983,2000,"DET,PHI,HAR,VAN,CHI,SJS"
Pavel Datsyuk,1978-07-20,14,2002,2016,DET
Lorne Davis,1930-07-20,8,1952,1960,"MTL,CBH,DET,BOS"
Dillon Dube,1998-07-20,1,2019,2020,CGY
Peter Forsberg*,1973-07-20,16,1995,2011,"QUE,COL,PHI,NSH"
Morgan Geekie,1998-07-20,0,2020,2020,CAR
Matt Gilroy,1984-07-20,4,2010,2014,"NYR,OTT,TBL,FLA"
Ray Giroux,1976-07-20,4,2000,2004,"NYI,NJD"
Jack Hughes,1957-07-20,1,1981,1982,CLR
Larry Johnston,1943-07-20,9,1968,1977,"LAK,DET,KCS,CLR"
Oscar Klefbom,1993-07-20,6,2014,2020,EDM
Stefan Meyer,1985-07-20,3,2008,2011,"FLA,CGY"
Terry Murray,1950-07-20,9,1973,1982,"CGS,PHI,DET,WSH"
Bill Oleschuk,1955-07-20,4,1976,1980,"KCS,CLR"
Brent Peterson,1972-07-20,2,1997,1999,TBL
Andrew Shaw,1991-07-20,8,2012,2020,"CHI,MTL"
Ryan Stanton,1989-07-20,3,2013,2016,"CHI,VAN,WSH"
Jozef Stumpel,1972-07-20,16,1992,2008,"BOS,LAK,FLA"
Nick Vachon,1972-07-20,0,1997,1997,NYI
Antoine Vermette,1982-07-20,14,2004,2018,"OTT,CBJ,PHX,ARI,CHI,ANA"
Garry Bauman,1940-07-21,2,1967,1969,"MTL,MNS"
Byron Bitz,1984-07-21,3,2009,2012,"BOS,FLA,VAN"
Guillaume Brisebois,1997-07-21,0,2019,2019,VAN
Jean-Francois Damphousse,1979-07-21,0,2002,2002,NJD
Bill Flett,1943-07-21,12,1968,1980,"LAK,PHI,TOR,ATF,EDM"
Len Grosvenor,1905-07-21,5,1928,1933,"OTS,NYA,MTL"
Timo Helbling,1981-07-21,1,2006,2007,"TBL,WSH"
Alexei Kudashov,1971-07-21,0,1994,1994,TOR
Lyle Odelein,1968-07-21,16,1990,2006,"MTL,NJD,PHX,CBJ,CHI,DAL,FLA,PIT"
Johnny Peirson,1925-07-21,11,1947,1958,BOS
Dutch Reibel,1930-07-21,5,1954,1959,"DET,CBH,BOS"
Cody Rudkowsky,1978-07-21,0,2003,2003,STL
Phil Russell,1952-07-21,14,1973,1987,"CBH,ATF,CGY,NJD,BUF"
Ron Scott,1960-07-21,6,1984,1990,"NYR,LAK"
Lou Trudel,1912-07-21,7,1934,1941,"CBH,MTL"
Sergei Varlamov,1978-07-21,5,1998,2003,"CGY,STL"
Cole Bardreau,1993-07-22,0,2020,2020,NYI
Tony Demers,1917-07-22,6,1938,1944,"MTL,NYR"
Gerry Desjardins,1944-07-22,9,1969,1978,"LAK,CBH,NYI,BUF"
Kevin Fiala,1996-07-22,5,2015,2020,"NSH,MIN"
Charles Fraser,1897-07-22,0,1924,1924,HAM
Gord Hynes,1966-07-22,1,1992,1993,"BOS,PHI"
Dmitri Kalinin,1980-07-22,9,2000,2009,"BUF,NYR,PHX"
Steven King,1969-07-22,3,1993,1996,"NYR,MDA"
Leo Labine,1931-07-22,10,1952,1962,"BOS,DET"
Marek Langhamer,1994-07-22,1,2017,2018,ARI
Tobias Lindberg,1995-07-22,0,2016,2016,TOR
Mike McNeill,1966-07-22,1,1991,1992,"CHI,QUE"
Wade Megan,1990-07-22,2,2017,2019,"STL,DET"
Charles Pletsch,1892-07-22,0,1921,1921,HAM
Claude Pronovost,1935-07-22,3,1956,1959,"BOS,MTL"
Jason Robertson,1999-07-22,0,2020,2020,DAL
Dave Rochefort,1946-07-22,0,1967,1967,DET
Brad Schlegel,1968-07-22,2,1992,1994,"WSH,CGY"
Jiri Sejba,1962-07-22,0,1991,1991,BUF
Paul Skidmore,1956-07-22,0,1982,1982,STL
Fred Speck,1947-07-22,3,1969,1972,"DET,VAN"
Wilf Starr,1909-07-22,3,1933,1936,"NYA,DET"
Sergei Zubov*,1970-07-22,16,1993,2009,"NYR,PIT,DAL"
Harvey Bennett,1925-07-23,0,1945,1945,BOS
Chuck Blair,1928-07-23,0,1949,1949,TOR
Dennis Bonvie,1973-07-23,9,1995,2004,"EDM,CHI,PIT,BOS,OTT,COL"
Earl Campbell,1900-07-23,2,1924,1926,"OTS,NYA"
Andrew Cassels,1969-07-23,16,1990,2006,"MTL,HAR,CGY,VAN,CBJ,WSH"
Scott Clemmensen,1977-07-23,13,2002,2015,"NJD,TOR,FLA"
Chuck Dinsmore,1903-07-23,5,1925,1930,MTM
Red Dutton*,1897-07-23,9,1927,1936,"MTM,NYA"
Randy Jones,1981-07-23,8,2004,2012,"PHI,LAK,TBL,WPG"
Kasperi Kapanen,1996-07-23,4,2016,2020,TOR
Dmitri Khristich,1969-07-23,11,1991,2002,"WSH,LAK,BOS,TOR"
Nick Knott,1920-07-23,0,1942,1942,BRO
Jakob Lilja,1993-07-23,0,2020,2020,CBJ
Bert Lindsay,1881-07-23,1,1918,1919,"MTW,TRA"
Peter Loob,1957-07-23,0,1985,1985,QUE
Brad Miller,1969-07-23,5,1989,1994,"BUF,OTT,CGY"
Bill Nyrop,1952-07-23,6,1976,1982,"MTL,MNS"
Dmitry Orlov,1991-07-23,8,2012,2020,WSH
Mark Osiecki,1968-07-23,1,1992,1993,"CGY,MNS,OTT,WIN"
Johnny Sheppard,1903-07-23,7,1927,1934,"DTC,NYA,BOS,CBH"
Shawn Thornton,1977-07-23,14,2003,2017,"CHI,ANA,BOS,FLA"
Glenn Tomalty,1954-07-23,0,1980,1980,WIN
B.J. Young,1977-07-23,0,2000,2000,DET
Cody Almond,1989-07-24,2,2010,2012,MIN
Johan Backlund,1981-07-24,0,2010,2010,PHI
Rick Bennett,1967-07-24,2,1990,1992,NYR
Patrice Bergeron,1985-07-24,16,2004,2020,BOS
Rosie Couture,1905-07-24,7,1929,1936,"CBH,MTL"
Red Garrett,1924-07-24,0,1943,1943,NYR
Nathan Gerbe,1987-07-24,11,2009,2020,"BUF,CAR,CBJ"
Gerry Heffernan,1916-07-24,2,1942,1944,MTL
Gord Hollingworth,1933-07-24,3,1955,1958,"CBH,DET"
Jeff Jillson,1980-07-24,4,2002,2006,"SJS,BOS,BUF"
Tanner Kero,1992-07-24,2,2016,2018,CHI
Evgeny Korolev,1978-07-24,2,2000,2002,NYI
Roger Lafreniere,1942-07-24,10,1963,1973,"DET,STL"
Jamie Langenbrunner,1975-07-24,18,1995,2013,"DAL,NJD,STL"
Robin Lehner,1991-07-24,9,2011,2020,"OTT,BUF,NYI,CHI,VEG"
David Mackey,1966-07-24,6,1988,1994,"CHI,MNS,STL"
Ray Maluta,1954-07-24,1,1976,1977,BOS
Mike Marson,1955-07-24,5,1975,1980,"WSH,LAK"
Pat Mayer,1961-07-24,0,1988,1988,PIT
Jack O'Callahan,1957-07-24,6,1983,1989,"CBH,CHI,NJD"
Christer Olsson,1970-07-24,1,1996,1997,"STL,OTT"
David Printz,1980-07-24,1,2006,2007,PHI
Trevor van Riemsdyk,1991-07-24,5,2015,2020,"CHI,CAR"
Richard Bachman,1987-07-25,8,2011,2019,"DAL,EDM,VAN"
Jake Bischoff,1994-07-25,0,2020,2020,VEG
Mathew Dumba,1994-07-25,6,2014,2020,MIN
Luke Gazdic,1989-07-25,3,2014,2017,"EDM,NJD"
Tony Granato,1964-07-25,12,1989,2001,"NYR,LAK,SJS"
Ravil Gusmanov,1972-07-25,0,1996,1996,WIN
Ed Harrison,1927-07-25,3,1948,1951,"BOS,NYR"
Samuel Henley,1993-07-25,0,2017,2017,COL
Arturs Kulda,1988-07-25,2,2010,2012,"ATL,WPG"
Johan Larsson,1992-07-25,7,2013,2020,"MIN,BUF"
George Maneluk,1967-07-25,0,1991,1991,NYI
Jordan Martinook,1992-07-25,5,2015,2020,"ARI,CAR"
Eddie Mazur,1929-07-25,3,1954,1957,"MTL,CBH"
Evgeni Nabokov,1975-07-25,15,2000,2015,"SJS,NYI,TBL"
Aldo Palazzari,1918-07-25,0,1944,1944,"BOS,NYR"
Pekka Rautakallio,1953-07-25,2,1980,1982,"ATF,CGY"
Jani Rita,1981-07-25,4,2002,2006,"EDM,PIT"
Michael Sgarbossa,1992-07-25,7,2013,2020,"COL,ANA,FLA,WSH"
Gordon Spence,1897-07-25,0,1926,1926,TRS
Peter Sullivan,1951-07-25,1,1980,1981,WIN
Corey Tropp,1989-07-25,5,2012,2017,"BUF,CBJ,ANA"
Andrei Vasilevskiy,1994-07-25,5,2015,2020,TBL
Michael Wall,1985-07-25,0,2007,2007,ANA
Tim Watters,1959-07-25,13,1982,1995,"WIN,LAK"
Sebastian Aho,1997-07-26,3,2017,2020,CAR
Lorne Anderson,1931-07-26,0,1952,1952,NYR
Norm Aubin,1960-07-26,1,1982,1983,TOR
Tyson Barrie,1991-07-26,8,2012,2020,"COL,TOR"
Jordie Benn,1987-07-26,8,2012,2020,"DAL,MTL,VAN"
Bob Bergloff,1958-07-26,0,1983,1983,MNS
Eric Calder,1963-07-26,1,1982,1983,WSH
Brian Flynn,1988-07-26,4,2013,2017,"BUF,MTL"
Oleg Kvasha,1978-07-26,7,1999,2006,"FLA,NYI,PHX"
Rod Lorrain,1914-07-26,6,1936,1942,MTL
Rick Martin,1951-07-26,10,1972,1982,"BUF,LAK"
Alec Martinez,1987-07-26,10,2010,2020,"LAK,VEG"
Barrie Meissner,1946-07-26,1,1968,1969,MNS
Peter Nordstrom,1974-07-26,0,1999,1999,BOS
Zach Redmond,1988-07-26,5,2013,2018,"WPG,COL,MTL,BUF"
Bobby Rousseau,1940-07-26,14,1961,1975,"MTL,MNS,NYR"
Philip Samuelsson,1991-07-26,2,2014,2016,"PIT,ARI"
Peter Sarno,1979-07-26,2,2004,2006,"EDM,CBJ"
Nakina Smith,1915-07-26,0,1944,1944,DET
Rodger Smith,1896-07-26,5,1926,1931,"PTP,PHQ"
Nils Tremblay,1923-07-26,1,1945,1946,MTL
Gord Wappel,1958-07-26,2,1980,1982,"ATF,CGY"
Erik Westrum,1979-07-26,3,2004,2007,"PHX,MIN,TOR"
John Adams,1946-07-27,2,1973,1975,"BOS,WSH"
George Allen,1914-07-27,8,1939,1947,"NYR,CBH,MTL"
Yohann Auvitu,1989-07-27,1,2017,2018,"NJD,EDM"
Andy Barbe,1923-07-27,0,1951,1951,TOR
Jack Bownass,1930-07-27,4,1958,1962,"MTL,NYR"
Dave Capuano,1968-07-27,4,1990,1994,"PIT,VAN,TBL,SJS"
Steve Coates,1950-07-27,0,1977,1977,DET
Andrew Desjardins,1986-07-27,6,2011,2017,"SJS,CHI"
Simon Despres,1991-07-27,5,2012,2017,"PIT,ANA"
Andre Dupont,1949-07-27,12,1971,1983,"NYR,STL,PHI,QUE"
Tyrone Garner,1978-07-27,0,1999,1999,CGY
Doug Grant,1948-07-27,6,1974,1980,"DET,STL"
Bob Hoffmeyer,1955-07-27,7,1978,1985,"CBH,PHI,NJD"
Doug Horbul,1952-07-27,0,1975,1975,KCS
Rosario Joanette,1919-07-27,0,1945,1945,MTL
Bill Johansen,1928-07-27,0,1950,1950,TOR
Jim Jones,1949-07-27,0,1972,1972,CGS
Rick Kessell,1949-07-27,4,1970,1974,"PIT,CGS"
Krys Kolanos,1981-07-27,10,2002,2012,"PHX,EDM,MIN,CGY"
Jack Mann,1919-07-27,1,1944,1945,NYR
Blake Sloan,1975-07-27,5,1999,2004,"DAL,CBJ,CGY"
Dennis Smith,1964-07-27,1,1990,1991,"WSH,LAK"
Carson Soucy,1994-07-27,2,2018,2020,MIN
Pavel Trnka,1976-07-27,6,1998,2004,"MDA,FLA"
Craig Wolanin,1967-07-27,12,1986,1998,"NJD,QUE,COL,TBL,TOR"
Jason Woolley,1969-07-27,14,1992,2006,"WSH,FLA,PIT,BUF,DET"
Barry Ashbee,1939-07-28,8,1966,1974,"BOS,PHI"
Aki Berg,1977-07-28,10,1996,2006,"LAK,TOR"
Casey Borer,1985-07-28,2,2008,2010,CAR
Hudson Fasching,1995-07-28,2,2016,2018,BUF
Drew Fata,1983-07-28,1,2007,2008,NYI
Maxime Fortunus,1983-07-28,4,2010,2014,DAL
Gilles Gratton,1952-07-28,1,1976,1977,"STL,NYR"
Noah Gregor,1998-07-28,0,2020,2020,SJS
Charlie Hodge,1933-07-28,16,1955,1971,"MTL,OAK,VAN"
Don Howse,1952-07-28,0,1980,1980,LAK
Yan Kaminsky,1971-07-28,1,1994,1995,"NYI,WIN"
Jim Korn,1957-07-28,10,1980,1990,"DET,TOR,BUF,NJD,CGY"
Lauri Korpikoski,1986-07-28,8,2009,2017,"NYR,PHX,ARI,EDM,CBJ,DAL"
Les Kuntar,1969-07-28,0,1994,1994,MTL
Jim Leavins,1960-07-28,1,1986,1987,"DET,NYR"
Dale Lewis,1952-07-28,0,1976,1976,NYR
Dennis McCord,1952-07-28,0,1974,1974,VAN
Hap Myers,1947-07-28,0,1971,1971,BUF
Zach Parise,1984-07-28,14,2006,2020,"NJD,MIN"
Evan Rodrigues,1993-07-28,4,2016,2020,"BUF,PIT"
Kevin Schamehorn,1956-07-28,4,1977,1981,"DET,LAK"
Jeff Sharples,1967-07-28,2,1987,1989,DET
Garth Snow,1969-07-28,12,1994,2006,"QUE,PHI,VAN,PIT,NYI"
Steve Staios,1973-07-28,16,1996,2012,"BOS,VAN,ATL,EDM,CGY,NYI"
Alex Stalock,1987-07-28,9,2011,2020,"SJS,MIN"
Brad Staubitz,1984-07-28,4,2009,2013,"SJS,MIN,MTL,ANA"
Jeremy Stevenson,1974-07-28,10,1996,2006,"MDA,NSH,MIN,DAL"
Moe White,1919-07-28,0,1946,1946,MTL
Ron Anderson,1945-07-29,4,1968,1972,"DET,LAK,STL,BUF"
Anton Belov,1986-07-29,0,2014,2014,EDM
Bill Benson,1920-07-29,1,1941,1942,"NYA,BRO"
Bart Bradley,1930-07-29,0,1950,1950,BOS
Dave Cameron,1958-07-29,2,1982,1984,"CLR,NJD"
Pete Conacher,1932-07-29,6,1952,1958,"CBH,NYR,TOR"
Andrew Crescenzi,1992-07-29,0,2018,2018,LAK
Dirk Graham,1959-07-29,11,1984,1995,"MNS,CHI"
Brendan Guhle,1997-07-29,3,2017,2020,"BUF,ANA"
Billy Harris,1935-07-29,13,1956,1969,"TOR,DET,OAK,PIT"
Tyler Johnson,1990-07-29,7,2013,2020,TBL
Alexei Kaigorodov,1983-07-29,0,2007,2007,OTT
Clayton Keller,1998-07-29,3,2017,2020,ARI
Geoff Kinrade,1985-07-29,0,2009,2009,TBL
Ted Lindsay*,1925-07-29,20,1945,1965,"DET,CBH"
Tye McGinn,1990-07-29,3,2013,2016,"PHI,ARI,SJS,TBL"
Andrei Mironov,1994-07-29,0,2018,2018,COL
Liam O'Brien,1994-07-29,3,2015,2018,WSH
Xavier Ouellet,1993-07-29,6,2014,2020,"DET,MTL"
Neal Pionk,1995-07-29,2,2018,2020,"NYR,WPG"
Gage Quinney,1995-07-29,0,2020,2020,VEG
Erik Reitz,1982-07-29,3,2006,2009,"MIN,NYR"
Jan Rutta,1990-07-29,2,2018,2020,"CHI,TBL"
Yevgeny Shaldybin,1975-07-29,0,1997,1997,BOS
Jerry Toppazzini,1931-07-29,11,1953,1964,"BOS,CBH,DET"
Derek Wilkinson,1974-07-29,3,1996,1999,TBL
Jesper Bratt,1998-07-30,2,2018,2020,NJD
Norm Calladine,1916-07-30,2,1943,1945,BOS
Jeff Christian,1970-07-30,6,1992,1998,"NJD,PIT,PHX"
Real Cloutier,1956-07-30,5,1980,1985,"QUE,BUF"
Alex Goligoski,1985-07-30,12,2008,2020,"PIT,DAL,ARI"
Shaun Heshka,1985-07-30,0,2010,2010,PHX
Bruce Hoffort,1966-07-30,1,1990,1991,PHI
George Johnston,1920-07-30,5,1942,1947,CBH
Dylan Larkin,1996-07-30,4,2016,2020,DET
Reed Larson,1956-07-30,13,1977,1990,"DET,BOS,EDM,MNS,NYI,BUF"
Pit Lepine,1901-07-30,12,1926,1938,MTL
Danny Markov,1976-07-30,9,1998,2007,"TOR,PHX,CAR,PHI,NSH,DET"
Markus Mattsson,1957-07-30,4,1980,1984,"WIN,LAK,MNS"
Markus Naslund,1973-07-30,15,1994,2009,"PIT,VAN,NYR"
Jack Portland,1912-07-30,9,1934,1943,"MTL,BOS,CBH"
Greg Redquest,1956-07-30,0,1978,1978,PIT
Scott Sabourin,1992-07-30,0,2020,2020,OTT
Sid Veysey,1955-07-30,0,1978,1978,VAN
Chris Ahrens,1952-07-31,4,1974,1978,MNS
Paul Andrea,1941-07-31,5,1966,1971,"NYR,PIT,BUF,CGS"
Helmut Balderis,1952-07-31,0,1990,1990,MNS
Gilles Bilodeau,1955-07-31,0,1980,1980,QUE
Lyle Bradley,1943-07-31,3,1974,1977,"CGS,CLE"
Tony Featherstone,1949-07-31,4,1970,1974,"OAK,CGS,MNS"
Jiri Fischer,1980-07-31,6,2000,2006,DET
Ray Frederick,1929-07-31,0,1955,1955,CBH
Kristers Gudlevskis,1992-07-31,3,2014,2017,TBL
Sergey Gusev,1975-07-31,3,1998,2001,"DAL,TBL"
Bryan Hextall*,1913-07-31,11,1937,1948,NYR
Dale Hunter,1960-07-31,18,1981,1999,"QUE,WSH,COL"
Ryan Johansen,1992-07-31,8,2012,2020,"CBJ,NSH"
Evgeni Malkin,1986-07-31,13,2007,2020,PIT
Dave Maloney,1956-07-31,10,1975,1985,"NYR,BUF"
Tom McCarthy,1960-07-31,8,1980,1988,"MNS,BOS"
Lloyd Mohns,1921-07-31,0,1944,1944,NYR
Troy Murray,1962-07-31,14,1982,1996,"CBH,CHI,WIN,OTT,PIT,COL"
David Sacco,1970-07-31,2,1994,1996,"TOR,MDA"
Brian Skrudland,1963-07-31,14,1986,2000,"MTL,CGY,FLA,DAL,NYR"
Derek Smith,1954-07-31,6,1977,1983,"BUF,DET"
Linus Ullmark,1993-07-31,4,2016,2020,BUF
Syl Apps,1947-08-01,9,1971,1980,"NYR,PIT,LAK"
Eddie Bruneteau,1919-08-01,8,1941,1949,DET
Marc Denis,1977-08-01,12,1997,2009,"COL,CBJ,TBL,MTL"
Benoit Dusablon,1979-08-01,0,2004,2004,NYR
Dave Farrish,1956-08-01,7,1977,1984,"NYR,QUE,TOR"
Harold Jackson,1918-08-01,10,1937,1947,"CBH,DET"
Frank Mailley,1916-08-01,0,1943,1943,MTL
Gus Marker,1907-08-01,9,1933,1942,"DET,MTM,TOR,BRO"
Bill Miller,1908-08-01,2,1935,1937,"MTM,MTL"
David Nemirovsky,1976-08-01,3,1996,1999,FLA
Jon Rheault,1986-08-01,0,2013,2013,FLA
Danny Richmond,1984-08-01,2,2006,2008,"CAR,CHI"
Bob Rivard,1939-08-01,0,1968,1968,PIT
Geordie Robertson,1959-08-01,0,1983,1983,BUF
Enio Sclisizzi,1925-08-01,5,1948,1953,"DET,CBH"
Richard Scott,1978-08-01,2,2002,2004,NYR
Anton Stralman,1986-08-01,12,2008,2020,"TOR,CBJ,NYR,TBL,FLA"
Dan Vincelette,1967-08-01,4,1988,1992,"CHI,QUE"
Jason Widmer,1973-08-01,2,1995,1997,"NYI,SJS"
Wendell Young,1963-08-01,9,1986,1995,"VAN,PHI,PIT,TBL"
Tony Amonte,1970-08-02,15,1992,2007,"NYR,CHI,PHI,PHX,CGY"
Dave Balon,1938-08-02,13,1960,1973,"NYR,MTL,MNS,VAN"
Leo Boivin*,1932-08-02,18,1952,1970,"TOR,BOS,DET,PIT,MNS"
Peter Cehlarik,1995-08-02,3,2017,2020,BOS
John Cullen,1964-08-02,10,1989,1999,"PIT,HAR,TOR,TBL"
Todd Hawkins,1966-08-02,3,1989,1992,"VAN,TOR"
Hans Jonsson,1973-08-02,3,2000,2003,PIT
Evander Kane,1991-08-02,10,2010,2020,"ATL,WPG,BUF,SJS"
Rick Lapointe,1955-08-02,10,1976,1986,"DET,PHI,STL,QUE,LAK"
Brian Marchinko,1948-08-02,3,1971,1974,"TOR,NYI"
John McCormack,1925-08-02,7,1948,1955,"TOR,MTL,CBH"
Paul Pooley,1960-08-02,1,1985,1986,WIN
Ollie Reinikka,1901-08-02,0,1927,1927,NYR
Torrie Robertson,1961-08-02,9,1981,1990,"WSH,HAR,DET"
Alexander Volkov,1997-08-02,0,2020,2020,TBL
Howie Young,1937-08-02,10,1961,1971,"DET,CBH,VAN"
George Abbott,1911-08-03,0,1944,1944,BOS
Bobby Babcock,1968-08-03,2,1991,1993,WSH
Ryan Carter,1983-08-03,8,2008,2016,"ANA,CAR,FLA,NJD,MIN"
Marcel Dionne*,1951-08-03,17,1972,1989,"DET,LAK,NYR"
Gerry Geran,1896-08-03,8,1918,1926,"MTW,BOS"
Mark Lamb,1964-08-03,10,1986,1996,"CGY,DET,EDM,OTT,PHI,MTL"
Jordan Leopold,1980-08-03,12,2003,2015,"CGY,COL,FLA,PIT,BUF,STL,CBJ,MIN"
John Lilley,1972-08-03,2,1994,1996,MDA
Brian McCutcheon,1949-08-03,2,1975,1977,DET
Howard McNamara,1893-08-03,0,1920,1920,MTL
Dominic Moore,1980-08-03,14,2004,2018,"NYR,MIN,PIT,TOR,BUF,FLA,MTL,TBL,SJS,BOS"
Sandis Ozolinsh,1972-08-03,15,1993,2008,"SJS,COL,CAR,FLA,MDA,NYR"
George Standing,1941-08-03,0,1968,1968,MNS
Shea Theodore,1995-08-03,4,2016,2020,"ANA,VEG"
Nicholas Baptiste,1995-08-04,1,2017,2018,BUF
Glen Burdon,1954-08-04,0,1975,1975,KCS
Wayne Carleton,1946-08-04,6,1966,1972,"TOR,BOS,CGS"
Michael Colman,1968-08-04,0,1992,1992,SJS
Neil Colville*,1914-08-04,13,1936,1949,NYR
Gerry Denoird,1902-08-04,0,1923,1923,TRS
Iain Duncan,1963-08-04,4,1987,1991,WIN
Bengt Lundholm,1955-08-04,4,1982,1986,WIN
Maurice Richard*,1921-08-04,17,1943,1960,MTL
Christian Tanguay,1962-08-04,0,1982,1982,QUE
Alex Wellington,1893-08-04,0,1920,1920,QBC
Mark Bell,1980-08-05,11,2001,2012,"CHI,SJS,TOR,ANA"
Anders Bjork,1996-08-05,2,2018,2020,BOS
Gord Davidson,1918-08-05,1,1943,1944,NYR
Jeff Friesen,1976-08-05,12,1995,2007,"SJS,MDA,NJD,WSH,CGY"
Trevor Frischmon,1981-08-05,0,2010,2010,CBJ
Valeri Karpov,1971-08-05,2,1995,1997,MDA
Jack McCartan,1935-08-05,1,1960,1961,NYR
Ian McCoshen,1995-08-05,2,2017,2019,FLA
Jamie McGinn,1988-08-05,10,2009,2019,"SJS,COL,ANA,BUF,ARI,FLA"
Jack Norris,1942-08-05,6,1965,1971,"BOS,CBH,LAK"
Lukas Radil,1990-08-05,1,2019,2020,SJS
Herb Raglan,1967-08-05,8,1986,1994,"STL,QUE,TBL,OTT"
Mike Siltala,1963-08-05,6,1982,1988,"WSH,NYR"
Anton Stastny,1959-08-05,8,1981,1989,QUE
Cy Thomas,1926-08-05,0,1948,1948,"CBH,TOR"
Howard Walker,1958-08-05,2,1981,1983,"WSH,CGY"
Bobby Walton,1912-08-05,0,1944,1944,MTL
Dale Weise,1988-08-05,9,2011,2020,"NYR,VAN,MTL,CHI,PHI"
Sami Aittokallio,1992-08-06,1,2013,2014,COL
Andreas Athanasiou,1994-08-06,4,2016,2020,"DET,EDM"
Mike Bales,1971-08-06,4,1993,1997,"BOS,OTT"
Henrik Borgstr√∂m,1997-08-06,2,2018,2020,FLA
Erik Condra,1986-08-06,8,2011,2019,"OTT,TBL,DAL"
Gerry Couture,1925-08-06,8,1946,1954,"DET,MTL,CBH"
Christian Djoos,1994-08-06,2,2018,2020,"WSH,ANA"
John McLellan,1928-08-06,0,1952,1952,TOR
Harri Pesonen,1988-08-06,0,2013,2013,NJD
Shayne Toporowski,1975-08-06,0,1997,1997,TOR
Tim Wallace,1984-08-06,4,2009,2013,"PIT,NYI,TBL,CAR"
Bryan Young,1986-08-06,1,2007,2008,EDM
Jake Allen,1990-08-07,7,2013,2020,STL
Jonathan Bernier,1988-08-07,12,2008,2020,"LAK,TOR,ANA,COL,DET"
Sidney Crosby,1987-08-07,14,2006,2020,PIT
Philippe DeRouville,1974-08-07,2,1995,1997,PIT
Hazen McAndrew,1917-08-07,0,1942,1942,BRO
Sheldon Rempal,1995-08-07,0,2019,2019,LAK
Michael Sauer,1987-08-07,3,2009,2012,NYR
Damon Severson,1994-08-07,5,2015,2020,NJD
Mark Visentin,1992-08-07,0,2014,2014,PHX
Bubba Berenzweig,1977-08-08,3,2000,2003,NSH
Barry Brust,1983-08-08,0,2007,2007,LAK
Ken Dryden*,1947-08-08,8,1971,1979,MTL
Viktor Fasth,1982-08-08,2,2013,2015,"ANA,EDM"
Landon Ferraro,1991-08-08,4,2014,2018,"DET,BOS,MIN"
Cody Franson,1987-08-08,8,2010,2018,"NSH,TOR,BUF,CHI"
Bill Gadsby*,1927-08-08,19,1947,1966,"CBH,NYR,DET"
Matt Jones,1983-08-08,2,2006,2008,PHX
Jari Kaarela,1958-08-08,0,1981,1981,CLR
Don Keenan,1938-08-08,0,1959,1959,BOS
Bobby Kirk,1909-08-08,0,1938,1938,NYR
Nathan Lieuwen,1991-08-08,0,2014,2014,BUF
Steve MacIntyre,1980-08-08,4,2009,2013,"EDM,FLA,PIT"
Murdo MacKay,1917-08-08,2,1946,1948,MTL
Greg Polis,1950-08-08,9,1971,1980,"PIT,STL,NYR,WSH"
Gary Rissling,1956-08-08,6,1979,1985,"WSH,PIT"
Tony Salmelainen,1981-08-08,3,2004,2007,"EDM,CHI"
Scott Sandelin,1964-08-08,5,1987,1992,"MTL,PHI,MNS"
Dominik Simon,1994-08-08,4,2016,2020,PIT
Rocky Thompson,1977-08-08,4,1998,2002,"CGY,FLA"
Carter Bancks,1989-08-09,0,2013,2013,CGY
Harvey Bennett,1952-08-09,4,1975,1979,"PIT,WSH,PHI,MNS,STL"
Andy Brickley,1961-08-09,11,1983,1994,"PHI,PIT,NJD,BOS,WIN"
Rod Brind'Amour,1970-08-09,20,1990,2010,"STL,PHI,CAR"
Bernie Brophy,1905-08-09,4,1926,1930,"MTM,DTC"
Frank Brophy,1900-08-09,0,1920,1920,QBC
John Byce,1967-08-09,1,1991,1992,BOS
Patrick Cannone,1986-08-09,0,2017,2017,MIN
Matt Davidson,1977-08-09,2,2001,2003,CBJ
Herb Foster,1913-08-09,7,1941,1948,NYR
Mark Hamway,1961-08-09,2,1985,1987,NYI
Brett Hull*,1964-08-09,19,1987,2006,"CGY,STL,DAL,DET,PHX"
Jim Johnson,1962-08-09,12,1986,1998,"PIT,MNS,DAL,WSH,PHX"
Yuri Khmylev,1964-08-09,4,1993,1997,"BUF,STL"
Brian Loney,1972-08-09,0,1996,1996,VAN
John McCarthy,1986-08-09,6,2010,2016,SJS
Shane O'Brien,1983-08-09,8,2007,2015,"ANA,TBL,VAN,NSH,COL,CGY,FLA"
Bruce Racine,1966-08-09,0,1996,1996,STL
Larry Regan,1930-08-09,4,1957,1961,"BOS,TOR"
Pavel Skrbek,1978-08-09,3,1999,2002,"PIT,NSH"
Lorne Stamler,1951-08-09,3,1977,1980,"LAK,TOR,WIN"
Rhys Thomson,1918-08-09,3,1940,1943,"MTL,TOR"
Alexander Andrievski,1968-08-10,0,1993,1993,CHI
Zach Aston-Reese,1994-08-10,2,2018,2020,PIT
Jesse Boulerice,1978-08-10,7,2002,2009,"PHI,CAR,STL,EDM"
Cam Connor,1954-08-10,4,1979,1983,"MTL,EDM,NYR"
Frank Dunlap,1924-08-10,0,1944,1944,TOR
Marcus Foligno,1991-08-10,8,2012,2020,"BUF,MIN"
Iain Fraser,1969-08-10,4,1993,1997,"NYI,QUE,DAL,EDM,WIN,SJS"
Sam Gagner,1989-08-10,12,2008,2020,"EDM,ARI,PHI,CBJ,VAN,DET"
Lloyd Haddon,1938-08-10,0,1960,1960,DET
Greg Hawgood,1968-08-10,14,1988,2002,"BOS,EDM,PHI,FLA,PIT,SJS,VAN,DAL"
Bret Hedican,1970-08-10,17,1992,2009,"STL,VAN,FLA,CAR,ANA"
Darcy Hordichuk,1980-08-10,12,2001,2013,"ATL,PHX,FLA,NSH,VAN,EDM"
David Jones,1984-08-10,8,2008,2016,"COL,CGY,MIN"
Butch Keeling,1905-08-10,11,1927,1938,"TOR,NYR"
Bill McDougall,1966-08-10,3,1991,1994,"DET,EDM,TBL"
Mike McEwen,1956-08-10,11,1977,1988,"NYR,CLR,NYI,LAK,WSH,DET,HAR"
Tanner Pearson,1992-08-10,6,2014,2020,"LAK,PIT,VAN"
Alexander Perezhogin,1983-08-10,1,2006,2007,MTL
Claude Robert,1928-08-10,0,1951,1951,MTL
Mathieu Roy,1983-08-10,7,2006,2013,"EDM,CBJ,TBL"
Nick Suzuki,1999-08-10,0,2020,2020,MTL
Vic Teal,1949-08-10,0,1974,1974,NYI
Rick Wilson,1950-08-10,3,1974,1977,"MTL,STL,DET"
Marc Bergevin,1965-08-11,19,1985,2004,"CBH,CHI,NYI,HAR,TBL,DET,STL,PIT,VAN"
Floyd Curry,1925-08-11,10,1948,1958,MTL
Brad Dalgarno,1967-08-11,10,1986,1996,NYI
Connie Dion,1918-08-11,1,1944,1945,DET
Larry Fullan,1949-08-11,0,1975,1975,WSH
Alexander Kerfoot,1994-08-11,2,2018,2020,"COL,TOR"
Ken Kuzyk,1953-08-11,1,1977,1978,CLE
Guy Labrie,1920-08-11,1,1944,1945,"BOS,NYR"
Kellan Lain,1989-08-11,0,2014,2014,VAN
Ken Linseman,1958-08-11,13,1979,1992,"PHI,EDM,BOS,TOR"
Aaron Miller,1971-08-11,14,1994,2008,"QUE,COL,LAK,VAN"
Larry Popein,1930-08-11,13,1955,1968,"NYR,OAK"
Cayden Primeau,1999-08-11,0,2020,2020,MTL
Chuck Rayner*,1920-08-11,12,1941,1953,"NYA,BRO,NYR"
Dave Shand,1956-08-11,8,1977,1985,"ATF,TOR,WSH"
Ron Snell,1948-08-11,1,1969,1970,PIT
Martin St. Pierre,1983-08-11,8,2006,2014,"CHI,BOS,OTT,MTL"
Jari Torkki,1965-08-11,0,1989,1989,CHI
Mike Vellucci,1966-08-11,0,1988,1988,HAR
Lubomir Visnovsky,1976-08-11,14,2001,2015,"LAK,EDM,ANA,NYI"
Jason Williams,1980-08-11,11,2001,2012,"DET,CHI,ATL,CBJ,DAL,PIT"
Mark Arcobello,1988-08-12,3,2013,2016,"EDM,ARI,NSH,PIT,TOR"
David Ayres,1977-08-12,0,2020,2020,CAR
Roy Burmister,1906-08-12,2,1930,1932,NYA
Walt Farrant,1912-08-12,0,1944,1944,CBH
Greg Fox,1953-08-12,7,1978,1985,"ATF,CBH,PIT"
Ryan Garbutt,1985-08-12,5,2012,2017,"DAL,ANA,CHI"
Colin Hemingway,1980-08-12,0,2006,2006,STL
Paul Houck,1963-08-12,2,1986,1988,MNS
Vladislav Kamenev,1996-08-12,3,2017,2020,"NSH,COL"
Rob Klinkhammer,1986-08-12,5,2011,2016,"CHI,OTT,PHX,ARI,EDM,PIT"
Moe L'Abbe,1947-08-12,0,1973,1973,CBH
Fred Lowrey,1902-08-12,1,1925,1926,"MTM,PTP"
Brad Lukowich,1976-08-12,13,1998,2011,"DAL,TBL,NJD,NYI,SJS,VAN"
Todd Marchant,1973-08-12,17,1994,2011,"EDM,NYR,CBJ,MDA,ANA"
Anders Myrvold,1975-08-12,8,1996,2004,"COL,BOS,NYI,DET"
Jiri Novotny,1983-08-12,3,2006,2009,"BUF,WSH,CBJ"
Rosaire Paiement,1945-08-12,4,1968,1972,"PHI,VAN"
Kyle Quincey,1985-08-12,12,2006,2018,"DET,LAK,COL,CBJ,NJD,MIN"
Jake Rathwell,1947-08-12,0,1975,1975,BOS
Pat Rupp,1942-08-12,0,1964,1964,DET
Tony Stiles,1959-08-12,0,1984,1984,CGY
Bob Taylor,1904-08-12,0,1930,1930,BOS
Terry Virtue,1970-08-12,1,1999,2000,"BOS,NYR"
Gord Walker,1965-08-12,3,1987,1990,"NYR,LAK"
Ron Busniuk,1948-08-13,1,1973,1974,BUF
Kyle Capobianco,1997-08-13,2,2018,2020,ARI
Steve Cardwell,1950-08-13,2,1971,1973,PIT
Bobby Clarke*,1949-08-13,14,1970,1984,PHI
Shayne Corson,1966-08-13,18,1986,2004,"MTL,EDM,STL,TOR,DAL"
Casey DeSmith,1991-08-13,1,2018,2019,PIT
Randy Exelby,1965-08-13,1,1989,1990,"MTL,EDM"
Giovanni Fiore,1996-08-13,0,2018,2018,ANA
Peter Folco,1953-08-13,0,1974,1974,VAN
Filip Forsberg,1994-08-13,7,2013,2020,NSH
Johnny Gaudreau,1993-08-13,6,2014,2020,CGY
Hago Harrington,1904-08-13,7,1926,1933,"BOS,MTL"
Carter Hart,1998-08-13,1,2019,2020,PHI
Ales Hemsky,1983-08-13,15,2003,2018,"EDM,OTT,DAL,MTL"
Jujhar Khaira,1994-08-13,4,2016,2020,EDM
Zenith Komarniski,1978-08-13,4,2000,2004,"VAN,CBJ"
Joe Krol,1915-08-13,5,1937,1942,"NYR,BRO"
Ed Lowrey,1891-08-13,3,1918,1921,"OTS,HAM"
Bill Masterton,1938-08-13,0,1968,1968,MNS
Mark Osborne,1961-08-13,13,1982,1995,"DET,NYR,TOR,WIN"
Cedric Paquette,1993-08-13,6,2014,2020,TBL
Marcus Ragnarsson,1971-08-13,8,1996,2004,"SJS,PHI"
Anssi Salmela,1984-08-13,2,2009,2011,"ATL,NJD"
Joe Simpson*,1893-08-13,5,1926,1931,NYA
Tommy Sjodin,1965-08-13,1,1993,1994,"MNS,DAL,QUE"
Stan Smith,1917-08-13,1,1940,1941,NYR
Lee Sweatt,1985-08-13,0,2011,2011,VAN
Marty Turco,1975-08-13,11,2001,2012,"DAL,CHI,BOS"
Ron Boehm,1943-08-14,0,1968,1968,OAK
Josh Gorges,1984-08-14,12,2006,2018,"SJS,MTL,BUF"
Adam Hall,1980-08-14,12,2002,2014,"NSH,MIN,NYR,PIT,TBL,CAR,PHI"
Miloslav Horava,1961-08-14,2,1989,1991,NYR
John Klingberg,1992-08-14,5,2015,2020,DAL
Brett McLean,1978-08-14,6,2003,2009,"CHI,COL,FLA"
Logan O'Connor,1996-08-14,1,2019,2020,COL
Mark Plantery,1959-08-14,0,1981,1981,WIN
Nolan Pratt,1975-08-14,11,1997,2008,"HAR,CAR,COL,TBL,BUF"
Dick Redmond,1949-08-14,12,1970,1982,"MNS,CGS,CBH,ATF,STL,BOS"
Kyle Turris,1989-08-14,12,2008,2020,"PHX,OTT,NSH"
Carter Verhaeghe,1995-08-14,0,2020,2020,TBL
Shea Weber,1985-08-14,14,2006,2020,"NSH,MTL"
Scott Wedgewood,1992-08-14,2,2016,2018,"NJD,ARI"
Greg Adams,1963-08-15,16,1985,2001,"NJD,VAN,DAL,PHX,FLA"
Martin Biron,1977-08-15,18,1996,2014,"BUF,PHI,NYI,NYR"
James Black,1969-08-15,11,1990,2001,"HAR,MNS,BUF,DAL,CHI,WSH"
Teddy Blueger,1994-08-15,1,2019,2020,PIT
Ivan Boldirev,1949-08-15,14,1971,1985,"BOS,CGS,CBH,ATF,VAN,DET"
Adam Boqvist,2000-08-15,0,2020,2020,CHI
Stephane Brochu,1967-08-15,0,1989,1989,NYR
Rick Chinnick,1953-08-15,1,1974,1975,MNS
Norm Corcoran,1931-08-15,6,1950,1956,"BOS,CBH,DET"
Jim Cunningham,1956-08-15,0,1978,1978,PHI
Fred Doherty,1887-08-15,0,1919,1919,MTL
Marv Edwards,1935-08-15,5,1969,1974,"PIT,TOR,CGS"
Michael Funk,1986-08-15,1,2007,2008,BUF
Sheldon Kannegiesser,1947-08-15,7,1971,1978,"PIT,NYR,LAK,VAN"
Christer Kellgren,1958-08-15,0,1982,1982,CLR
Oskar Lindblom,1996-08-15,2,2018,2020,PHI
Craig MacTavish,1958-08-15,17,1980,1997,"BOS,EDM,NYR,PHI,STL"
Brendan Morrison,1975-08-15,14,1998,2012,"NJD,VAN,ANA,DAL,WSH,CGY,CHI"
Victor Oreskovich,1986-08-15,2,2010,2012,"FLA,VAN"
Roland Stoltz,1954-08-15,0,1982,1982,WSH
Peter Taglianetti,1963-08-15,10,1985,1995,"WIN,MNS,PIT,TBL"
Jakub Voracek,1989-08-15,11,2009,2020,"CBJ,PHI"
Neil Wilkinson,1967-08-15,9,1990,1999,"MNS,SJS,CHI,WIN,PIT"
Gary Yaremchuk,1961-08-15,3,1982,1985,TOR
Bob Blake,1914-08-16,0,1936,1936,BOS
Edward Diachuk,1936-08-16,0,1961,1961,DET
Garnet Exelby,1981-08-16,7,2003,2010,"ATL,TOR"
Irv Frew,1907-08-16,2,1934,1936,"MTM,STE,MTL"
Larry Gould,1952-08-16,0,1974,1974,VAN
Travis Hamonic,1990-08-16,9,2011,2020,"NYI,CGY"
Nick Harbaruk,1943-08-16,4,1970,1974,"PIT,STL"
Alan Hepple,1963-08-16,2,1984,1986,NJD
Connor Jones,1990-08-16,0,2017,2017,NYI
Kaapo Kahkonen,1996-08-16,0,2020,2020,MIN
Barry MacKenzie,1941-08-16,0,1969,1969,MNS
Mike McHugh,1965-08-16,3,1989,1992,"MNS,SJS"
Ed Olczyk,1966-08-16,15,1985,2000,"CBH,CHI,TOR,WIN,NYR,LAK,PIT"
Steve Payne,1958-08-16,9,1979,1988,MNS
Adam Pelech,1994-08-16,4,2016,2020,NYI
Carey Price,1987-08-16,12,2008,2020,MTL
Randy Rota,1950-08-16,4,1973,1977,"MTL,LAK,KCS,CLR"
Cory Sarich,1978-08-16,15,1999,2014,"BUF,TBL,CGY,COL"
Andy Schliebener,1962-08-16,3,1982,1985,VAN
Gabriel Vilardi,1999-08-16,0,2020,2020,LAK
Georges Boucher*,1896-08-17,14,1918,1932,"OTS,MTM,CBH"
Eric Boulton,1976-08-17,15,2001,2016,"BUF,ATL,NJD,NYI"
Troy Brouwer,1985-08-17,13,2007,2020,"CHI,WSH,STL,CGY,FLA"
Mitch Callahan,1991-08-17,3,2014,2017,DET
Drew Callander,1956-08-17,3,1977,1980,"PHI,VAN"
Jim Dorey,1947-08-17,3,1969,1972,"TOR,NYR"
Nelson Emerson,1967-08-17,11,1991,2002,"STL,WIN,HAR,CAR,CHI,OTT,ATL,LAK"
John Emmons,1974-08-17,2,2000,2002,"OTT,TBL,BOS"
Harry Frost,1914-08-17,0,1939,1939,BOS
Rob Garner,1958-08-17,0,1983,1983,PIT
Gord Henry,1926-08-17,1,1949,1950,BOS
Buck Jones,1918-08-17,4,1939,1943,"DET,TOR"
Mike Labadie,1932-08-17,0,1953,1953,NYR
David Legwand,1980-08-17,17,1999,2016,"NSH,DET,OTT,BUF"
Craig Levie,1959-08-17,5,1982,1987,"WIN,MNS,STL,VAN"
Jamie Macoun,1961-08-17,16,1983,1999,"CGY,TOR,DET"
Chico Maki,1939-08-17,14,1962,1976,CBH
Brady Murray,1984-08-17,0,2008,2008,LAK
Pete Peeters,1957-08-17,12,1979,1991,"PHI,BOS,WSH"
Don Sweeney,1966-08-17,15,1989,2004,"BOS,DAL"
Jake Virtanen,1996-08-17,4,2016,2020,VAN
Petr Cajanek,1975-08-18,4,2003,2007,STL
Geoff Courtnall,1962-08-18,16,1984,2000,"BOS,EDM,WSH,STL,VAN"
Bruce Cowick,1951-08-18,1,1975,1976,"WSH,STL"
Brian Dobbin,1966-08-18,5,1987,1992,"PHI,BOS"
Forbes Kennedy,1935-08-18,12,1957,1969,"CBH,DET,BOS,PHI,TOR"
Joel L'Esperance,1995-08-18,1,2019,2020,DAL
Max Middendorf,1967-08-18,4,1987,1991,"QUE,EDM"
John Sleaver,1934-08-18,3,1954,1957,CBH
Ossi Vaananen,1980-08-18,8,2001,2009,"PHX,COL,PHI,VAN"
Peter Worrell,1977-08-18,6,1998,2004,"FLA,COL"
Bob Woytowich,1941-08-18,7,1965,1972,"BOS,MNS,PIT,LAK"
Michael Zalewski,1992-08-18,3,2014,2017,VAN
Erik Andersson,1971-08-19,0,1998,1998,CGY
Joey Daccord,1996-08-19,0,2019,2019,OTT
Dave Dunn,1948-08-19,2,1974,1976,"VAN,TOR"
Mike Fidler,1956-08-19,6,1977,1983,"CLE,MNS,HAR,CBH"
Rod Graham,1946-08-19,0,1975,1975,BOS
David Jensen,1965-08-19,3,1985,1988,"HAR,WSH"
Andreas Karlsson,1975-08-19,8,2000,2008,"ATL,TBL"
Martin Lojek,1985-08-19,1,2007,2008,FLA
Tomi Maki,1983-08-19,0,2007,2007,CGY
Steve Ott,1982-08-19,14,2003,2017,"DAL,BUF,STL,DET,MTL"
Taylor Pyatt,1981-08-19,13,2001,2014,"NYI,BUF,VAN,PHX,NYR,PIT"
David Rittich,1992-08-19,3,2017,2020,CGY
Bobby Rowe,1885-08-19,0,1925,1925,BOS
Darryl Sutter,1958-08-19,7,1980,1987,"CBH,CHI"
Don Waddell,1958-08-19,0,1981,1981,LAK
Jimmy Watson,1952-08-19,9,1973,1982,PHI
Shawn Cronin,1963-08-20,6,1989,1995,"WSH,WIN,PHI,SJS"
Robert Dirk,1966-08-20,8,1988,1996,"STL,VAN,CHI,MDA,MTL"
Chris Drury,1976-08-20,12,1999,2011,"COL,CGY,BUF,NYR"
Steven Finn,1966-08-20,11,1986,1997,"QUE,LAK,TBL"
Tanner Fritz,1991-08-20,1,2018,2019,NYI
Al Hamilton,1946-08-20,14,1966,1980,"NYR,BUF,EDM"
Jyrki Jokipakka,1991-08-20,2,2015,2017,"DAL,CGY,OTT"
Ernest Kenny,1907-08-20,4,1931,1935,"NYR,CBH"
Vitali Kolesnik,1979-08-20,0,2006,2006,COL
Zane McIntyre,1992-08-20,0,2017,2017,BOS
Brian Murphy,1947-08-20,0,1975,1975,DET
Pat Murray,1969-08-20,1,1991,1992,PHI
Robert Nordmark,1962-08-20,3,1988,1991,"STL,VAN"
Richard Petiot,1982-08-20,5,2006,2011,"LAK,TBL,EDM"
Harvey Rockburn,1908-08-20,3,1930,1933,"DTC,DTF,OTS"
Ed Sandford,1928-08-20,8,1948,1956,"BOS,CBH,DET"
Bruce Shoebottom,1965-08-20,3,1988,1991,BOS
Steve Valiquette,1977-08-20,10,2000,2010,"NYI,EDM,NYR"
Joe Vitale,1985-08-20,5,2011,2016,"PIT,ARI"
Steven Zalewski,1986-08-20,2,2010,2012,"SJS,NJD"
Bryan Allen,1980-08-21,14,2001,2015,"VAN,FLA,CAR,ANA,MTL"
Keith Allen*,1923-08-21,1,1954,1955,DET
Toe Blake*,1912-08-21,13,1935,1948,"MTM,MTL"
Alex Brooks,1976-08-21,0,2007,2007,NJD
Tom Colley,1953-08-21,0,1975,1975,MNS
Brandon Davidson,1991-08-21,5,2015,2020,"EDM,MTL,NYI,CHI,CGY,SJS"
Rob Dopson,1967-08-21,0,1994,1994,PIT
Chad Erickson,1970-08-21,0,1992,1992,NJD
Dominik Kubal√≠k,1995-08-21,0,2020,2020,CHI
Jean-Paul Lamirande,1924-08-21,8,1947,1955,"NYR,MTL"
Steve McKenna,1973-08-21,7,1997,2004,"LAK,MIN,PIT,NYR"
Mitch Messier,1965-08-21,3,1988,1991,MNS
Paul Miller,1959-08-21,0,1982,1982,CLR
Ron Moffat,1905-08-21,2,1933,1935,DET
Bernie Morris,1890-08-21,0,1925,1925,BOS
Roman Oksiuta,1970-08-21,3,1994,1997,"EDM,VAN,MDA,PIT"
Billy Reay,1918-08-21,9,1944,1953,"DET,MTL"
Gord Sherven,1963-08-21,4,1984,1988,"EDM,MNS,HAR"
Jared Staal,1990-08-21,0,2013,2013,CAR
Frank Daley,1909-08-22,0,1929,1929,DTC
Dean Evason,1964-08-22,12,1984,1996,"WSH,HAR,SJS,DAL,CGY"
George Ferguson,1952-08-22,11,1973,1984,"TOR,PIT,MNS"
Ken Hammond,1963-08-22,8,1985,1993,"LAK,EDM,NYR,TOR,BOS,SJS,OTT"
Mitch Lamoureux,1962-08-22,4,1984,1988,"PIT,PHI"
Olli Maatta,1994-08-22,6,2014,2020,"PIT,CHI"
Shawn MacKenzie,1962-08-22,0,1983,1983,NJD
Ron Martin,1909-08-22,1,1933,1934,NYA
Ray McKay,1946-08-22,5,1969,1974,"CBH,BUF,CGS"
Eric Prentice,1926-08-22,0,1944,1944,TOR
Andy Roach,1973-08-22,0,2006,2006,STL
Jonas Ronnqvist,1973-08-22,0,2001,2001,MDA
Brayden Schenn,1991-08-22,10,2010,2020,"LAK,PHI,STL"
Bruno St. Jacques,1980-08-22,4,2002,2006,"PHI,CAR,MDA"
Mike Zanier,1962-08-22,0,1985,1985,EDM
Jack Carlson,1954-08-23,8,1979,1987,"MNS,STL"
Mike Casselman,1968-08-23,0,1996,1996,FLA
Ray Ferraro,1964-08-23,17,1985,2002,"HAR,NYI,LAK,NYR,ATL,STL"
Dave Gardner,1952-08-23,7,1973,1980,"MTL,STL,CGS,CLE,PHI"
Mike Green,1979-08-23,0,2004,2004,"FLA,NYR"
John Grisdale,1948-08-23,6,1973,1979,"TOR,VAN"
Carl Hagelin,1988-08-23,8,2012,2020,"NYR,ANA,PIT,LAK,WSH"
Glenn Healy,1962-08-23,15,1986,2001,"LAK,NYI,NYR,TOR"
Randy Moller,1963-08-23,12,1983,1995,"QUE,NYR,BUF,FLA"
Igor Radulov,1982-08-23,1,2003,2004,CHI
Jarkko Ruutu,1975-08-23,11,2000,2011,"VAN,PIT,OTT,ANA"
Percy Traub,1896-08-23,2,1927,1929,"CBH,DTC"
Murray Balfour,1936-08-24,8,1957,1965,"MTL,CBH,BOS"
Norm Barnes,1953-08-24,5,1977,1982,"PHI,HAR"
Landon Bow,1995-08-24,0,2019,2019,DAL
Benoit Brunet,1968-08-24,13,1989,2002,"MTL,DAL,OTT"
Andrew Brunette,1973-08-24,16,1996,2012,"WSH,NSH,ATL,MIN,COL,CHI"
Greg Classen,1977-08-24,2,2001,2003,NSH
Alain Daigle,1954-08-24,5,1975,1980,CBH
Mikko Eloranta,1972-08-24,3,2000,2003,"BOS,LAK"
Marcel Goc,1983-08-24,9,2006,2015,"SJS,NSH,FLA,PIT,STL"
Bill Goldsworthy,1944-08-24,13,1965,1978,"BOS,MNS,NYR"
Raman Hrabarenka,1992-08-24,0,2015,2015,NJD
Brad Hunt,1988-08-24,6,2014,2020,"EDM,NSH,STL,VEG,MIN"
Anze Kopitar,1987-08-24,13,2007,2020,LAK
Rich LeDuc,1951-08-24,8,1973,1981,"BOS,QUE"
Wally Maxwell,1933-08-24,0,1953,1953,TOR
Gilles Mayer,1930-08-24,6,1950,1956,TOR
Don McLeod,1946-08-24,1,1971,1972,"DET,PHI"
Ian Moran,1972-08-24,11,1996,2007,"PIT,BOS,ANA"
Derek Morris,1978-08-24,16,1998,2014,"CGY,COL,PHX,NYR,BOS"
Randy Murray,1945-08-24,0,1970,1970,TOR
Paul O'Neil,1953-08-24,2,1974,1976,"VAN,BOS"
Ricard Persson,1969-08-24,6,1996,2002,"NJD,STL,OTT"
Ken Priestlay,1967-08-24,5,1987,1992,"BUF,PIT"
Gary Sampson,1959-08-24,3,1984,1987,WSH
Red Spooner,1910-08-24,0,1930,1930,PTP
Bill Derlago,1958-08-25,8,1979,1987,"VAN,TOR,BOS,WIN,QUE"
Justin Dibenedetto,1988-08-25,0,2011,2011,NYI
Jerry Holland,1954-08-25,1,1975,1976,NYR
Connor James,1982-08-25,3,2006,2009,"LAK,PIT"
Charlie Langlois,1894-08-25,3,1925,1928,"HAM,NYA,PTP,MTL"
Jamie Leach,1969-08-25,4,1990,1994,"PIT,HAR,FLA"
Bob Lorimer,1953-08-25,9,1977,1986,"NYI,CLR,NJD"
Lane MacDermid,1989-08-25,2,2012,2014,"BOS,DAL,CGY"
Andy McDonald,1977-08-25,12,2001,2013,"MDA,ANA,STL"
Harry Mummery,1889-08-25,5,1918,1923,"TRA,QBC,MTL,HAM"
Alexander Nikulin,1985-08-25,1,2008,2009,"OTT,PHX"
Iiro Pakarinen,1991-08-25,3,2015,2018,EDM
Greg Paslawski,1961-08-25,10,1984,1994,"MTL,STL,WIN,BUF,QUE,CGY,PHI"
Nick Schultz,1982-08-25,15,2002,2017,"MIN,EDM,CBJ,PHI"
Tomas Srsen,1966-08-25,0,1991,1991,EDM
Pete Stemkowski,1943-08-25,14,1964,1978,"TOR,DET,NYR,LAK"
Dean Talafous,1953-08-25,7,1975,1982,"ATF,MNS,NYR"
Dave Tippett,1961-08-25,10,1984,1994,"HAR,WSH,PIT,PHI"
Mike Veisor,1952-08-25,10,1974,1984,"CBH,HAR,WIN"
David Williams,1967-08-25,3,1992,1995,"SJS,MDA"
Bryon Baltimore,1952-08-26,0,1980,1980,EDM
Steve Carlson,1955-08-26,0,1980,1980,LAK
Anthony Duclair,1995-08-26,5,2015,2020,"NYR,ARI,CHI,CBJ,OTT"
Bob Dupuis,1952-08-26,0,1980,1980,EDM
Alex Foster,1984-08-26,0,2008,2008,TOR
Dylan Gambrell,1996-08-26,2,2018,2020,SJS
Matiss Kivlenieks,1996-08-26,0,2020,2020,CBJ
Henry Lehvonen,1950-08-26,0,1975,1975,KCS
Perttu Lindgren,1987-08-26,0,2010,2010,DAL
Chris McRae,1965-08-26,2,1988,1990,"TOR,DET"
Greg Rallo,1981-08-26,1,2012,2013,FLA
Cole Schneider,1990-08-26,1,2016,2017,BUF
Wayne Simmonds,1988-08-26,11,2009,2020,"LAK,PHI,NSH,BUF,NJD"
Ron Stackhouse,1949-08-26,11,1971,1982,"CGS,DET,PIT"
Zach Trotman,1990-08-26,6,2014,2020,"BOS,PIT"
Noah Welch,1982-08-26,5,2006,2011,"PIT,FLA,TBL,ATL"
Bill White,1939-08-26,8,1968,1976,"LAK,CBH"
Ryan Bast,1975-08-27,0,1999,1999,PHI
Mark Botell,1961-08-27,0,1982,1982,PHI
Kip Brennan,1980-08-27,6,2002,2008,"LAK,ATL,MDA,NYI"
Robin Burns,1946-08-27,5,1971,1976,"PIT,KCS"
Aaron Downey,1974-08-27,9,2000,2009,"BOS,CHI,DAL,MTL,STL,DET"
Mario Doyon,1968-08-27,2,1989,1991,"CHI,QUE"
Manny Fernandez,1974-08-27,14,1995,2009,"DAL,MIN,BOS"
Dallas Gaume,1963-08-27,0,1989,1989,HAR
Bob Gladney,1957-08-27,1,1983,1984,"LAK,PIT"
Petter Granberg,1992-08-27,3,2014,2017,"TOR,NSH"
Troy Grosenick,1989-08-27,0,2015,2015,SJS
Brandon Hagel,1998-08-27,0,2020,2020,CHI
Jonas Holos,1987-08-27,0,2011,2011,COL
Stan Jackson,1898-08-27,5,1922,1927,"TRS,BOS,OTS"
Teemu Laakso,1987-08-27,2,2010,2012,NSH
Brad Leeb,1979-08-27,4,2000,2004,"VAN,TOR"
Moylan McDonnell,1889-08-27,0,1921,1921,HAM
Evgeny Medvedev,1982-08-27,0,2016,2016,PHI
Craig Mills,1976-08-27,3,1996,1999,"WIN,CHI"
Don O'Donoghue,1949-08-27,2,1970,1972,"OAK,CGS"
Adam Oates*,1962-08-27,18,1986,2004,"DET,STL,BOS,WSH,PHI,MDA,EDM"
Karel Rachunek,1979-08-27,8,2000,2008,"OTT,NYR,NJD"
Doug Robinson,1940-08-27,6,1965,1971,"CBH,NYR,LAK"
Murray Anderson,1949-08-28,0,1975,1975,WSH
Andy Bathgate*,1932-08-28,18,1953,1971,"NYR,TOR,DET,PIT"
Ed Cooper,1960-08-28,1,1981,1982,CLR
Tom Fitzgerald,1968-08-28,17,1989,2006,"NYI,FLA,COL,NSH,CHI,TOR,BOS"
Jonas Frogren,1980-08-28,0,2009,2009,TOR
Larry Giroux,1951-08-28,6,1974,1980,"STL,DET,KCS,HAR"
Harry Helman,1894-08-28,2,1923,1925,OTS
Darby Hendrickson,1972-08-28,9,1995,2004,"TOR,NYI,VAN,MIN,COL"
Glenn Hicks,1958-08-28,1,1980,1981,DET
Marek Hrivik,1991-08-28,2,2016,2018,"NYR,CGY"
John Miner,1965-08-28,0,1988,1988,EDM
Gord Redahl,1935-08-28,0,1959,1959,BOS
Tim Sestito,1984-08-28,6,2009,2015,"EDM,NJD"
Pierre Turgeon,1969-08-28,19,1988,2007,"BUF,NYI,MTL,STL,DAL,COL"
Bill Whelton,1959-08-28,0,1981,1981,WIN
Peter Andersson,1965-08-29,1,1993,1994,"NYR,FLA"
Baz Bastien,1919-08-29,0,1946,1946,TOR
Hal Cooper,1915-08-29,0,1945,1945,NYR
Glen Cressman,1934-08-29,0,1957,1957,MTL
Martin Erat,1981-08-29,13,2002,2015,"NSH,WSH,PHX,ARI"
Brian Glennie,1946-08-29,9,1970,1979,"TOR,LAK"
Dan Hodgson,1965-08-29,3,1986,1989,"TOR,VAN"
Jonas Hoglund,1972-08-29,6,1997,2003,"CGY,MTL,TOR"
Hannes Hyvonen,1975-08-29,1,2002,2003,"SJS,CBJ"
Aurele Joliat*,1901-08-29,15,1923,1938,MTL
Kim MacDougall,1954-08-29,0,1975,1975,MNS
Mike Murray,1966-08-29,0,1988,1988,PHI
Antti Niemi,1983-08-29,10,2009,2019,"CHI,SJS,DAL,FLA,MTL,PIT"
Rob Plumb,1957-08-29,1,1978,1979,DET
Max Quackenbush,1928-08-29,1,1951,1952,"BOS,CBH"
Dylan Reese,1984-08-29,5,2010,2015,"NYI,PIT,ARI"
Ted Saunders,1911-08-29,0,1934,1934,OTS
Doug Sulliman,1959-08-29,10,1980,1990,"NYR,HAR,NJD,PHI"
Tim Tookey,1960-08-29,8,1981,1989,"WSH,QUE,PIT,PHI,LAK"
Shaun Van Allen,1967-08-29,13,1991,2004,"EDM,MDA,OTT,DAL,MTL"
Tony Bukovich,1915-08-30,1,1944,1945,DET
Guy Delparte,1949-08-30,0,1977,1977,CLR
Duke Dukowski,1902-08-30,7,1927,1934,"CBH,NYA,NYR"
Dunc Fisher,1927-08-30,10,1949,1959,"NYR,BOS,DET"
Jean-Guy Gendron,1934-08-30,16,1956,1972,"NYR,BOS,MTL,PHI"
Ken Lockett,1947-08-30,1,1975,1976,VAN
Lowell MacDonald,1941-08-30,16,1962,1978,"DET,LAK,PIT"
Howie Mackie,1913-08-30,1,1937,1938,DET
Vladimir Malakhov,1968-08-30,13,1993,2006,"NYI,MTL,NJD,NYR,PHI"
Mike McMahon,1941-08-30,8,1964,1972,"NYR,MNS,CBH,DET,PIT,BUF"
Justin Peters,1986-08-30,7,2010,2017,"CAR,WSH,ARI"
Dave Reierson,1964-08-30,0,1989,1989,CGY
Buddy Robinson,1991-08-30,4,2016,2020,"OTT,CGY"
Nikita Tryamkin,1994-08-30,1,2016,2017,VAN
Simon Wheeldon,1966-08-30,3,1988,1991,"NYR,WIN"
Burr Williams,1909-08-30,3,1934,1937,"DET,BOS,STE"
Jamie Baker,1966-08-31,9,1990,1999,"QUE,OTT,SJS,TOR"
Jean Beliveau*,1931-08-31,20,1951,1971,MTL
Brian Conacher,1941-08-31,10,1962,1972,"TOR,DET"
Matt Ellis,1981-08-31,8,2007,2015,"DET,LAK,BUF"
Fern Gauthier,1919-08-31,5,1944,1949,"NYR,MTL,DET"
John Grahame,1975-08-31,8,2000,2008,"BOS,TBL,CAR"
Ryan Kesler,1984-08-31,15,2004,2019,"VAN,ANA"
Bryce Lampman,1982-08-31,3,2004,2007,NYR
Guy Larose,1967-08-31,5,1989,1994,"WIN,TOR,CGY"
Radek Martinek,1976-08-31,12,2002,2014,"NYI,CBJ"
Alexei Mikhnov,1982-08-31,0,2007,2007,EDM
Bob Mongrain,1959-08-31,6,1980,1986,"BUF,LAK"
Scott Niedermayer*,1973-08-31,18,1992,2010,"NJD,MDA,ANA"
Kent Nilsson,1956-08-31,15,1980,1995,"ATF,CGY,MNS,EDM"
Gerry O'Flaherty,1950-08-31,7,1972,1979,"TOR,VAN,ATF"
Ondrej Pavelec,1987-08-31,10,2008,2018,"ATL,WPG,NYR"
Lyle Phair,1961-08-31,2,1986,1988,LAK
Ellie Pringle,1911-08-31,0,1931,1931,NYA
Steve Regier,1984-08-31,3,2006,2009,"NYI,STL"
Mike Stuart,1980-08-31,2,2004,2006,STL
Andrei Trefilov,1969-08-31,6,1993,1999,"CGY,BUF,CHI"
Blake Wheeler,1986-08-31,11,2009,2020,"BOS,ATL,WPG"
Ron Zanussi,1956-08-31,4,1978,1982,"MNS,TOR"
Brian Bellows,1964-09-01,16,1983,1999,"MNS,MTL,TBL,MDA,WSH"
Rich Chernomaz,1963-09-01,10,1982,1992,"CLR,NJD,CGY"
Dale DeGray,1963-09-01,4,1986,1990,"CGY,TOR,LAK,BUF"
Doug Friedman,1971-09-01,1,1998,1999,"EDM,NSH"
Alan Haworth,1960-09-01,7,1981,1988,"BUF,WSH,QUE"
Otto Koivula,1998-09-01,0,2020,2020,NYI
Dave Lumley,1954-09-01,8,1979,1987,"MTL,EDM,HAR"
Norm Maciver,1964-09-01,11,1987,1998,"NYR,HAR,EDM,OTT,PIT,WIN,PHX"
Nathan MacKinnon,1995-09-01,6,2014,2020,COL
Tomas Nosek,1992-09-01,4,2016,2020,"DET,VEG"
Gustav Nyquist,1989-09-01,8,2012,2020,"DET,SJS,CBJ"
Rollie Paulhus,1902-09-01,0,1926,1926,MTL
Rod Pelley,1984-09-01,5,2007,2012,"NJD,ANA"
Didier Pitre*,1883-09-01,5,1918,1923,MTL
Lauri Tukonen,1986-09-01,1,2007,2008,LAK
Alexei Vasiliev,1977-09-01,0,2000,2000,NYR
Jimmy Ward,1906-09-01,11,1928,1939,"MTM,MTL"
Jeff Woywitka,1983-09-01,6,2006,2012,"STL,DAL,NYR"
Harry Zolnierczyk,1987-09-01,5,2012,2017,"PHI,PIT,NYI,ANA,NSH"
Mats Zuccarello,1987-09-01,9,2011,2020,"NYR,DAL,MIN"
Aleksander Barkov,1995-09-02,6,2014,2020,FLA
Michel Belhumeur,1949-09-02,3,1973,1976,"PHI,WSH"
Jason Blake,1973-09-02,13,1999,2012,"LAK,NYI,TOR,ANA"
Erik Brannstrom,1999-09-02,1,2019,2020,OTT
Gerard Gallant,1963-09-02,10,1985,1995,"DET,TBL"
Bobby Gould,1957-09-02,10,1980,1990,"ATF,CGY,WSH,BOS"
Red Goupille,1915-09-02,7,1936,1943,MTL
Paul Guay,1963-09-02,7,1984,1991,"PHI,LAK,BOS,NYI"
Petr Hubacek,1979-09-02,0,2001,2001,PHI
Don Jackson,1956-09-02,9,1978,1987,"MNS,EDM,NYR"
Jay Leach,1979-09-02,5,2006,2011,"BOS,TBL,NJD,MTL,SJS"
Eetu Luostarinen,1998-09-02,0,2020,2020,CAR
Ivan Majesky,1976-09-02,3,2003,2006,"FLA,ATL,WSH"
Stephane Matteau,1969-09-02,12,1991,2003,"CGY,CHI,NYR,STL,SJS,FLA"
Brian McGrattan,1981-09-02,9,2006,2015,"OTT,PHX,CGY,NSH"
Kevin Miller,1965-09-02,15,1989,2004,"NYR,DET,STL,WSH,SJS,PIT,CHI,NYI,OTT"
Garrett Mitchell,1991-09-02,0,2017,2017,WSH
Mike Peluso,1974-09-02,2,2002,2004,"CHI,PHI"
Dany Sabourin,1980-09-02,5,2004,2009,"CGY,PIT,VAN"
Sami Salo,1974-09-02,15,1999,2014,"OTT,VAN,TBL"
Glen Sather*,1943-09-02,9,1967,1976,"BOS,PIT,NYR,STL,MTL,MNS"
Doug Smail,1957-09-02,12,1981,1993,"WIN,MNS,QUE,OTT"
Stan Smrke,1928-09-02,1,1957,1958,MTL
Mario Tremblay,1956-09-02,11,1975,1986,MTL
Cliff Barton,1907-09-03,10,1930,1940,"PTP,PHQ,NYR"
Doug Bentley*,1916-09-03,14,1940,1954,"CBH,NYR"
Marc Boileau,1932-09-03,0,1962,1962,DET
Gerry Brisson,1937-09-03,0,1963,1963,MTL
Rob Conn,1968-09-03,4,1992,1996,"CHI,BUF"
Toni Dahlman,1979-09-03,1,2002,2003,OTT
Ron Delorme,1955-09-03,8,1977,1985,"CLR,VAN"
Jacques Deslauriers,1928-09-03,0,1956,1956,MTL
Martin Gerber,1974-09-03,8,2003,2011,"MDA,CAR,OTT,TOR,EDM"
George Grigor,1916-09-03,0,1944,1944,CBH
Cristobal Huet,1975-09-03,7,2003,2010,"LAK,MTL,WSH,CHI"
Gary Jarrett,1942-09-03,11,1961,1972,"TOR,DET,OAK,CGS"
Fred Knipscheer,1969-09-03,2,1994,1996,"BOS,STL"
Matthew Konan,1991-09-03,0,2013,2013,PHI
Gerry Meehan,1946-09-03,10,1969,1979,"PHI,TOR,BUF,ATF,VAN,WSH"
James Neal,1987-09-03,11,2009,2020,"DAL,PIT,NSH,VEG,CGY,EDM"
Jaroslav Obsut,1976-09-03,1,2001,2002,"STL,COL"
Jed Ortmeyer,1978-09-03,8,2004,2012,"NYR,NSH,SJS,MIN"
Michal Rozsival,1978-09-03,17,2000,2017,"PIT,NYR,PHX,CHI"
Tim Sheehy,1948-09-03,2,1978,1980,"DET,HAR"
Brian Spencer,1949-09-03,9,1970,1979,"TOR,NYI,BUF,PIT"
Martin Straka,1972-09-03,15,1993,2008,"PIT,OTT,FLA,NYI,LAK,NYR"
Greg Theberge,1959-09-03,4,1980,1984,WSH
Maxim Afinogenov,1979-09-04,10,2000,2010,"BUF,ATL"
Butch Bouchard*,1919-09-04,14,1942,1956,MTL
Craig Conroy,1971-09-04,16,1995,2011,"MTL,STL,CGY,LAK"
Ray Gariepy,1928-09-04,2,1954,1956,"BOS,TOR"
Len Hachborn,1961-09-04,2,1984,1986,"PHI,LAK"
Jeff Hamilton,1977-09-04,5,2004,2009,"NYI,CHI,CAR,TOR"
Alex Hicks,1969-09-04,4,1996,2000,"MDA,PIT,FLA,SJS"
Magnus Johansson,1973-09-04,0,2008,2008,"CHI,FLA"
Wayne King,1951-09-04,2,1974,1976,CGS
Alan Letang,1975-09-04,3,2000,2003,"DAL,CGY,NYI"
Cliff Malone,1925-09-04,0,1952,1952,MTL
Sergio Momesso,1965-09-04,13,1984,1997,"MTL,STL,VAN,NYR,TOR"
Bert Olmstead*,1926-09-04,13,1949,1962,"CBH,MTL,TOR"
Matt Pelech,1987-09-04,5,2009,2014,"CGY,SJS"
Rags Raglan,1927-09-04,2,1951,1953,"DET,CBH"
Jerome Samson,1987-09-04,2,2010,2012,CAR
Tomas Sandstrom,1964-09-04,14,1985,1999,"NYR,LAK,PIT,DET,MDA"
Jim Schoenfeld,1952-09-04,12,1973,1985,"BUF,DET,BOS"
Paul Shakes,1952-09-04,0,1974,1974,CGS
Niklas Svedberg,1989-09-04,1,2014,2015,BOS
Pascal Trepanier,1973-09-04,5,1998,2003,"COL,MDA,NSH"
John Vanbiesbrouck,1963-09-04,20,1982,2002,"NYR,FLA,PHI,NJD,NYI"
Peter Bartos,1973-09-05,0,2001,2001,MIN
Filip Chytil,1999-09-05,2,2018,2020,NYR
Dave Dryden,1941-09-05,18,1962,1980,"NYR,CBH,BUF,EDM"
Henry Dyck,1912-09-05,0,1944,1944,NYR
John Ferguson,1938-09-05,7,1964,1971,MTL
Mark Ferner,1965-09-05,8,1987,1995,"BUF,WSH,MDA,DET"
Harrison Gray,1941-09-05,0,1964,1964,DET
Alexandre Grenier,1991-09-05,1,2016,2017,VAN
Lloyd Gross,1905-09-05,8,1927,1935,"TOR,BOS,DET,NYA"
Murray Henderson,1921-09-05,7,1945,1952,BOS
Bill Hogaboam,1949-09-05,7,1973,1980,"ATF,DET,MNS"
Stan Jonathan,1955-09-05,7,1976,1983,"BOS,PIT"
Blaine Lacher,1970-09-05,1,1995,1996,BOS
Don Maloney,1958-09-05,12,1979,1991,"NYR,HAR,NYI"
Ken Mann,1953-09-05,0,1976,1976,DET
Scott Parse,1984-09-05,2,2010,2012,LAK
Ryan Potulny,1984-09-05,5,2006,2011,"PHI,EDM,CHI,OTT"
Craig Smith,1989-09-05,8,2012,2020,NSH
Lucas Wallmark,1995-09-05,3,2017,2020,"CAR,FLA"
Wayne Bianchin,1953-09-06,6,1974,1980,"PIT,EDM"
Brian Dumoulin,1991-09-06,6,2014,2020,PIT
Patrick Fischer,1975-09-06,0,2007,2007,PHX
Rolly Huard,1902-09-06,0,1931,1931,TOR
Ivan Huml,1981-09-06,2,2002,2004,BOS
Danny Irmen,1984-09-06,0,2010,2010,MIN
Igor Korolev,1970-09-06,11,1993,2004,"STL,WIN,PHX,TOR,CHI"
Paul Ladue,1992-09-06,3,2017,2020,LAK
Kilby MacDonald,1914-09-06,5,1940,1945,NYR
Red Mitchell,1912-09-06,3,1942,1945,CBH
Todd Okerlund,1964-09-06,0,1988,1988,NYI
Pavel Patera,1971-09-06,1,2000,2001,"DAL,MIN"
Bill Root,1959-09-06,5,1983,1988,"MTL,TOR,PHI,STL"
Glen Sharpley,1956-09-06,5,1977,1982,"MNS,CBH"
Brian Smith,1940-09-06,1,1968,1969,"LAK,MNS"
Gene Achtymichuk,1932-09-07,7,1952,1959,"MTL,DET"
Douglas Adam,1923-09-07,0,1950,1950,NYR
Warren Babe,1968-09-07,3,1988,1991,MNS
Nicholas Caamano,1998-09-07,0,2020,2020,DAL
Matt Cooke,1978-09-07,16,1999,2015,"VAN,WSH,PIT,MIN"
Shawn Evans,1965-09-07,4,1986,1990,"STL,NYI"
Eric Fehr,1985-09-07,13,2006,2019,"WSH,WPG,PIT,TOR,SJS,MIN"
Orland Kurtenbach,1936-09-07,13,1961,1974,"NYR,BOS,TOR,VAN"
Sasha Lakovic,1971-09-07,2,1997,1999,"CGY,NJD"
Jacques Lemaire*,1945-09-07,11,1968,1979,MTL
Andrew MacDonald,1986-09-07,10,2009,2019,"NYI,PHI"
Paul Mara,1979-09-07,12,1999,2011,"TBL,PHX,BOS,NYR,MTL,ANA"
Paul Marshall,1960-09-07,3,1980,1983,"PIT,TOR,HAR"
Bryan Maxwell,1955-09-07,7,1978,1985,"MNS,STL,WIN,PIT"
Lindsay Middlebrook,1955-09-07,3,1980,1983,"WIN,MNS,EDM,NJD"
John Mokosak,1963-09-07,1,1989,1990,DET
Baldy Northcott,1908-09-07,10,1929,1939,"MTM,CBH"
Chris Oddleifson,1950-09-07,8,1973,1981,"BOS,VAN"
Gino Odjick,1970-09-07,11,1991,2002,"VAN,NYI,PHI,MTL"
Aaron Palushaj,1989-09-07,3,2011,2014,"MTL,COL,CAR"
Jeff Parker,1964-09-07,4,1987,1991,"BUF,HAR"
Dusan Pasek,1960-09-07,0,1989,1989,MNS
Larry Romanchych,1949-09-07,6,1971,1977,"CBH,ATF"
Duncan Siemens,1993-09-07,3,2015,2018,COL
Tony Tanti,1963-09-07,10,1982,1992,"CBH,VAN,PIT,BUF"
Rob Zepp,1981-09-07,0,2015,2015,PHI
Dwight Bialowas,1952-09-08,3,1974,1977,"ATF,MNS"
Reid Boucher,1993-09-08,5,2014,2019,"NJD,NSH,VAN"
Paul DiPietro,1970-09-08,5,1992,1997,"MTL,TOR,LAK"
Tyler Eckford,1985-09-08,1,2010,2011,NJD
Bill Gooden,1923-09-08,1,1943,1944,NYR
Joe Junkin,1946-09-08,0,1969,1969,BOS
Michal Kempny,1990-09-08,3,2017,2020,"CHI,WSH"
Ralph MacSweyn,1942-09-08,4,1968,1972,PHI
Bud Maracle,1904-09-08,0,1931,1931,NYR
Trent McCleary,1972-09-08,4,1996,2000,"OTT,BOS,MTL"
Jack McIntyre,1930-09-08,10,1950,1960,"BOS,CBH,DET"
Jay McKee,1977-09-08,14,1996,2010,"BUF,STL,PIT"
Nino Niederreiter,1992-09-08,9,2011,2020,"NYI,MIN,CAR"
Teddy Purcell,1985-09-08,9,2008,2017,"LAK,TBL,EDM,FLA"
Pierre Sevigny,1971-09-08,4,1994,1998,"MTL,NYR"
Marco Sturm,1978-09-08,14,1998,2012,"SJS,BOS,LAK,WSH,FLA,VAN"
Rogie Vachon*,1945-09-08,15,1967,1982,"MTL,LAK,DET,BOS"
Viv Allen,1916-09-09,0,1941,1941,NYA
Bob Baun,1936-09-09,16,1957,1973,"TOR,OAK,DET"
Corrie D'Alessio,1969-09-09,0,1993,1993,HAR
Josh Gratton,1982-09-09,3,2006,2009,"PHI,PHX"
Kevin Hatcher,1966-09-09,16,1985,2001,"WSH,DAL,PIT,NYR,CAR"
Trent Kaese,1967-09-09,0,1989,1989,BUF
Alexander Khokhlachev,1993-09-09,2,2014,2016,BOS
Ed Nicholson,1923-09-09,0,1948,1948,DET
Hickey Nicholson,1911-09-09,0,1938,1938,CBH
Mattias Ohlund,1976-09-09,13,1998,2011,"VAN,TBL"
Nelson Pyatt,1953-09-09,6,1974,1980,"DET,WSH,CLR"
Lee Sorochan,1975-09-09,1,1999,2000,CGY
Keith Yandle,1986-09-09,13,2007,2020,"PHX,ARI,NYR,FLA"
Dave Feamster,1958-09-10,3,1982,1985,CBH
Rob Holland,1957-09-10,1,1980,1981,PIT
Tim Hunter,1960-09-10,15,1982,1997,"CGY,QUE,VAN,SJS"
Chris Joseph,1969-09-10,13,1988,2001,"EDM,PIT,TBL,VAN,PHI,PHX,ATL"
Corban Knight,1990-09-10,5,2014,2019,"CGY,FLA,PHI"
Staffan Kronwall,1982-09-10,4,2006,2010,"TOR,WSH,CGY"
Gordon Mark,1964-09-10,8,1987,1995,"NJD,EDM"
Carson McMillan,1988-09-10,3,2011,2014,MIN
Kevin Miehm,1969-09-10,1,1993,1994,STL
Joe Nieuwendyk*,1966-09-10,20,1987,2007,"CGY,DAL,NJD,TOR,FLA"
Pete Palangio,1908-09-10,11,1927,1938,"MTL,DTC,CBH"
Robert Palmer,1956-09-10,6,1978,1984,"LAK,NJD"
Jim Pappin,1939-09-10,13,1964,1977,"TOR,CBH,CGS,CLE"
Denis Pederson,1975-09-10,7,1996,2003,"NJD,VAN,PHX,NSH"
Sergei Petrenko,1968-09-10,0,1994,1994,BUF
Peter Ratchuk,1977-09-10,2,1999,2001,FLA
Paul Runge,1908-09-10,7,1931,1938,"BOS,MTM,MTL"
Jordan Staal,1988-09-10,13,2007,2020,"PIT,CAR"
Troy Terry,1997-09-10,2,2018,2020,ANA
Yvon Vautour,1956-09-10,5,1980,1985,"NYI,CLR,NJD,QUE"
Brian Watts,1947-09-10,0,1976,1976,DET
Craig Billington,1966-09-11,17,1986,2003,"NJD,OTT,BOS,COL,WSH"
Buddy Boone,1932-09-11,0,1958,1958,BOS
Gord Brooks,1950-09-11,3,1972,1975,"STL,WSH"
Mike Byers,1946-09-11,4,1968,1972,"TOR,PHI,LAK,BUF"
Tony Camazzola,1962-09-11,0,1982,1982,WSH
Mike Comrie,1980-09-11,10,2001,2011,"EDM,PHI,PHX,OTT,NYI,PIT"
Marc Dufour,1941-09-11,5,1964,1969,"NYR,LAK"
Sean Gagnon,1973-09-11,3,1998,2001,"PHX,OTT"
Gus Kyle,1923-09-11,2,1950,1952,"NYR,BOS"
Shep Mayer,1923-09-11,0,1943,1943,TOR
Butch Paul,1943-09-11,0,1965,1965,DET
Andre Petersson,1990-09-11,0,2012,2012,OTT
Barry Richter,1970-09-11,5,1996,2001,"NYR,BOS,NYI,MTL"
Garth Rizzuto,1947-09-11,0,1971,1971,VAN
Ben Scrivens,1986-09-11,4,2012,2016,"TOR,EDM,LAK,MTL"
Glen Seabrooke,1967-09-11,2,1987,1989,PHI
Konstantin Shafranov,1968-09-11,0,1997,1997,STL
Frank Simonetti,1962-09-11,3,1985,1988,BOS
Zack Stortini,1985-09-11,5,2007,2012,"EDM,NSH"
Garry Swain,1947-09-11,0,1969,1969,PIT
Teuvo Teravainen,1994-09-11,6,2014,2020,"CHI,CAR"
Scott Timmins,1989-09-11,2,2011,2013,FLA
Wes Trainor,1922-09-11,0,1949,1949,NYR
J.P. Vigier,1976-09-11,6,2001,2007,ATL
Butch Williams,1952-09-11,2,1974,1976,"STL,CGS"
Jaret Anderson-Dolan,1999-09-12,1,2019,2020,LAK
Marcel Bonin,1932-09-12,9,1953,1962,"DET,BOS,MTL"
Shawn Byram,1968-09-12,1,1991,1992,"NYI,CHI"
Tommy Cross,1989-09-12,0,2016,2016,BOS
Bob Davie,1912-09-12,2,1934,1936,BOS
Norm Dube,1951-09-12,1,1975,1976,KCS
Martin Lapointe,1973-09-12,16,1992,2008,"DET,BOS,CHI,OTT"
Ryan Lomberg,1994-09-12,1,2018,2019,CGY
Joe Lundrigan,1948-09-12,2,1973,1975,"TOR,WSH"
Earl Miller,1905-09-12,4,1928,1932,"CBH,TOR"
Mike Murphy,1950-09-12,11,1972,1983,"STL,NYR,LAK"
Neil Nicholson,1949-09-12,5,1973,1978,NYI
Paul Ranger,1984-09-12,8,2006,2014,"TBL,TOR"
Josef Vasicek,1980-09-12,7,2001,2008,"CAR,NSH,NYI"
Ron Ward,1944-09-12,2,1970,1972,"TOR,VAN"
Patrick Wiercioch,1990-09-12,6,2011,2017,"OTT,COL"
Craig Cunningham,1990-09-13,2,2014,2016,"BOS,ARI"
Harold Darragh,1902-09-13,7,1926,1933,"PTP,BOS,PHQ,TOR"
Brandon DeFazio,1988-09-13,0,2015,2015,VAN
Ted Drury,1971-09-13,7,1994,2001,"CGY,HAR,OTT,MDA,NYI,CBJ"
Turner Elson,1992-09-13,0,2016,2016,CGY
Alex Formenton,1999-09-13,1,2018,2019,OTT
Emile Francis*,1926-09-13,5,1947,1952,"CBH,NYR"
Scott Gruhl,1959-09-13,6,1982,1988,"LAK,PIT"
Mark Jankowski,1994-09-13,3,2017,2020,CGY
Adrian Kempe,1996-09-13,3,2017,2020,LAK
Igor Kravchuk,1966-09-13,11,1992,2003,"CHI,EDM,STL,OTT,CGY,FLA"
Art Lesieur,1907-09-13,7,1929,1936,"CBH,MTL"
Dave Reece,1948-09-13,0,1976,1976,BOS
Craig Rivet,1974-09-13,16,1995,2011,"MTL,SJS,BUF,CBJ"
Don Simmons,1931-09-13,12,1957,1969,"BOS,TOR,NYR"
Don Smillie,1910-09-13,0,1934,1934,BOS
Phil Stein,1913-09-13,0,1940,1940,TOR
Shay Stephenson,1983-09-13,0,2007,2007,LAK
Alexandre Texier,1999-09-13,1,2019,2020,CBJ
Jose Theodore,1976-09-13,17,1996,2013,"MTL,COL,WSH,MIN,FLA"
Reto Von Arx,1976-09-13,0,2001,2001,CHI
Miles Wood,1995-09-13,4,2016,2020,NJD
Travis Boyd,1993-09-14,2,2018,2020,WSH
Harold Brown,1920-09-14,0,1946,1946,NYR
David Desharnais,1986-09-14,8,2010,2018,"MTL,EDM,NYR"
Chris Evans,1946-09-14,5,1970,1975,"TOR,BUF,STL,DET,KCS"
Todd Flichel,1964-09-14,2,1988,1990,WIN
Gus Giesebrecht,1917-09-14,3,1939,1942,DET
Alex Killorn,1989-09-14,7,2013,2020,TBL
Orest Kindrachuk,1950-09-14,9,1973,1982,"PHI,PIT,WSH"
Jason King,1981-09-14,5,2003,2008,"VAN,ANA"
Tom Kurvers,1962-09-14,10,1985,1995,"MTL,BUF,NJD,TOR,VAN,NYI,MDA"
Craig Laughlin,1957-09-14,7,1982,1989,"MTL,WSH,LAK,TOR"
Per Ledin,1978-09-14,0,2009,2009,COL
Mike Lenarduzzi,1972-09-14,1,1993,1994,HAR
Olivier Michaud,1983-09-14,0,2002,2002,MTL
Brad Palmer,1961-09-14,2,1981,1983,"MNS,BOS"
Petr Prucha,1982-09-14,5,2006,2011,"NYR,PHX"
Travis Scott,1975-09-14,0,2001,2001,LAK
Christian Soucy,1970-09-14,0,1994,1994,CHI
Layne Ulmer,1980-09-14,0,2004,2004,NYR
Mick Vukota,1966-09-14,10,1988,1998,"NYI,MTL,TBL"
Peter Ambroziak,1971-09-15,0,1995,1995,BUF
Derek Bekar,1975-09-15,4,2000,2004,"STL,LAK,NYI"
Dusty Blair,1929-09-15,0,1951,1951,TOR
Richard Brodeur,1952-09-15,8,1980,1988,"NYI,VAN,HAR"
Fred Brown,1900-09-15,0,1928,1928,MTM
Mike Greenlay,1968-09-15,0,1990,1990,EDM
Len Haley,1931-09-15,1,1960,1961,DET
Ken Houston,1953-09-15,8,1976,1984,"ATF,CGY,WSH,LAK"
Bernie Johnston,1956-09-15,1,1980,1981,HAR
Ralph Klassen,1955-09-15,8,1976,1984,"CGS,CLE,CLR,STL"
Jerry Korab,1948-09-15,14,1971,1985,"CBH,BUF,VAN,LAK"
Mike Korney,1953-09-15,5,1974,1979,"DET,NYR"
Bob Liddington,1948-09-15,0,1971,1971,TOR
Patrick Marleau,1979-09-15,22,1998,2020,"SJS,TOR,PIT"
Tom McCarthy,1934-09-15,4,1957,1961,"DET,BOS"
Mike Pandolfo,1979-09-15,0,2004,2004,CBJ
Alf Pike,1917-09-15,7,1940,1947,NYR
Gerry Pinder,1948-09-15,2,1970,1972,"CBH,CGS"
Marek Posmyk,1978-09-15,1,2000,2001,TBL
Joel Quenneville,1958-09-15,12,1979,1991,"TOR,CLR,NJD,HAR,WSH"
Emory Sparrow,1898-09-15,0,1925,1925,BOS
David Wolf,1989-09-15,0,2015,2015,CGY
John Chad,1919-09-16,6,1940,1946,CBH
Mike Dwyer,1957-09-16,3,1979,1982,"CLR,CGY"
Pierre Hamel,1952-09-16,6,1975,1981,"TOR,WIN"
Braden Holtby,1989-09-16,9,2011,2020,WSH
Rick Lanz,1961-09-16,11,1981,1992,"VAN,TOR,CHI"
Kevin LaVallee,1961-09-16,6,1981,1987,"CGY,LAK,STL,PIT"
Anthony Mantha,1994-09-16,4,2016,2020,DET
Gerry Melnyk,1934-09-16,8,1960,1968,"DET,CBH,STL"
Jack Miller,1925-09-16,1,1950,1951,CBH
Dan Olesevich,1937-09-16,0,1962,1962,NYR
Jaroslav Otevrel,1968-09-16,1,1993,1994,SJS
Larry Sacharuk,1952-09-16,4,1973,1977,"NYR,STL"
George Senick,1929-09-16,0,1953,1953,NYR
Patrik Stefan,1980-09-16,7,2000,2007,"ATL,DAL"
Paul Terbenche,1945-09-16,6,1968,1974,"CBH,BUF"
Brady Tkachuk,1999-09-16,1,2019,2020,OTT
Dustin Tokarski,1989-09-16,7,2010,2017,"TBL,MTL,ANA"
Gord Turlik,1939-09-16,0,1960,1960,BOS
Matt Underhill,1979-09-16,0,2004,2004,CHI
Eric Vail,1953-09-16,8,1974,1982,"ATF,CGY,DET"
Bob Wren,1974-09-16,4,1998,2002,"MDA,TOR"
Scott Arniel,1962-09-17,10,1982,1992,"WIN,BUF,BOS"
Zac Bierk,1976-09-17,6,1998,2004,"TBL,MIN,PHX"
Marc-Andre Bourdon,1989-09-17,0,2012,2012,PHI
Michael Bunting,1995-09-17,0,2019,2019,ARI
Gene Carr,1951-09-17,7,1972,1979,"NYR,STL,LAK,PIT,ATF"
Chris Cichocki,1963-09-17,3,1986,1989,"DET,NJD"
Michael Dark,1963-09-17,1,1987,1988,STL
Mario Ferraro,1998-09-17,0,2020,2020,SJS
Yutaka Fukufuji,1982-09-17,0,2007,2007,LAK
Jay Henderson,1978-09-17,2,1999,2001,BOS
Shawn Horcoff,1978-09-17,15,2001,2016,"EDM,DAL,ANA"
Frank Ingram,1907-09-17,2,1930,1932,CBH
Sheldon Keefe,1980-09-17,2,2001,2003,TBL
Jan Ludvig,1961-09-17,6,1983,1989,"NJD,BUF"
Auston Matthews,1997-09-17,3,2017,2020,TOR
Grant Mulvey,1956-09-17,9,1975,1984,"CBH,NJD"
Garth Murray,1982-09-17,5,2004,2009,"NYR,MTL,FLA,PHX"
Alex Ovechkin,1985-09-17,14,2006,2020,WSH
Nikolai Prokhorkin,1993-09-17,0,2020,2020,LAK
Claude Provost,1933-09-17,14,1956,1970,MTL
Mason Raymond,1985-09-17,9,2008,2017,"VAN,TOR,CGY,ANA"
Clarence Schmidt,1925-09-17,0,1944,1944,BOS
Egor Yakovlev,1991-09-17,0,2019,2019,NJD
Rob Zamuner,1969-09-17,12,1992,2004,"NYR,TBL,OTT,BOS"
Valeri Zelepukin,1968-09-17,9,1992,2001,"NJD,EDM,PHI,CHI"
Ralph Backstrom,1937-09-18,16,1957,1973,"MTL,LAK,CBH"
Jack Bionda,1933-09-18,3,1956,1959,"TOR,BOS"
Paul Brousseau,1973-09-18,5,1996,2001,"COL,TBL,FLA"
Peter Budaj,1982-09-18,13,2006,2019,"COL,MTL,LAK,TBL"
Tom Chorske,1966-09-18,10,1990,2000,"MTL,NJD,OTT,NYI,CGY,WSH,PIT"
Bun Cook*,1903-09-18,10,1927,1937,"NYR,BOS"
Bill Dineen,1932-09-18,4,1954,1958,"DET,CBH"
Richard Grenier,1952-09-18,0,1973,1973,NYI
Kelly Kisio,1959-09-18,12,1983,1995,"DET,NYR,SJS,CGY"
Lasse Kukkonen,1981-09-18,5,2004,2009,"CHI,PHI"
Ray Macias,1986-09-18,2,2009,2011,COL
Al Millar,1929-09-18,0,1958,1958,BOS
Andrew Miller,1988-09-18,1,2015,2016,EDM
Angelo Moretto,1953-09-18,0,1977,1977,CLE
Chad Penney,1973-09-18,0,1994,1994,OTT
Jared Ross,1982-09-18,1,2009,2010,PHI
Kent Ruhnke,1952-09-18,0,1976,1976,BOS
Darryl Sittler*,1950-09-18,14,1971,1985,"TOR,PHI,DET"
Carl Smith,1917-09-18,0,1944,1944,DET
Peter Stastny*,1956-09-18,14,1981,1995,"QUE,NJD,STL"
Cam Stewart,1971-09-18,7,1994,2001,"BOS,FLA,MIN"
Conor Timmins,1998-09-18,0,2020,2020,COL
Brock Trotter,1987-09-18,0,2010,2010,MTL
Roger Wilson,1946-09-18,0,1975,1975,CBH
Don Beaupre,1961-09-19,16,1981,1997,"MNS,WSH,OTT,TOR"
Andre Boudrias,1943-09-19,12,1964,1976,"MTL,MNS,CBH,STL,VAN"
Dan Bylsma,1970-09-19,8,1996,2004,"LAK,MDA"
Andre Champagne,1943-09-19,0,1963,1963,TOR
Odie Cleghorn,1891-09-19,9,1919,1928,"MTL,PTP"
Scott Daniels,1969-09-19,6,1993,1999,"HAR,PHI,NJD"
Gilbert Dionne,1970-09-19,5,1991,1996,"MTL,PHI,FLA"
Rick DiPietro,1981-09-19,12,2001,2013,NYI
Andre Gill,1941-09-19,0,1968,1968,BOS
Jonas Johansson,1995-09-19,0,2020,2020,BUF
Luke Johnson,1994-09-19,1,2019,2020,"CHI,MIN"
Michael Kapla,1994-09-19,0,2017,2017,NJD
Mario Kempe,1988-09-19,1,2018,2019,ARI
Milan Marcetta,1936-09-19,1,1968,1969,MNS
Jack McGill,1920-09-19,5,1942,1947,BOS
Nolan Patrick,1998-09-19,1,2018,2019,PHI
Joni Pitkanen,1983-09-19,9,2004,2013,"PHI,EDM,CAR"
Daniel Poulin,1957-09-19,0,1982,1982,MNS
Nick Spaling,1988-09-19,6,2010,2016,"NSH,PIT,SJS,TOR"
Mikael Tellqvist,1979-09-19,6,2003,2009,"TOR,PHX,BUF"
Antti Tormanen,1970-09-19,0,1996,1996,OTT
Ed Westfall,1940-09-19,17,1962,1979,"BOS,NYI"
Jason Bacashihua,1982-09-20,1,2006,2007,STL
Sergei Bobrovsky,1988-09-20,9,2011,2020,"PHI,CBJ,FLA"
Ray Cullen,1941-09-20,5,1966,1971,"NYR,DET,MNS,VAN"
Dylan Ferguson,1998-09-20,0,2018,2018,VEG
Mike Forbes,1957-09-20,4,1978,1982,"BOS,EDM"
Matt Glennon,1968-09-20,0,1992,1992,BOS
Sam Godin,1909-09-20,6,1928,1934,"OTS,MTL"
Ryan Hartman,1994-09-20,5,2015,2020,"CHI,NSH,PHI,MIN"
Jan Hlavac,1976-09-20,8,2000,2008,"NYR,PHI,VAN,CAR,NSH,TBL"
Dave Kelly,1952-09-20,0,1977,1977,DET
Kerry Ketter,1947-09-20,0,1973,1973,ATF
Guy Lafleur*,1951-09-20,19,1972,1991,"MTL,NYR,QUE"
Brandon Mashinter,1988-09-20,5,2011,2016,"SJS,NYR,CHI"
Jeff Nielsen,1971-09-20,4,1997,2001,"NYR,MDA,MIN"
Glen Richardson,1955-09-20,0,1976,1976,VAN
Bill Riley,1950-09-20,5,1975,1980,"WSH,WIN"
Radim Simek,1992-09-20,1,2019,2020,SJS
Kevin Stenlund,1996-09-20,1,2019,2020,CBJ
John Tavares,1990-09-20,10,2010,2020,"NYI,TOR"
Blair Barnes,1960-09-21,0,1983,1983,LAK
Gord Dineen,1962-09-21,12,1983,1995,"NYI,MNS,PIT,OTT"
Bob Errey,1964-09-21,14,1984,1998,"PIT,BUF,SJS,DET,DAL,NYR"
Matti Hagman,1955-09-21,5,1977,1982,"BOS,EDM"
Milt Halliday,1906-09-21,2,1927,1929,OTS
Uli Hiemer,1962-09-21,2,1985,1987,NJD
Chuck Holmes,1934-09-21,3,1959,1962,DET
Percy Jackson,1907-09-21,4,1932,1936,"BOS,NYA,NYR"
Nick Jensen,1990-09-21,3,2017,2020,"DET,WSH"
Curtis Leschyshyn,1969-09-21,15,1989,2004,"QUE,COL,HAR,WSH,CAR,MIN,OTT"
Troy Loney,1963-09-21,11,1984,1995,"PIT,MDA,NYI,NYR"
Ross Lowe,1928-09-21,2,1950,1952,"BOS,MTL"
Howie Morenz*,1902-09-21,13,1924,1937,"MTL,CBH,NYR"
Petr Prajsler,1965-09-21,4,1988,1992,"LAK,BOS"
Al Staley,1928-09-21,0,1949,1949,NYR
Barry Sullivan,1927-09-21,0,1948,1948,DET
Johan Sundstrom,1992-09-21,0,2014,2014,NYI
Bill Sweatt,1988-09-21,1,2012,2013,VAN
Connie Tudin,1917-09-21,0,1942,1942,MTL
Derick Brassard,1987-09-22,12,2008,2020,"CBJ,NYR,OTT,PIT,COL,FLA,NYI"
Matt Elich,1979-09-22,1,2000,2001,TBL
Pat Falloon,1972-09-22,8,1992,2000,"SJS,PHI,OTT,EDM,PIT"
Gerry Foley,1932-09-22,14,1955,1969,"TOR,NYR,LAK"
Rick Foley,1945-09-22,3,1971,1974,"CBH,PHI,DET"
Brian Ford,1961-09-22,1,1984,1985,"QUE,PIT"
Mark Johnson,1957-09-22,10,1980,1990,"PIT,MNS,HAR,STL,NJD"
Gerry McNamara,1934-09-22,9,1961,1970,TOR
Carl Mokosak,1962-09-22,7,1982,1989,"CGY,LAK,PHI,PIT,BOS"
Steve Moore,1978-09-22,2,2002,2004,COL
Ethan Moreau,1975-09-22,16,1996,2012,"CHI,EDM,CBJ,LAK"
Antti-Jussi Niemi,1977-09-22,1,2001,2002,MDA
Janne Niskala,1981-09-22,0,2009,2009,TBL
Harvie Pocza,1959-09-22,2,1980,1982,WSH
Craig Redmond,1965-09-22,4,1985,1989,"LAK,EDM"
Mike Richter,1966-09-22,13,1990,2003,NYR
Brandy Semchuk,1971-09-22,0,1993,1993,LAK
Petr Taticek,1983-09-22,0,2006,2006,FLA
Milan Tichy,1969-09-22,3,1993,1996,"CHI,NYI"
Alexander Wennberg,1994-09-22,5,2015,2020,CBJ
Pontus Aberg,1993-09-23,3,2017,2020,"NSH,EDM,ANA,MIN,TOR"
Donald Audette,1969-09-23,13,1991,2004,"BUF,LAK,ATL,DAL,MTL,FLA"
Dan Bonar,1956-09-23,2,1981,1983,LAK
Christian Bordeleau,1947-09-23,3,1969,1972,"MTL,STL,CBH"
Gabriel Bourque,1990-09-23,8,2012,2020,"NSH,COL,WPG"
Garrett Burnett,1975-09-23,0,2004,2004,MDA
Matthieu Descoteaux,1977-09-23,0,2001,2001,MTL
Kaden Fulcher,1998-09-23,0,2019,2019,DET
Mario Giallonardo,1957-09-23,1,1980,1981,CLR
Zach Hamill,1988-09-23,2,2010,2012,BOS
Lukas Kaspar,1985-09-23,1,2008,2009,SJS
Wildor Larochelle,1906-09-23,11,1926,1937,"MTL,CBH"
Petteri Lindbohm,1993-09-23,2,2015,2017,STL
Joffrey Lupul,1983-09-23,12,2004,2016,"MDA,EDM,PHI,ANA,TOR"
Milan Novy,1951-09-23,0,1983,1983,WSH
Bill Phillips,1902-09-23,0,1930,1930,MTM
Curt Ridley,1951-09-23,6,1975,1981,"NYR,VAN,TOR"
Dixon Ward,1968-09-23,10,1993,2003,"VAN,LAK,TOR,BUF,BOS,NYR"
Yannick Weber,1988-09-23,11,2009,2020,"MTL,VAN,NSH"
Vitali Yeremeyev,1975-09-23,0,2001,2001,NYR
Karl Alzner,1988-09-24,11,2009,2020,"WSH,MTL"
Chris Bala,1978-09-24,0,2002,2002,OTT
Paul Carey,1988-09-24,6,2014,2020,"COL,WSH,NYR,BOS,OTT"
Tim Ecclestone,1947-09-24,10,1968,1978,"STL,DET,TOR,ATF"
Miloslav Guren,1976-09-24,1,1999,2000,MTL
Walter Harnott,1909-09-24,0,1934,1934,BOS
Dale Henry,1964-09-24,5,1985,1990,NYI
Albert Holway,1902-09-24,5,1924,1929,"TRS,MTM,PTP"
Steven Kampfer,1988-09-24,9,2011,2020,"BOS,MIN,FLA,NYR"
Brett Lernout,1995-09-24,2,2016,2018,MTL
Tapio Levo,1955-09-24,1,1982,1983,"CLR,NJD"
Mike Lundin,1984-09-24,5,2008,2013,"TBL,MIN,OTT"
Dan Maloney,1950-09-24,11,1971,1982,"CBH,LAK,DET,TOR"
Kris Manery,1954-09-24,3,1978,1981,"CLE,MNS,VAN,WIN"
Davis Payne,1970-09-24,1,1996,1997,BOS
Tomas Surovy,1981-09-24,3,2003,2006,PIT
Frank Bialowas,1969-09-25,0,1994,1994,TOR
George Boothman,1916-09-25,1,1943,1944,TOR
Bill Bowler,1974-09-25,0,2001,2001,CBJ
Matt Carle,1984-09-25,11,2006,2017,"SJS,PHI,TBL,NSH"
Ed Gorman,1892-09-25,3,1925,1928,"OTS,TOR"
Kim Issel,1967-09-25,0,1989,1989,EDM
Calle Jarnkrok,1991-09-25,6,2014,2020,NSH
Toni Lydman,1977-09-25,12,2001,2013,"CGY,BUF,ANA"
Stu McNeill,1938-09-25,2,1958,1960,DET
Bryan McSheffrey,1952-09-25,2,1973,1975,"VAN,BUF"
Joel Prpic,1974-09-25,3,1998,2001,"BOS,COL"
Al Simmons,1951-09-25,4,1972,1976,"CGS,BOS"
Stu Smith,1918-09-25,1,1941,1942,MTL
Carol Vadnais,1945-09-25,16,1967,1983,"MTL,OAK,CGS,BOS,NYR,NJD"
Alexandre Volchkov,1977-09-25,0,2000,2000,WSH
Aubrey Webster,1912-09-25,4,1931,1935,"PHQ,MTM"
Joe Zanussi,1947-09-25,2,1975,1977,"NYR,BOS,STL"
Clint Benedict*,1892-09-26,12,1918,1930,"OTS,MTM"
Jonas Bergqvist,1962-09-26,0,1990,1990,CGY
Frank Brimsek*,1915-09-26,11,1939,1950,"BOS,CBH"
Craig Darby,1972-09-26,9,1995,2004,"MTL,NYI,PHI,NJD"
Norm Dussault,1925-09-26,3,1948,1951,MTL
Vic Heyliger,1912-09-26,6,1938,1944,CBH
Garry Howatt,1952-09-26,11,1973,1984,"NYI,HAR,NJD"
Craig Janney,1967-09-26,11,1988,1999,"BOS,STL,SJS,WIN,PHX,NYI,TBL"
Karson Kuhlman,1995-09-26,1,2019,2020,BOS
Chris Kunitz,1979-09-26,15,2004,2019,"MDA,ATL,ANA,PIT,TBL,CHI"
Paul Laus,1970-09-26,8,1994,2002,FLA
Joona Luoto,1997-09-26,0,2020,2020,WPG
Brooks Orpik,1980-09-26,16,2003,2019,"PIT,WSH"
Fido Purpur,1914-09-26,10,1935,1945,"STE,CBH"
John Scott,1982-09-26,7,2009,2016,"MIN,CHI,NYR,BUF,SJS,ARI,MTL"
Daniel Sedin,1980-09-26,17,2001,2018,VAN
Henrik Sedin,1980-09-26,17,2001,2018,VAN
Nick Shore,1992-09-26,5,2015,2020,"LAK,CGY,OTT,TOR,WPG"
Raymie Skilton,1889-09-26,0,1918,1918,MTW
Jack Stoddard,1926-09-26,1,1952,1953,NYR
Steve Stone,1952-09-26,0,1974,1974,VAN
Brody Sutter,1991-09-26,1,2015,2016,CAR
Bob Sykes,1951-09-26,0,1975,1975,TOR
Michel Archambault,1950-09-27,0,1977,1977,CBH
Frank Bathe,1954-09-27,8,1975,1983,"DET,PHI"
Jay Bouwmeester,1983-09-27,17,2003,2020,"FLA,CGY,STL"
Wally Boyer,1937-09-27,6,1966,1972,"TOR,CBH,OAK,PIT"
Rene Chapdelaine,1966-09-27,2,1991,1993,LAK
Jeff Cowan,1976-09-27,8,2000,2008,"CGY,ATL,LAK,VAN"
Miroslav Frycer,1959-09-27,7,1982,1989,"QUE,TOR,DET,EDM"
Gary Gambucci,1946-09-27,2,1972,1974,MNS
Blair Jones,1986-09-27,8,2007,2015,"TBL,CGY,PHI"
Dennis Kearns,1945-09-27,9,1972,1981,VAN
Daymond Langkow,1976-09-27,16,1996,2012,"TBL,PHI,PHX,CGY"
Al MacNeil,1935-09-27,12,1956,1968,"TOR,MTL,CBH,NYR,PIT"
Merlin Malinowski,1958-09-27,4,1979,1983,"CLR,HAR,NJD"
Wayne Maxner,1942-09-27,1,1965,1966,BOS
Paul Mulvey,1958-09-27,3,1979,1982,"WSH,LAK,PIT"
Ryan Murray,1993-09-27,6,2014,2020,CBJ
Aaron Rome,1983-09-27,7,2007,2014,"ANA,CBJ,VAN,DAL"
Tommy Smith*,1886-09-27,0,1920,1920,QBC
John Arbour,1945-09-28,6,1966,1972,"BOS,PIT,STL,VAN"
Bruce Eakin,1962-09-28,4,1982,1986,"CGY,DET"
Don Edwards,1955-09-28,9,1977,1986,"BUF,CGY,TOR"
Ray Emery,1982-09-28,12,2003,2015,"OTT,PHI,ANA,CHI"
Grant Fuhr*,1962-09-28,18,1982,2000,"EDM,TOR,BUF,LAK,STL,CGY"
Barry Gibbs,1948-09-28,12,1968,1980,"BOS,MNS,ATF,STL,LAK"
Doug Gibson,1953-09-28,4,1974,1978,"BOS,WSH"
Syd Howe*,1911-09-28,16,1930,1946,"OTS,PHQ,TOR,DET,STE"
Vern Kaiser,1926-09-28,0,1951,1951,MTL
Steve Kasper,1961-09-28,12,1981,1993,"BOS,LAK,PHI,TBL"
Bob Miller,1956-09-28,7,1978,1985,"BOS,CLR,LAK"
Tom O'Neill,1923-09-28,1,1944,1945,TOR
Dustin Penner,1982-09-28,8,2006,2014,"MDA,ANA,EDM,LAK,WSH"
Brian Rafalski,1973-09-28,11,2000,2011,"NJD,DET"
Jesse Schultz,1982-09-28,0,2007,2007,VAN
Tom Sestito,1987-09-28,9,2008,2017,"CBJ,PHI,VAN,PIT"
Andrei Skopintsev,1971-09-28,2,1999,2001,"TBL,ATL"
Rod Smylie,1895-09-28,5,1921,1926,"TRS,OTS"
Tim Trimper,1959-09-28,5,1980,1985,"CBH,WIN,MNS"
Art Wiebe,1912-09-28,11,1933,1944,CBH
Dave Andreychuk*,1963-09-29,23,1983,2006,"BUF,TOR,NJD,BOS,COL,TBL"
Danny Biega,1991-09-29,0,2015,2015,CAR
Wade Brookbank,1977-09-29,5,2004,2009,"NSH,VAN,BOS,CAR"
Paul Curtis,1947-09-29,3,1970,1973,"MTL,LAK,STL"
Cleon Daskalakis,1962-09-29,2,1985,1987,BOS
Rolf Edberg,1950-09-29,2,1979,1981,WSH
Mark Flood,1984-09-29,2,2010,2012,"NYI,WPG"
Mark Fraser,1986-09-29,8,2007,2015,"NJD,TOR,EDM"
Joe Hulbig,1973-09-29,4,1997,2001,"EDM,BOS"
Jorgen Jonsson,1972-09-29,0,2000,2000,"MDA,NYI"
Matt Lashoff,1986-09-29,4,2007,2011,"BOS,TBL,TOR"
Nathan Lawson,1983-09-29,3,2011,2014,"NYI,OTT"
John Miszuk,1940-09-29,6,1964,1970,"DET,CBH,PHI,MNS"
Mike Pelyk,1947-09-29,10,1968,1978,TOR
Rudy Poeschek,1966-09-29,12,1988,2000,"NYR,WIN,TBL,STL"
Benoit Pouliot,1986-09-29,11,2007,2018,"MIN,MTL,BOS,TBL,NYR,EDM,BUF"
Jordan Schroeder,1990-09-29,5,2013,2018,"VAN,MIN,CBJ"
Jon Sim,1977-09-29,12,1999,2011,"DAL,LAK,NSH,PIT,FLA,PHI,ATL,NYI"
Mario Thyer,1966-09-29,0,1990,1990,MNS
Ray Timgren,1928-09-29,6,1949,1955,"TOR,CBH"
Walt Tkaczuk,1947-09-29,13,1968,1981,NYR
John Tucker,1964-09-29,12,1984,1996,"BUF,WSH,NYI,TBL"
Jim Vesey,1965-09-29,3,1989,1992,"STL,BOS"
Kailer Yamamoto,1998-09-29,2,2018,2020,EDM
Trent Yawney,1965-09-29,11,1988,1999,"CHI,CGY,STL"
Yves Belanger,1952-09-30,5,1975,1980,"STL,ATF,BOS"
Kirk Bowman,1952-09-30,1,1977,1978,CBH
Per-Olov Brasar,1950-09-30,4,1978,1982,"MNS,VAN"
Mathieu Carle,1987-09-30,0,2010,2010,MTL
Ryane Clowe,1982-09-30,9,2006,2015,"SJS,NYR,NJD"
Cedrick Desjardins,1985-09-30,3,2011,2014,TBL
Anthony Greco,1993-09-30,0,2019,2019,FLA
Colin McDonald,1984-09-30,7,2010,2017,"EDM,PIT,NYI,PHI"
Cal O'Reilly,1986-09-30,9,2009,2018,"NSH,PHX,PIT,BUF,MIN"
Yan Stastny,1982-09-30,4,2006,2010,"BOS,EDM,STL"
Dan Brennan,1962-10-01,2,1984,1986,LAK
Luca Caputi,1988-10-01,2,2009,2011,"PIT,TOR"
Alex Chiasson,1990-10-01,7,2013,2020,"DAL,OTT,CGY,WSH,EDM"
Justin Dowling,1990-10-01,3,2017,2020,DAL
Denis Gauthier,1976-10-01,11,1998,2009,"CGY,PHI,PHX,LAK"
Frank Hughes,1949-10-01,0,1972,1972,CGS
Danny Johnson,1944-10-01,2,1970,1972,"TOR,VAN,DET"
Larry Keenan,1940-10-01,10,1962,1972,"TOR,STL,BUF,PHI"
Cliff Koroll,1946-10-01,10,1970,1980,CBH
Leo Lamoureux,1916-10-01,5,1942,1947,MTL
Mats Lindgren,1974-10-01,6,1997,2003,"EDM,NYI,VAN"
Mike Maneluk,1973-10-01,2,1999,2001,"CHI,NYR,PHI,CBJ"
Johnny Oduya,1981-10-01,11,2007,2018,"NJD,ATL,CHI,WPG,DAL,OTT,PHI"
Paul Pageau,1959-10-01,0,1981,1981,LAK
Domenic Pittis,1974-10-01,7,1997,2004,"PIT,BUF,EDM,NSH"
Dale Rominski,1975-10-01,0,2000,2000,TBL
Cliff Ronning,1965-10-01,17,1987,2004,"STL,VAN,PHX,NSH,LAK,MIN,NYI"
MacGregor Sharp,1985-10-01,0,2010,2010,ANA
Jaroslav Svejkovsky,1976-10-01,3,1997,2000,"WSH,TBL"
Dmytro Timashov,1996-10-01,0,2020,2020,"DET,TOR"
Igor Ulanov,1969-10-01,14,1992,2006,"WIN,WSH,CHI,TBL,MTL,EDM,FLA,NYR"
Doug Young,1908-10-01,9,1932,1941,"DTF,DET,MTL"
Scott Young,1967-10-01,18,1988,2006,"HAR,PIT,QUE,COL,MDA,STL,DAL"
Alex Zhamnov,1970-10-01,13,1993,2006,"WIN,CHI,PHI,BOS"
Frederik Andersen,1989-10-02,6,2014,2020,"ANA,TOR"
Glenn Anderson*,1960-10-02,15,1981,1996,"EDM,TOR,NYR,STL"
Josh Bailey,1989-10-02,11,2009,2020,NYI
Doug Barrie,1946-10-02,3,1969,1972,"PIT,BUF,LAK"
Red Beattie,1907-10-02,8,1931,1939,"BOS,DET,NYA"
Stu Bickel,1986-10-02,3,2012,2015,"NYR,MIN"
Jack Brownschidle,1955-10-02,8,1978,1986,"STL,HAR"
Bruce Draper,1940-10-02,0,1963,1963,TOR
Jonathan Filewich,1984-10-02,0,2008,2008,PIT
Alvin Fisher,1894-10-02,0,1925,1925,TRS
Link Gaetz,1968-10-02,3,1989,1992,"MNS,SJS"
Jason Herter,1970-10-02,0,1996,1996,NYI
Tim Hrynewich,1963-10-02,1,1983,1984,PIT
Kasimir Kaskisuo,1993-10-02,0,2020,2020,TOR
Martin Kaut,1999-10-02,0,2020,2020,COL
Phil Kessel,1987-10-02,13,2007,2020,"BOS,TOR,PIT,ARI"
Bill Kitchen,1960-10-02,3,1982,1985,"MTL,TOR"
Myles Lane,1905-10-02,5,1929,1934,"BOS,NYR"
Don Luce,1948-10-02,12,1970,1982,"NYR,DET,BUF,LAK,TOR"
Norm Maracle,1974-10-02,4,1998,2002,"DET,ATL"
Michael Mersch,1992-10-02,0,2016,2016,LAK
Bill Moe,1916-10-02,4,1945,1949,NYR
Hank Monteith,1945-10-02,2,1969,1971,DET
Rob Palmer,1952-10-02,2,1974,1976,CBH
Jimmy Peters,1922-10-02,8,1946,1954,"MTL,BOS,DET,CBH"
Gordie Roberts,1957-10-02,14,1980,1994,"HAR,MNS,PHI,STL,PIT,BOS"
Ralph Taylor,1905-10-02,2,1928,1930,"CBH,NYR"
Lorrain Thibeault,1918-10-02,1,1945,1946,"DET,MTL"
Graeme Townshend,1965-10-02,4,1990,1994,"BOS,NYI,OTT"
Julien Vauclair,1979-10-02,0,2004,2004,OTT
Vladimir Vorobiev,1972-10-02,2,1997,1999,"NYR,EDM"
Glen Wesley,1968-10-02,20,1988,2008,"BOS,HAR,CAR,TOR"
Brian Young,1958-10-02,0,1981,1981,CBH
Sheldon Brookbank,1980-10-03,7,2007,2014,"NSH,NJD,ANA,CHI"
Pat Flatley,1963-10-03,13,1984,1997,"NYI,NYR"
Adam Gaudette,1996-10-03,2,2018,2020,VAN
Bruno Gervais,1984-10-03,7,2006,2013,"NYI,TBL,PHI"
Mark Giordano,1983-10-03,14,2006,2020,CGY
Glenn Hall*,1931-10-03,18,1953,1971,"DET,CBH,STL"
Andy Hebenton,1929-10-03,8,1956,1964,"NYR,BOS"
Mike Johnson,1974-10-03,11,1997,2008,"TOR,TBL,PHX,MTL,STL"
Seth Jones,1994-10-03,6,2014,2020,"NSH,CBJ"
Antti Laaksonen,1973-10-03,8,1999,2007,"BOS,MIN,COL"
Michel Larocque,1976-10-03,0,2001,2001,CHI
Daniel Marois,1968-10-03,7,1989,1996,"TOR,NYI,BOS,DAL"
Jim McElmury,1949-10-03,5,1973,1978,"MNS,KCS,CLR"
Todd McLellan,1967-10-03,0,1988,1988,NYI
Michael Nylander,1972-10-03,16,1993,2009,"HAR,CGY,TBL,CHI,WSH,BOS,NYR"
Jean Ratelle*,1940-10-03,20,1961,1981,"NYR,BOS"
Jon Rohloff,1969-10-03,2,1995,1997,BOS
Ronnie Sundin,1970-10-03,0,1998,1998,NYR
Mark Vermette,1967-10-03,3,1989,1992,QUE
Jim Witherspoon,1951-10-03,0,1976,1976,LAK
Tom Askey,1974-10-04,0,1998,1998,MDA
Ray Barry,1928-10-04,0,1952,1952,BOS
Lean Bergmann,1998-10-04,0,2020,2020,SJS
Zach Boychuk,1989-10-04,6,2009,2015,"CAR,NSH,PIT"
Les Cunningham,1913-10-04,3,1937,1940,"NYA,CBH"
Rusty Fitzgerald,1972-10-04,1,1995,1996,PIT
Vic Hadfield,1940-10-04,15,1962,1977,"NYR,PIT"
Jim Hofford,1964-10-04,3,1986,1989,"BUF,LAK"
Petri Kontiola,1984-10-04,0,2008,2008,CHI
Connie Madigan,1934-10-04,0,1973,1973,STL
Gerry Odrowski,1938-10-04,11,1961,1972,"DET,OAK,STL"
Tom Webster,1948-10-04,11,1969,1980,"BOS,DET,CGS"
Justin Williams,1981-10-04,19,2001,2020,"PHI,CAR,LAK,WSH"
Jesse Winchester,1983-10-04,6,2008,2014,"OTT,FLA"
Bogdan Yakimov,1994-10-04,0,2015,2015,EDM
Sven Baertschi,1992-10-05,8,2012,2020,"CGY,VAN"
Stan Baluik,1935-10-05,0,1960,1960,BOS
Paul Beraldo,1967-10-05,1,1988,1989,BOS
Lorne Chabot,1900-10-05,10,1927,1937,"NYR,TOR,MTL,CBH,MTM,NYA"
Roy Conacher*,1916-10-05,13,1939,1952,"BOS,DET,CBH"
Jean Cusson,1942-10-05,0,1968,1968,OAK
Gary Edwards,1947-10-05,13,1969,1982,"STL,LAK,CLE,MNS,EDM,PIT"
Martin Frk,1993-10-05,3,2017,2020,"CAR,DET,LAK"
Michael Grabner,1987-10-05,10,2010,2020,"VAN,NYI,TOR,NYR,NJD,ARI"
Jesse Joensuu,1987-10-05,6,2009,2015,"NYI,EDM"
Denis Larocque,1967-10-05,0,1988,1988,LAK
Mario Lemieux*,1965-10-05,21,1985,2006,PIT
Par Lindholm,1991-10-05,1,2019,2020,"TOR,WPG,BOS"
Fredrik Olausson,1966-10-05,16,1987,2003,"WIN,EDM,MDA,PIT,DET"
Dan Plante,1971-10-05,4,1994,1998,NYI
Dean Prentice,1932-10-05,21,1953,1974,"NYR,BOS,DET,PIT,MNS"
Patrick Roy*,1965-10-05,18,1985,2003,"MTL,COL"
Curtis Sanford,1979-10-05,9,2003,2012,"STL,VAN,CBJ"
Peter Sejna,1979-10-05,4,2003,2007,STL
Logan Shaw,1991-10-05,4,2016,2020,"FLA,ANA,MTL,WPG"
Nate Thompson,1984-10-05,13,2007,2020,"BOS,NYI,TBL,ANA,LAK,OTT,MTL,PHI"
Bob Whitelaw,1916-10-05,1,1941,1942,DET
Josh Archibald,1992-10-06,4,2016,2020,"PIT,ARI,EDM"
Joel Baillargeon,1964-10-06,2,1987,1989,"WIN,QUE"
Steve Bancroft,1970-10-06,9,1993,2002,"CHI,SJS"
Daniel Briere,1977-10-06,17,1998,2015,"PHX,BUF,PHI,MTL,COL"
Roland Cloutier,1957-10-06,2,1978,1980,"DET,QUE"
Gabriel Dumont,1990-10-06,8,2012,2020,"MTL,TBL,OTT,MIN"
David Dziurzynski,1989-10-06,3,2013,2016,OTT
Tyler Ennis,1989-10-06,10,2010,2020,"BUF,MIN,TOR,EDM,OTT"
Martin Fehervary,1999-10-06,0,2020,2020,WSH
Jake Guentzel,1994-10-06,3,2017,2020,PIT
Marcus Johansson,1990-10-06,9,2011,2020,"WSH,NJD,BOS,BUF"
Kenny Jonsson,1974-10-06,9,1995,2004,"TOR,NYI"
Nazem Kadri,1990-10-06,10,2010,2020,"TOR,COL"
Ville Leino,1983-10-06,5,2009,2014,"DET,PHI,BUF"
Phil Maloney,1927-10-06,10,1950,1960,"BOS,TOR,CBH"
Jeff McLean,1969-10-06,0,1994,1994,SJS
Joe Miller,1900-10-06,3,1928,1931,"NYA,PTP,PHQ"
Sergei Mylnikov,1958-10-06,0,1990,1990,QUE
Ryan Pulock,1994-10-06,4,2016,2020,NYI
Pokey Reddick,1964-10-06,7,1987,1994,"WIN,EDM,FLA"
Bob Ring,1946-10-06,0,1966,1966,BOS
Howard Scruton,1962-10-06,0,1983,1983,LAK
Bill Stewart,1957-10-06,8,1978,1986,"BUF,STL,TOR,MNS"
Juuso Valimaki,1998-10-06,0,2019,2019,CGY
Nail Yakupov,1993-10-06,5,2013,2018,"EDM,STL,COL"
Gary Bergman,1938-10-07,11,1965,1976,"DET,MNS,KCS"
Garth Boesch,1920-10-07,3,1947,1950,TOR
Frank Boucher*,1901-10-07,22,1922,1944,"OTS,NYR"
David Bruce,1964-10-07,8,1986,1994,"VAN,STL,SJS"
Oscar Fantenberg,1991-10-07,2,2018,2020,"LAK,CGY,VAN"
Andre Faust,1969-10-07,1,1993,1994,PHI
Ross Fitzpatrick,1960-10-07,3,1983,1986,PHI
Nikolay Goldobin,1995-10-07,4,2016,2020,"SJS,VAN"
Jim Hrycuik,1949-10-07,0,1975,1975,WSH
Mike Hurlbut,1966-10-07,7,1993,2000,"NYR,QUE,BUF"
Josh Manson,1991-10-07,5,2015,2020,ANA
Bob McManama,1951-10-07,2,1974,1976,PIT
Rod Morrison,1925-10-07,0,1948,1948,DET
Darryl Olsen,1966-10-07,0,1992,1992,CGY
Jacques Richard,1952-10-07,10,1973,1983,"ATF,BUF,QUE"
Kerby Rychel,1994-10-07,4,2015,2019,"CBJ,MTL,CGY"
Cameron Schilling,1988-10-07,6,2013,2019,"WSH,WPG"
Brian Sutter,1956-10-07,11,1977,1988,STL
Scottie Upshall,1983-10-07,15,2003,2018,"NSH,PHI,PHX,CBJ,FLA,STL"
Kevyn Adams,1974-10-08,10,1998,2008,"TOR,CBJ,FLA,CAR,PHX,CHI"
John Blum,1959-10-08,7,1983,1990,"EDM,BOS,WSH,DET"
Don Cairns,1955-10-08,1,1976,1977,"KCS,CLR"
Alexandre Carrier,1996-10-08,3,2017,2020,NSH
George Gardner,1942-10-08,6,1966,1972,"DET,VAN"
Todd Harkins,1968-10-08,2,1992,1994,"CGY,HAR"
Seth Helgeson,1990-10-08,2,2015,2017,NJD
Timo Meier,1996-10-08,3,2017,2020,SJS
Branislav Mezei,1980-10-08,7,2001,2008,"NYI,FLA"
Fredrik Modin,1974-10-08,14,1997,2011,"TOR,TBL,CBJ,LAK,ATL,CGY"
Jean-Marc Richard,1966-10-08,2,1988,1990,QUE
David Rundblad,1990-10-08,4,2012,2016,"OTT,PHX,CHI"
Jordan Schmaltz,1993-10-08,2,2017,2019,STL
Art Stratton,1935-10-08,8,1960,1968,"NYR,DET,CBH,PHI,PIT"
Raffi Torres,1981-10-08,12,2002,2014,"NYI,EDM,CBJ,BUF,VAN,PHX,SJS"
Larry Wright,1951-10-08,6,1972,1978,"PHI,CGS,DET"
Bill Allum,1916-10-09,0,1941,1941,NYR
Nicolas Beaudin,1999-10-09,0,2020,2020,CHI
Don Caley,1945-10-09,0,1968,1968,STL
Bill Cook*,1896-10-09,10,1927,1937,NYR
Trevor Daley,1983-10-09,16,2004,2020,"DAL,CHI,PIT,DET"
Phillip Di Giuseppe,1993-10-09,4,2016,2020,"CAR,NSH,NYR"
Stephen Gionta,1983-10-09,8,2011,2019,"NJD,NYI"
Larry Hale,1941-10-09,3,1969,1972,PHI
Cameron Hughes,1996-10-09,0,2020,2020,BOS
Jack Keating,1916-10-09,1,1939,1940,DET
Jason Krog,1975-10-09,9,2000,2009,"NYI,MDA,ATL,NYR,VAN"
Arnie Kullman,1927-10-09,2,1948,1950,BOS
Alain Langlais,1950-10-09,1,1974,1975,MNS
Jason Morgan,1976-10-09,10,1997,2007,"LAK,CGY,NSH,CHI,MIN"
Rem Murray,1972-10-09,9,1997,2006,"EDM,NYR,NSH"
Evgeny Namestnikov,1971-10-09,6,1994,2000,"VAN,NYI,NSH"
Garry Peters,1942-10-09,7,1965,1972,"MTL,NYR,PHI,BOS"
Alexandre Picard,1985-10-09,4,2006,2010,CBJ
Al Rollins,1926-10-09,10,1950,1960,"TOR,CBH,NYR"
Wayne Thomas,1947-10-09,8,1973,1981,"MTL,TOR,NYR"
Art Townsend,1905-10-09,0,1927,1927,CBH
Tony Tuzzolino,1975-10-09,4,1998,2002,"MDA,NYR,BOS"
Greg Vaydik,1955-10-09,0,1977,1977,CBH
Henrik Zetterberg,1980-10-09,15,2003,2018,DET
Gerry Carson,1905-10-10,8,1929,1937,"MTL,NYR,MTM"
Mal Davis,1956-10-10,7,1979,1986,"DET,BUF"
Shane Doan,1976-10-10,21,1996,2017,"WIN,PHX,ARI"
Mike Donnelly,1963-10-10,10,1987,1997,"NYR,BUF,LAK,DAL,NYI"
Ron Flockhart,1960-10-10,8,1981,1989,"PHI,PIT,MTL,STL,BOS"
Art Gauthier,1904-10-10,0,1927,1927,MTL
Leth Graham,1894-10-10,5,1921,1926,"OTS,HAM"
Brian Holzinger,1972-10-10,9,1995,2004,"BUF,TBL,PIT,CBJ"
Mike Hordy,1956-10-10,1,1979,1980,NYI
Edgar Laprade*,1919-10-10,9,1946,1955,NYR
Pete Mahovlich,1946-10-10,15,1966,1981,"DET,MTL,PIT"
Ilya Mikheyev,1994-10-10,0,2020,2020,TOR
Mitch Molloy,1966-10-10,0,1990,1990,BUF
Johan Motin,1989-10-10,0,2010,2010,EDM
Sami Niku,1996-10-10,2,2018,2020,WPG
Bob Nystrom,1952-10-10,13,1973,1986,NYI
Rostislav Olesz,1985-10-10,8,2006,2014,"FLA,CHI,NJD"
Tomas Popperle,1984-10-10,0,2007,2007,CBJ
Chris Pronger*,1974-10-10,18,1994,2012,"HAR,STL,EDM,ANA,PHI"
Roberto Romano,1962-10-10,11,1983,1994,"PIT,BOS"
Jeff Shantz,1973-10-10,9,1994,2003,"CHI,CGY,COL"
Dallas Smith,1941-10-10,18,1960,1978,"BOS,NYR"
Alexei Zhitnik,1972-10-10,15,1993,2008,"LAK,BUF,NYI,ATL,PHI"
Tomas Zizka,1979-10-10,1,2003,2004,LAK
Jason Arnott,1974-10-11,18,1994,2012,"EDM,NJD,DAL,NSH,WSH,STL"
Len Broderick,1938-10-11,0,1958,1958,MTL
Yuri Butsayev,1978-10-11,3,2000,2003,"DET,ATL"
Shawn Chambers,1966-10-11,12,1988,2000,"MNS,WSH,TBL,NJD,DAL"
Miroslav Dvorak,1951-10-11,2,1983,1985,PHI
Justin Falk,1988-10-11,9,2010,2019,"MIN,NYR,CBJ,BUF,OTT"
Art Gagne,1897-10-11,5,1927,1932,"MTL,BOS,OTS,DTF"
Denis Grebeshkov,1983-10-11,10,2004,2014,"LAK,NYI,EDM,NSH"
Scott Harlow,1963-10-11,0,1988,1988,STL
Smokey Harris,1890-10-11,0,1925,1925,BOS
Radoslav Hecl,1974-10-11,0,2003,2003,BUF
Claude Lapointe,1968-10-11,13,1991,2004,"QUE,CGY,COL,NYI,PHI"
Irv McGibbon,1914-10-11,0,1943,1943,MTL
Jim Morrison,1931-10-11,19,1952,1971,"BOS,TOR,DET,NYR,PIT"
Mike Neville,1904-10-11,6,1925,1931,"TRS,NYA"
Peter Olvecky,1985-10-11,1,2009,2010,"MIN,NSH"
Mark Popovic,1982-10-11,6,2004,2010,"MDA,ATL"
Dale Purinton,1976-10-11,4,2000,2004,NYR
Dennis Vaske,1967-10-11,8,1991,1999,"NYI,BOS"
Grant Warwick,1921-10-11,8,1942,1950,"NYR,BOS,MTL"
Ed Barry,1919-10-12,0,1947,1947,BOS
Eddy Beers,1959-10-12,4,1982,1986,"CGY,STL"
Dave Brown,1962-10-12,13,1983,1996,"PHI,EDM,SJS"
Danny Cox,1903-10-12,7,1927,1934,"TOR,OTS,DTF,NYR"
J.J. Daigneault,1965-10-12,16,1985,2001,"VAN,PHI,MTL,PIT,STL,MDA,NYI,NSH,PHX,MIN"
Mike Green,1985-10-12,14,2006,2020,"WSH,DET,EDM"
Marcel Hossa,1981-10-12,6,2002,2008,"MTL,NYR,PHX"
Larry Jeffrey,1940-10-12,7,1962,1969,"DET,TOR,NYR"
Todd Krygier,1965-10-12,8,1990,1998,"HAR,WSH,MDA"
Lars Lindgren,1952-10-12,5,1979,1984,"VAN,MNS"
Jake McCabe,1993-10-12,6,2014,2020,BUF
Adam McQuaid,1986-10-12,9,2010,2019,"BOS,CBJ,NYR"
Sean Monahan,1994-10-12,6,2014,2020,CGY
Jacob Nilsson,1993-10-12,0,2019,2019,CHI
Randy Robitaille,1975-10-12,11,1997,2008,"BOS,NSH,LAK,PIT,NYI,ATL,MIN,PHI,OTT"
Dwayne Roloson,1969-10-12,15,1997,2012,"CGY,BUF,MIN,EDM,NYI,TBL"
Carl Soderberg,1985-10-12,7,2013,2020,"BOS,COL,ARI"
Randy Wood,1963-10-12,10,1987,1997,"NYI,BUF,TOR,DAL"
Lias Andersson,1998-10-13,2,2018,2020,NYR
Marc-Andre Bergeron,1980-10-13,10,2003,2013,"EDM,NYI,ANA,MIN,MTL,TBL,CAR"
Paul Cavallini,1965-10-13,9,1987,1996,"WSH,STL,DAL"
Jack Dyte,1918-10-13,0,1944,1944,CBH
Bob Hall,1899-10-13,0,1926,1926,NYA
Norm Larson,1920-10-13,6,1941,1947,"NYA,BRO,NYR"
Bill Lochead,1954-10-13,5,1975,1980,"DET,CLR,NYR"
Darren Lowe,1960-10-13,0,1984,1984,PIT
Jon Matsumoto,1986-10-13,1,2011,2012,"CAR,FLA"
Andrej Meszaros,1985-10-13,9,2006,2015,"OTT,TBL,PHI,BOS,BUF"
Sean O'Donnell,1971-10-13,17,1995,2012,"LAK,MIN,NJD,BOS,MDA,PHX,ANA,PHI,CHI"
Igor Ozhiganov,1992-10-13,0,2019,2019,TOR
Rod Schutt,1956-10-13,8,1978,1986,"MTL,PIT,TOR"
Darrel Scoville,1975-10-13,4,2000,2004,"CGY,CBJ"
Hunter Shinkaruk,1994-10-13,1,2016,2017,"CGY,VAN"
Jakob Silfverberg,1990-10-13,7,2013,2020,"OTT,ANA"
Derek Smith,1984-10-13,4,2010,2014,"OTT,CGY"
Perry Anderson,1961-10-14,10,1982,1992,"STL,NJD,SJS"
Jean-Claude Bergeron,1968-10-14,6,1991,1997,"MTL,TBL,LAK"
Dale Dunbar,1961-10-14,3,1986,1989,"VAN,BOS"
Dmitri Filimonov,1971-10-14,0,1994,1994,OTT
Hec Fowler,1892-10-14,0,1925,1925,BOS
Harvey Fraser,1918-10-14,0,1945,1945,CBH
Quinn Hughes,1999-10-14,1,2019,2020,VAN
Alexei Kasatonov,1959-10-14,6,1990,1996,"NJD,MDA,STL,BOS"
Skip Krake,1943-10-14,7,1964,1971,"BOS,LAK,BUF"
Sylvain Lefebvre,1967-10-14,13,1990,2003,"MTL,TOR,QUE,COL,NYR"
Spencer Machacek,1988-10-14,3,2009,2012,"ATL,WPG"
Scott Mayfield,1992-10-14,6,2014,2020,NYI
Mickey Murray,1898-10-14,0,1930,1930,MTL
Dave Schultz,1949-10-14,8,1972,1980,"PHI,LAK,PIT,BUF"
Matt Smaby,1984-10-14,3,2008,2011,TBL
Nikita Soshnikov,1993-10-14,3,2016,2019,"TOR,STL"
Billy Taylor,1942-10-14,0,1965,1965,NYR
Billy Tibbetts,1974-10-14,2,2001,2003,"PIT,PHI,NYR"
Daniel Tjarnqvist,1976-10-14,7,2002,2009,"ATL,MIN,EDM,COL"
Peter Vandermeer,1975-10-14,0,2008,2008,PHX
Murray Wing,1950-10-14,0,1974,1974,DET
Steve Buzinski,1917-10-15,0,1943,1943,NYR
Hank Ciesla,1934-10-15,3,1956,1959,"CBH,NYR"
Julien Gauthier,1997-10-15,0,2020,2020,"CAR,NYR"
Mark Hartigan,1977-10-15,6,2002,2008,"ATL,CBJ,ANA,DET"
Dave Hindmarch,1958-10-15,3,1981,1984,CGY
Jack Howard,1911-10-15,0,1937,1937,TOR
Jerome Mrazek,1951-10-15,0,1976,1976,PHI
Brock Nelson,1991-10-15,6,2014,2020,NYI
Willie O'Ree*,1935-10-15,3,1958,1961,BOS
Jean Pusie,1910-10-15,5,1931,1936,"MTL,NYR,BOS"
Rocky Saganiuk,1957-10-15,5,1979,1984,"TOR,PIT"
Grant Stevenson,1981-10-15,0,2006,2006,SJS
Lefty Wilson,1919-10-15,4,1954,1958,"DET,TOR,BOS"
Stew Adams,1904-10-16,3,1930,1933,"CBH,TOR"
Frank Ashworth,1927-10-16,0,1947,1947,CBH
Steve Atkinson,1948-10-16,6,1969,1975,"BOS,BUF,WSH"
Jay Beagle,1985-10-16,11,2009,2020,"WSH,VAN"
Sean Bentivoglio,1985-10-16,0,2009,2009,NYI
Bob Collyard,1949-10-16,0,1974,1974,STL
Thomas Eriksson,1959-10-16,5,1981,1986,PHI
Norm Ferguson,1945-10-16,3,1969,1972,"OAK,CGS"
Gerry Fleming,1966-10-16,1,1994,1995,MTL
Paul Kariya*,1974-10-16,15,1995,2010,"MDA,COL,NSH,STL"
Darius Kasparaitis,1972-10-16,14,1993,2007,"NYI,PIT,COL,NYR"
Reg Kerr,1957-10-16,6,1978,1984,"CBH,CLE,EDM"
Tom Martin,1947-10-16,0,1968,1968,TOR
Joe Murphy,1967-10-16,14,1987,2001,"DET,EDM,CHI,STL,SJS,BOS,WSH"
Wilf Paiement,1955-10-16,13,1975,1988,"KCS,CLR,TOR,QUE,NYR,BUF,PIT"
Sam Rothschild,1899-10-16,3,1925,1928,"MTM,NYA,PTP"
German Titov,1965-10-16,8,1994,2002,"CGY,PIT,EDM,MDA"
Norm Armstrong,1938-10-17,0,1963,1963,TOR
Rick Blight,1955-10-17,7,1976,1983,"VAN,LAK"
Francis Bouillon,1975-10-17,14,2000,2014,"MTL,NSH"
Ross Brooks,1937-10-17,2,1973,1975,BOS
Mat Clark,1990-10-17,3,2012,2015,ANA
Jake Debrusk,1996-10-17,2,2018,2020,BOS
Jeremy Duchesne,1986-10-17,0,2010,2010,PHI
Bo Elik,1929-10-17,0,1963,1963,DET
Sami Lepisto,1984-10-17,4,2008,2012,"WSH,PHX,CBJ,CHI"
Ken Morrow,1956-10-17,9,1980,1989,NYI
Brad Ralph,1980-10-17,0,2001,2001,PHX
Bobby Robins,1981-10-17,0,2015,2015,BOS
Mike Tomlak,1964-10-17,4,1990,1994,HAR
Bert Wilson,1949-10-17,7,1974,1981,"NYR,LAK,STL,CGY"
Mark Alt,1991-10-18,4,2015,2019,"PHI,COL"
Mike Antonovich,1951-10-18,8,1976,1984,"MNS,HAR,NJD"
Frank Beisler,1913-10-18,3,1937,1940,NYA
Connie Forey,1950-10-18,0,1974,1974,STL
Leroy Goldsworthy,1906-10-18,9,1930,1939,"NYR,DTF,DET,CBH,MTL,BOS,NYA"
Hilliard Graves,1950-10-18,9,1971,1980,"CGS,ATF,VAN,WIN"
Ben Hanowski,1990-10-18,1,2013,2014,CGY
Alex Henry,1979-10-18,6,2003,2009,"EDM,WSH,MIN,MTL"
John Johannson,1961-10-18,0,1984,1984,NJD
Normand Lacombe,1964-10-18,6,1985,1991,"BUF,EDM,PHI"
Bryan Lefley,1948-10-18,5,1973,1978,"NYI,KCS,CLR"
Doug Lidster,1960-10-18,15,1984,1999,"VAN,NYR,STL,DAL"
David Liffiton,1984-10-18,5,2006,2011,"NYR,COL"
Mush March,1908-10-18,16,1929,1945,CBH
Roly Rossignol,1921-10-18,2,1944,1946,"DET,MTL"
Kjell Samuelsson,1958-10-18,13,1986,1999,"NYR,PHI,PIT,TBL"
Jean-Guy Trudel,1975-10-18,3,2000,2003,"PHX,MIN"
Casey Wellman,1987-10-18,4,2010,2014,"MIN,WSH"
Pete Bellefeuille,1901-10-19,4,1926,1930,"TRS,DTC,TOR"
Zdeno Ciger,1969-10-19,11,1991,2002,"NJD,EDM,NYR,TBL"
Bob Connors,1904-10-19,3,1927,1930,"NYA,DTC"
Joaquin Gage,1973-10-19,6,1995,2001,EDM
Leo Gaudreault,1905-10-19,5,1928,1933,MTL
Boyd Gordon,1983-10-19,13,2004,2017,"WSH,PHX,EDM,ARI,PHI"
Tom McGrattan,1927-10-19,0,1948,1948,DET
Kirk Nielsen,1973-10-19,0,1998,1998,BOS
Calvin Petersen,1994-10-19,1,2019,2020,LAK
Rob Shearer,1976-10-19,0,2001,2001,COL
Frank Sheppard,1907-10-19,0,1928,1928,DTC
Dan Smith,1976-10-19,7,1999,2006,"COL,EDM"
Frank Spring,1949-10-19,7,1970,1977,"BOS,STL,CGS,CLE"
Dale Tallon,1950-10-19,9,1971,1980,"VAN,CBH,PIT"
Don Ward,1935-10-19,2,1958,1960,"CBH,BOS"
Roy Worters*,1900-10-19,11,1926,1937,"PTP,NYA,MTL"
Evan Bouchard,1999-10-20,0,2019,2019,EDM
Guy Chouinard,1956-10-20,9,1975,1984,"ATF,CGY,STL"
Jim Drummond,1918-10-20,0,1945,1945,NYR
Mike Farrell,1978-10-20,2,2002,2004,"WSH,NSH"
Gerry Goyer,1936-10-20,0,1968,1968,CBH
Joey Hishon,1991-10-20,0,2015,2015,COL
Benjamin LaPrairie,1911-10-20,0,1937,1937,CBH
J.P. LeBlanc,1946-10-20,10,1969,1979,"CBH,DET"
Gustav Lindstrom,1998-10-20,0,2020,2020,DET
Murray McLachlan,1948-10-20,0,1971,1971,TOR
Garry Monahan,1946-10-20,11,1968,1979,"MTL,DET,LAK,TOR,VAN"
Todd Richards,1966-10-20,1,1991,1992,HAR
Eric Selleck,1987-10-20,3,2013,2016,"FLA,ARI"
Mikhail Shtalenkov,1965-10-20,6,1994,2000,"MDA,EDM,PHX,FLA"
Matt Taormina,1986-10-20,5,2011,2016,"NJD,TBL"
Colin Wilson,1989-10-20,10,2010,2020,"NSH,COL"
Ryan Bach,1973-10-21,0,1999,1999,LAK
Bill Berg,1967-10-21,10,1989,1999,"NYI,TOR,NYR,OTT"
Carl Brewer,1938-10-21,22,1958,1980,"TOR,DET,STL"
Michel Briere,1949-10-21,0,1970,1970,PIT
Alexander Burmistrov,1991-10-21,7,2011,2018,"ATL,WPG,ARI,VAN"
Al Cameron,1955-10-21,5,1976,1981,"DET,WIN"
Mike Danton,1980-10-21,3,2001,2004,"NJD,STL"
Brian Kilrea*,1934-10-21,10,1958,1968,"DET,LAK"
Frenchy Lacroix,1897-10-21,0,1926,1926,MTL
Larry Mickey,1943-10-21,10,1965,1975,"CBH,NYR,TOR,MTL,LAK,BUF,PHI"
Vincent Tremblay,1959-10-21,4,1980,1984,"TOR,PIT"
Bill Brydge,1901-10-22,9,1927,1936,"TOR,DTC,NYA"
Hugh Currie,1925-10-22,0,1951,1951,MTL
Butch Goring,1949-10-22,15,1970,1985,"LAK,NYI,BOS"
Darren Haydar,1979-10-22,7,2003,2010,"NSH,ATL,COL"
Gerry James,1934-10-22,5,1955,1960,TOR
Terry Kleisinger,1960-10-22,0,1986,1986,NYR
Scott Lachance,1972-10-22,12,1992,2004,"NYI,MTL,VAN,CBJ"
Barry Legge,1954-10-22,2,1980,1982,"QUE,WIN"
Sammy McManus,1911-10-22,2,1935,1937,"MTM,BOS"
Matt Pettinger,1980-10-22,9,2001,2010,"WSH,VAN,TBL"
Antti Pihlstrom,1984-10-22,1,2008,2009,NSH
Stephane Quintal,1968-10-22,15,1989,2004,"BOS,STL,WIN,MTL,NYR,CHI"
Fred Robertson,1911-10-22,2,1932,1934,"TOR,DET"
Miroslav Satan,1974-10-22,14,1996,2010,"EDM,BUF,NYI,PIT,BOS"
David Savard,1990-10-22,8,2012,2020,CBJ
Ron Sedlbauer,1954-10-22,6,1975,1981,"VAN,CBH,TOR"
Dave Thomlinson,1966-10-22,5,1990,1995,"STL,BOS,LAK"
Ron Tugnutt,1967-10-22,16,1988,2004,"QUE,EDM,MDA,MTL,OTT,PIT,CBJ,DAL"
Terry Yake,1968-10-22,12,1989,2001,"HAR,MDA,TOR,STL,WSH"
Jeff Batters,1970-10-23,1,1994,1995,STL
Matt D'Agostini,1986-10-23,6,2008,2014,"MTL,STL,NJD,BUF,PIT"
Gordie Drillon*,1913-10-23,6,1937,1943,"TOR,MTL"
Jim Henry,1920-10-23,13,1942,1955,"NYR,CBH,BOS"
Fred Shero*,1925-10-23,2,1948,1950,NYR
Louis Sleigher,1958-10-23,6,1980,1986,"QUE,BOS"
Nick Sorensen,1994-10-23,0,2017,2017,ANA
Larry Wilson,1930-10-23,6,1950,1956,"DET,CBH"
Bennett Wolf,1959-10-23,2,1981,1983,PIT
Chris Worthy,1947-10-23,2,1969,1971,"OAK,CGS"
Anthony DeAngelo,1995-10-24,3,2017,2020,"ARI,NYR"
Rob Globke,1982-10-24,2,2006,2008,FLA
Jonas Gustavsson,1984-10-24,7,2010,2017,"TOR,DET,BOS,EDM"
Ron Hutchinson,1936-10-24,0,1961,1961,NYR
Pavel Kolarik,1972-10-24,1,2001,2002,BOS
Ray LeBlanc,1964-10-24,0,1992,1992,CHI
Jamal Mayers,1974-10-24,16,1997,2013,"STL,TOR,CGY,SJS,CHI"
Joe Micheletti,1954-10-24,2,1980,1982,"STL,CLR"
Jim Peplinski,1960-10-24,14,1981,1995,CGY
Jim Pettie,1953-10-24,2,1977,1979,BOS
Kyle Rau,1992-10-24,3,2016,2019,"FLA,MIN"
Mike Rogers,1954-10-24,6,1980,1986,"HAR,NYR,EDM"
Gino Rozzini,1918-10-24,0,1945,1945,BOS
Mark Smith,1977-10-24,7,2001,2008,"SJS,CGY"
Harold Snepsts,1954-10-24,16,1975,1991,"VAN,MNS,DET,STL"
Clarke Wilm,1976-10-24,7,1999,2006,"CGY,NSH,TOR"
Josef Beranek,1969-10-25,9,1992,2001,"EDM,PHI,VAN,PIT"
Zac Boyer,1971-10-25,1,1995,1996,DAL
Kelly Chase,1967-10-25,10,1990,2000,"STL,HAR,TOR"
Wendel Clark,1966-10-25,14,1986,2000,"TOR,QUE,NYI,DET,TBL,CHI"
Rey Comeau,1948-10-25,8,1972,1980,"MTL,ATF,CLR"
Red Conn,1904-10-25,1,1934,1935,NYA
Chase De Leo,1995-10-25,4,2016,2020,"WPG,ANA"
Rejean Houle,1949-10-25,13,1970,1983,MTL
Earl Ingarfield,1934-10-25,12,1959,1971,"NYR,PIT,OAK,CGS"
John MacMillan,1935-10-25,4,1961,1965,"TOR,DET"
Terry Martin,1955-10-25,9,1976,1985,"BUF,QUE,TOR,EDM,MNS"
Don Murdoch,1956-10-25,5,1977,1982,"NYR,EDM,DET"
Chris Murray,1974-10-25,5,1995,2000,"MTL,HAR,CAR,OTT,CHI,DAL"
Keith Redmond,1972-10-25,0,1994,1994,LAK
Gerry Shannon,1910-10-25,4,1934,1938,"OTS,BOS,STE,MTM"
Drew Bagnall,1983-10-26,0,2011,2011,MIN
Adam Clendening,1992-10-26,4,2015,2019,"CHI,VAN,EDM,PIT,NYR,ARI,CBJ"
Joseph Cramarossa,1992-10-26,0,2017,2017,"ANA,VAN"
Jack Crawford,1916-10-26,12,1938,1950,BOS
Steve Kelly,1976-10-26,11,1997,2008,"EDM,TBL,NJD,LAK,MIN"
Miikka Kiprusoff,1976-10-26,12,2001,2013,"SJS,CGY"
Walt Ledingham,1950-10-26,4,1973,1977,"CBH,NYI"
Rollie McLenahan,1921-10-26,0,1946,1946,DET
Joe Noris,1951-10-26,2,1972,1974,"PIT,STL,BUF"
Harry Oliver*,1898-10-26,10,1927,1937,"BOS,NYA"
Robert Petrovicky,1973-10-26,8,1993,2001,"HAR,DAL,STL,TBL,NYI"
Patrick Rissmiller,1978-10-26,7,2004,2011,"SJS,NYR,ATL,FLA"
Shayne Stevenson,1970-10-26,2,1991,1993,"BOS,TBL"
Jim Walsh,1956-10-26,0,1982,1982,BUF
Rasmus Andersson,1996-10-27,3,2017,2020,CGY
Casey Bailey,1991-10-27,2,2015,2017,"TOR,OTT"
Paul Broten,1965-10-27,6,1990,1996,"NYR,DAL,STL"
Chris Butler,1986-10-27,10,2009,2019,"BUF,CGY,STL"
Larry DePalma,1965-10-27,8,1986,1994,"MNS,SJS,PIT"
Patrick DesRochers,1979-10-27,1,2002,2003,"PHX,CAR"
Leon Draisaitl,1995-10-27,5,2015,2020,EDM
Peter Driscoll,1954-10-27,1,1980,1981,EDM
Corey Foster,1969-10-27,8,1989,1997,"NJD,PHI,PIT,NYI"
Brad Lauer,1966-10-27,9,1987,1996,"NYI,CHI,OTT,PIT"
Hugh Lehman*,1885-10-27,1,1927,1928,CBH
Brian MacLellan,1958-10-27,9,1983,1992,"LAK,NYR,MNS,CGY,DET"
Frank McCool,1918-10-27,1,1945,1946,TOR
Gerry Minor,1958-10-27,4,1980,1984,VAN
Rich Nantais,1954-10-27,2,1975,1977,MNS
Toby Petersen,1978-10-27,12,2001,2013,"PIT,EDM,DAL"
Gordie Poirier,1914-10-27,0,1940,1940,MTL
Mike Ricci,1971-10-27,16,1991,2007,"PHI,QUE,COL,SJS,PHX"
Rasmus Ristolainen,1994-10-27,6,2014,2020,BUF
Brandon Saad,1992-10-27,8,2012,2020,"CHI,CBJ"
Sergei Samsonov,1978-10-27,13,1998,2011,"BOS,EDM,MTL,CAR,CHI,FLA"
Paul Baxter,1955-10-28,7,1980,1987,"QUE,PIT,CGY"
Karel Betik,1978-10-28,0,1999,1999,TBL
Mark Cullen,1978-10-28,6,2006,2012,"CHI,PHI,FLA"
Kevin Dineen,1963-10-28,18,1985,2003,"HAR,PHI,CAR,OTT,CBJ"
Jude Drouin,1948-10-28,12,1969,1981,"MTL,MNS,NYI,WIN"
Jack Eichel,1996-10-28,4,2016,2020,BUF
Perry Ganchar,1963-10-28,5,1984,1989,"STL,MTL,PIT"
Stanislav Gron,1978-10-28,0,2001,2001,NJD
Benoit Hogue,1966-10-28,14,1988,2002,"BUF,NYI,TOR,DAL,TBL,PHX,BOS,WSH"
Ron Hoover,1966-10-28,2,1990,1992,"BOS,STL"
Chris Jensen,1963-10-28,6,1986,1992,"NYR,PHI"
Matt Kassian,1986-10-28,3,2011,2014,"MIN,OTT"
Les Kozak,1940-10-28,0,1962,1962,TOR
Kevin Morrison,1949-10-28,0,1980,1980,CLR
Gary Nylund,1963-10-28,10,1983,1993,"TOR,CHI,NYI"
Doug Roberts,1942-10-28,9,1966,1975,"DET,OAK,CGS,BOS"
Martin Skoula,1979-10-28,10,2000,2010,"COL,MDA,DAL,MIN,NJD,PIT"
Mike Boland,1954-10-29,4,1975,1979,"KCS,BUF"
Chris Corrinet,1978-10-29,0,2002,2002,WSH
Josh Currie,1992-10-29,0,2019,2019,EDM
Vince Dunn,1996-10-29,2,2018,2020,STL
Ed Dyck,1950-10-29,2,1972,1974,VAN
Mike Gartner*,1959-10-29,18,1980,1998,"WSH,MNS,NYR,TOR,PHX"
Stan Gilbertson,1944-10-29,5,1972,1977,"CGS,STL,WSH,PIT"
Hank Goldup,1918-10-29,6,1940,1946,"TOR,NYR"
Matt Higgins,1977-10-29,3,1998,2001,MTL
Bill Juzda,1920-10-29,11,1941,1952,"NYR,TOR"
Dmitry Kulikov,1990-10-29,10,2010,2020,"FLA,BUF,WPG"
Oscar Lindberg,1991-10-29,4,2015,2019,"NYR,VEG,OTT"
Ted McCaskill,1936-10-29,0,1968,1968,MNS
Frazer McLaren,1987-10-29,4,2010,2014,"SJS,TOR"
Eric Messier,1973-10-29,7,1997,2004,"COL,FLA"
Colin Miller,1992-10-29,4,2016,2020,"BOS,VEG,BUF"
Johnny Mowers,1916-10-29,6,1941,1947,DET
Joel Otto,1961-10-29,13,1985,1998,"CGY,PHI"
Denis Potvin*,1953-10-29,14,1974,1988,NYI
Mikko Rantanen,1996-10-29,4,2016,2020,COL
Dan Ratushny,1970-10-29,0,1993,1993,VAN
Scott Scissons,1971-10-29,3,1991,1994,NYI
Pat Shea,1911-10-29,0,1932,1932,CBH
Bjorn Skaare,1958-10-29,0,1979,1979,DET
Eric Staal,1984-10-29,16,2004,2020,"CAR,NYR,MIN"
Al Suomi,1913-10-29,0,1937,1937,CBH
Nikita Zaitsev,1991-10-29,3,2017,2020,"TOR,OTT"
Brad Aitken,1967-10-30,3,1988,1991,"PIT,EDM"
Jesper Boqvist,1998-10-30,0,2020,2020,NJD
Dean Chynoweth,1968-10-30,9,1989,1998,"NYI,BOS"
Ivan Ciernik,1977-10-30,6,1998,2004,"OTT,WSH"
Sean Collins,1983-10-30,3,2009,2012,WSH
Pat Elynuik,1967-10-30,8,1988,1996,"WIN,WSH,TBL,OTT"
Len Frig,1950-10-30,6,1974,1980,"CBH,CGS,CLE,STL"
Cal Gardner,1924-10-30,11,1946,1957,"NYR,TOR,CBH,BOS"
Dennis Gilbert,1996-10-30,1,2019,2020,CHI
Andy Greene,1982-10-30,13,2007,2020,"NJD,NYI"
Richie Hansen,1955-10-30,5,1977,1982,"NYI,STL"
Ron Lalonde,1952-10-30,6,1973,1979,"PIT,WSH"
Danny Lawson,1947-10-30,4,1968,1972,"DET,MNS,BUF"
Cale Makar,1998-10-30,0,2020,2020,COL
Jim Mayer,1954-10-30,0,1980,1980,NYR
Sam Montembeault,1996-10-30,1,2019,2020,FLA
Artemi Panarin,1991-10-30,4,2016,2020,"CHI,CBJ,NYR"
Drew Stafford,1985-10-30,12,2007,2019,"BUF,WPG,BOS,NJD"
Chris Stewart,1987-10-30,11,2009,2020,"COL,STL,BUF,MIN,ANA,CGY,PHI"
Tyson Strachan,1984-10-30,7,2009,2016,"STL,FLA,WSH,BUF,MIN"
Patrice Tardif,1970-10-30,1,1995,1996,"STL,LAK"
Tage Thompson,1997-10-30,2,2018,2020,"STL,BUF"
Duvie Westcott,1977-10-30,6,2002,2008,CBJ
Matt Anderson,1982-10-31,0,2013,2013,NJD
Mel Angelstad,1972-10-31,0,2004,2004,WSH
Huddy Bell,1925-10-31,0,1947,1947,NYR
Mickey Blake,1912-10-31,3,1933,1936,"MTM,STE,TOR"
Paul Cyr,1963-10-31,9,1983,1992,"BUF,NYR,HAR"
Kim Davis,1957-10-31,3,1978,1981,"PIT,TOR"
Chris Durno,1980-10-31,1,2009,2010,COL
Steve Eminger,1983-10-31,10,2003,2013,"WSH,FLA,PHI,TBL,ANA,NYR"
Nick Foligno,1987-10-31,12,2008,2020,"OTT,CBJ"
Jakob Forsbacka Karlsson,1996-10-31,2,2017,2019,BOS
Dave Gagnon,1967-10-31,0,1991,1991,DET
Phil Goyette,1933-10-31,15,1957,1972,"MTL,NYR,STL,BUF"
Jimmy Herbert,1897-10-31,5,1925,1930,"BOS,TOR,DTC"
Newsy Lalonde*,1887-10-31,9,1918,1927,"MTL,NYA"
Bob Manno,1956-10-31,8,1977,1985,"VAN,TOR,DET"
Bucko McDonald,1914-10-31,10,1935,1945,"DET,TOR,NYR"
Mats Naslund,1959-10-31,12,1983,1995,"MTL,BOS"
Eric Nesterenko,1933-10-31,20,1952,1972,"TOR,CBH"
Claude Noel,1955-10-31,0,1980,1980,WSH
Tomas Plekanec,1982-10-31,15,2004,2019,"MTL,TOR"
Ron Serafini,1953-10-31,0,1974,1974,CGS
Risto Siltanen,1958-10-31,7,1980,1987,"EDM,HAR,QUE"
Evgeny Svechnikov,1996-10-31,3,2017,2020,DET
Al Arbour*,1932-11-01,17,1954,1971,"DET,CBH,TOR,STL"
Mitch Babin,1954-11-01,0,1976,1976,STL
Clarence Boucher,1896-11-01,1,1927,1928,NYA
Daniel Carr,1991-11-01,4,2016,2020,"MTL,VEG,NSH"
Zac Dalpe,1989-11-01,8,2011,2019,"CAR,VAN,BUF,MIN,CBJ"
Tie Domi,1969-11-01,16,1990,2006,"TOR,NYR,WIN"
Riku Hahl,1980-11-01,2,2002,2004,COL
Doug Halward,1955-11-01,13,1976,1989,"BOS,LAK,VAN,DET,EDM"
Dave Hrechkosy,1951-11-01,3,1974,1977,"CGS,STL"
Nick Lappin,1992-11-01,2,2017,2019,NJD
Bill Lesuk,1946-11-01,11,1969,1980,"BOS,PHI,LAK,WSH,WIN"
Mike Minard,1976-11-01,0,2000,2000,EDM
Matt Moulson,1983-11-01,10,2008,2018,"LAK,NYI,BUF,MIN"
Glen Murray,1972-11-01,16,1992,2008,"BOS,PIT,LAK"
Phil Myre,1948-11-01,13,1970,1983,"MTL,ATF,STL,PHI,CLR,BUF"
Gerry Ouellette,1938-11-01,0,1961,1961,BOS
Eric Perrin,1975-11-01,5,2004,2009,"TBL,ATL"
Tyler Pitlick,1991-11-01,6,2014,2020,"EDM,DAL,PHI"
Brent Tremblay,1957-11-01,1,1979,1980,WSH
Doug Baldwin,1922-11-02,2,1946,1948,"TOR,DET,CBH"
Darryl Bootland,1981-11-02,4,2004,2008,"DET,NYI"
Jordan Caron,1990-11-02,5,2011,2016,"BOS,COL,STL"
David Cooper,1973-11-02,4,1997,2001,TOR
Matt Cullen,1976-11-02,21,1998,2019,"MDA,FLA,CAR,NYR,OTT,MIN,NSH,PIT"
Martin Grenier,1980-11-02,5,2002,2007,"PHX,VAN,PHI"
Cal Heeter,1988-11-02,0,2014,2014,PHI
Vic Howe,1929-11-02,4,1951,1955,NYR
Filip Hronek,1997-11-02,1,2019,2020,DET
Rick Ley,1948-11-02,12,1969,1981,"TOR,HAR"
Kurtis McLean,1980-11-02,0,2009,2009,NYI
Rick Meagher,1953-11-02,11,1980,1991,"MTL,HAR,NJD,STL"
John Michaluk,1928-11-02,0,1951,1951,CBH
Bill Mosienko*,1921-11-02,13,1942,1955,CBH
Tim Ramholt,1984-11-02,0,2008,2008,CGY
Ruslan Salei,1974-11-02,14,1997,2011,"MDA,FLA,COL,DET"
Luke Schenn,1989-11-02,11,2009,2020,"TOR,PHI,LAK,ARI,ANA,VAN,TBL"
Jason Smith,1973-11-02,15,1994,2009,"NJD,TOR,EDM,PHI,OTT"
Ted Stackhouse,1894-11-02,0,1922,1922,TRS
Paul Thompson,1906-11-02,12,1927,1939,"NYR,CBH"
Matt Carkner,1980-11-03,8,2006,2014,"SJS,OTT,NYI"
Dan Clark,1957-11-03,0,1979,1979,NYR
Rob Cowie,1967-11-03,1,1995,1996,LAK
Gerry Ehman,1932-11-03,13,1958,1971,"BOS,DET,TOR,OAK,CGS"
Lucien Grenier,1946-11-03,2,1970,1972,"MTL,LAK"
Jay Harrison,1982-11-03,9,2006,2015,"TOR,CAR,WPG"
Lionel Hitchman,1901-11-03,11,1923,1934,"OTS,BOS"
Ike Klingbeil,1908-11-03,0,1937,1937,CBH
Leo Lafrance,1902-11-03,1,1927,1928,"MTL,CBH"
Edward Leier,1927-11-03,1,1950,1951,CBH
Jack McGill,1910-11-03,2,1935,1937,MTL
Jim McKenzie,1969-11-03,14,1990,2004,"HAR,DAL,PIT,WIN,PHX,MDA,WSH,NJD,NSH"
Mike O'Neill,1967-11-03,5,1992,1997,"WIN,MDA"
Doug Palazzari,1952-11-03,4,1975,1979,STL
Pekka Rinne,1982-11-03,14,2006,2020,NSH
Alexander Svitov,1982-11-03,4,2003,2007,"TBL,CBJ"
Chick Webster,1920-11-03,0,1950,1950,NYR
Doug Zmolek,1970-11-03,7,1993,2000,"SJS,DAL,LAK,CHI"
Lloyd Andrews,1894-11-04,3,1922,1925,TRS
John Arundel,1927-11-04,0,1950,1950,TOR
Max Bennett,1912-11-04,0,1936,1936,MTL
Rick Berry,1978-11-04,3,2001,2004,"COL,PIT,WSH"
Dustin Brown,1984-11-04,16,2004,2020,LAK
George Carey,1892-11-04,4,1920,1924,"QBC,HAM,TRS"
Eric Fichaud,1975-11-04,5,1996,2001,"NYI,NSH,CAR,MTL"
Ron Friest,1958-11-04,2,1981,1983,MNS
Mike Heidt,1963-11-04,0,1984,1984,LAK
Ed Hoekstra,1937-11-04,0,1968,1968,PHI
Ed Jeremiah,1905-11-04,0,1932,1932,"BOS,NYA"
Pete Langelle,1917-11-04,3,1939,1942,TOR
Eric Lavigne,1972-11-04,0,1995,1995,LAK
Igor Liba,1960-11-04,0,1989,1989,"LAK,NYR"
Howie Meeker,1923-11-04,7,1947,1954,TOR
Harry Meeking,1894-11-04,9,1918,1927,"TRA,BOS,DTC"
Ernie Parkes,1898-11-04,0,1925,1925,MTM
Corey Schwab,1970-11-04,8,1996,2004,"NJD,TBL,VAN,TOR"
Roman Simicek,1971-11-04,1,2001,2002,"MIN,PIT"
Sergei Berezin,1971-11-05,6,1997,2003,"TOR,MTL,PHX,CHI,WSH"
Sean Brown,1976-11-05,9,1997,2006,"EDM,BOS,NJD,VAN"
Scotty Cameron,1921-11-05,0,1943,1943,NYR
Jared Coreau,1991-11-05,1,2017,2018,DET
Baldy Cotton,1902-11-05,11,1926,1937,"PTP,TOR,NYA"
Lou Crawford,1962-11-05,2,1990,1992,BOS
Brian Curran,1963-11-05,10,1984,1994,"BOS,NYI,TOR,BUF,WSH"
Keaton Ellerby,1988-11-05,5,2010,2015,"FLA,LAK,WPG"
Toby Enstrom,1984-11-05,10,2008,2018,"ATL,WPG"
Al Karlander,1946-11-05,3,1970,1973,DET
Neil Komadoski,1951-11-05,7,1973,1980,"LAK,STL"
Maxime Lajoie,1997-11-05,1,2019,2020,OTT
Matthew Nieto,1992-11-05,6,2014,2020,"SJS,COL"
Lance Pitlick,1967-11-05,7,1995,2002,"OTT,FLA"
Victor Posa,1966-11-05,0,1986,1986,CBH
Otto Schmidt,1926-11-05,0,1944,1944,BOS
Colton Sissons,1993-11-05,6,2014,2020,NSH
Carl Sneep,1987-11-05,0,2012,2012,PIT
Ken Sutton,1969-11-05,11,1991,2002,"BUF,EDM,STL,NJD,SJS,NYI"
Mark Suzor,1956-11-05,1,1977,1978,"PHI,CLR"
Cooney Weiland*,1904-11-05,10,1929,1939,"BOS,OTS,DET"
Alexei Yashin,1973-11-05,13,1994,2007,"OTT,NYI"
Nikolai Zherdev,1984-11-05,7,2004,2011,"CBJ,NYR,PHI"
Keith Aucoin,1978-11-06,8,2006,2014,"CAR,WSH,NYI,STL"
Rollie Boutin,1957-11-06,2,1979,1981,WSH
Nelson Burton,1957-11-06,1,1978,1979,WSH
Walt Buswell,1907-11-06,7,1933,1940,"DET,MTL"
Erik Cole,1978-11-06,13,2002,2015,"CAR,EDM,MTL,DAL,DET"
Darryl Edestrand,1945-11-06,11,1968,1979,"STL,PHI,PIT,BOS,LAK"
Justin Fontaine,1987-11-06,2,2014,2016,MIN
Joe Klukay,1922-11-06,9,1947,1956,"TOR,BOS"
Albert Langlois,1934-11-06,8,1958,1966,"MTL,NYR,DET,BOS"
Claude Legris,1956-11-06,1,1981,1982,DET
Isac Lundestrom,1999-11-06,1,2019,2020,ANA
Paul MacKinnon,1958-11-06,4,1980,1984,WSH
Alfie Michaud,1976-11-06,0,2000,2000,VAN
Andrew Murray,1981-11-06,5,2008,2013,"CBJ,SJS,STL"
Greg Pankewicz,1970-11-06,5,1994,1999,"OTT,CGY"
Marty Pavelich,1927-11-06,9,1948,1957,DET
Sam Reinhart,1995-11-06,5,2015,2020,BUF
Brad Stuart,1979-11-06,16,2000,2016,"SJS,BOS,CGY,DET,LAK,COL"
Lars Zetterstrom,1953-11-06,0,1979,1979,VAN
Glenn Brydson,1910-11-07,7,1931,1938,"MTM,STE,CBH,NYR"
Dwight Carruthers,1944-11-07,2,1966,1968,"DET,PHI"
Mike Commodore,1979-11-07,11,2001,2012,"NJD,CGY,CAR,OTT,CBJ,DET,TBL"
Rusty Crawford*,1885-11-07,1,1918,1919,"OTS,TRA"
Jack Forsey,1914-11-07,0,1943,1943,TOR
Brandon Gignac,1997-11-07,0,2019,2019,NJD
Ernie Hicke,1947-11-07,7,1971,1978,"CGS,ATF,NYI,MNS,LAK"
Jim Johnson,1942-11-07,7,1965,1972,"NYR,PHI,LAK"
Ryan Kraft,1975-11-07,0,2003,2003,SJS
Pascal Leclaire,1982-11-07,7,2004,2011,"CBJ,OTT"
Ted McAneeley,1950-11-07,2,1973,1975,CGS
Michel Picard,1969-11-07,10,1991,2001,"HAR,SJS,OTT,STL,EDM,PHI"
Metro Prystai,1927-11-07,10,1948,1958,"CBH,DET"
Ryan Ready,1978-11-07,0,2006,2006,PHI
Butch Schaeffer,1911-11-07,0,1937,1937,CBH
Patrick Thoresen,1983-11-07,1,2007,2008,"EDM,PHI"
Murray Wilson,1951-11-07,6,1973,1979,"MTL,LAK"
Riley Armstrong,1984-11-08,0,2009,2009,SJS
Jaroslav Bednar,1976-11-08,2,2002,2004,"LAK,FLA"
Johnny Bower*,1924-11-08,16,1954,1970,"NYR,TOR"
Marc Chorney,1959-11-08,3,1981,1984,"PIT,LAK"
Jimmy Franks,1914-11-08,6,1938,1944,"DET,NYR,BOS"
Bob Gracie,1910-11-08,8,1931,1939,"TOR,BOS,NYA,MTM,CBH,MTL"
Kari Haakana,1973-11-08,0,2003,2003,EDM
Shane Hnidy,1975-11-08,10,2001,2011,"OTT,NSH,ATL,ANA,BOS,MIN"
Claude Houde,1947-11-08,1,1975,1976,KCS
Keith Jones,1968-11-08,8,1993,2001,"WSH,COL,PHI"
Frantisek Kaberle,1973-11-08,9,2000,2009,"ATL,LAK,CAR"
Ondrej Kase,1995-11-08,3,2017,2020,"ANA,BOS"
Gary Morrison,1955-11-08,2,1980,1982,PHI
Mike Peluso,1965-11-08,8,1990,1998,"CHI,OTT,NJD,STL,CGY"
Jason Bowen,1973-11-09,5,1993,1998,"PHI,EDM"
Randy Bucyk,1962-11-09,2,1986,1988,"MTL,CGY"
Todd Gill,1965-11-09,18,1985,2003,"TOR,SJS,STL,DET,PHX,COL,CHI"
Bill Guerin,1970-11-09,18,1992,2010,"NJD,EDM,BOS,DAL,SJS,STL,NYI,PIT"
Carl Gunnarsson,1986-11-09,10,2010,2020,"TOR,STL"
Neil Hawryliw,1955-11-09,0,1982,1982,NYI
Mike Iggulden,1982-11-09,1,2008,2009,"SJS,NYI"
Bob Neely,1953-11-09,4,1974,1978,"TOR,CLR"
Dennis Olson,1934-11-09,0,1958,1958,DET
Juuso Riikola,1993-11-09,1,2019,2020,PIT
Zach Sanford,1994-11-09,3,2017,2020,"STL,WSH"
Tom Thurlby,1938-11-09,0,1968,1968,OAK
John Wright,1948-11-09,2,1973,1975,"VAN,STL,KCS"
Clayton Beddoes,1970-11-10,1,1996,1997,BOS
Billy Boucher,1899-11-10,6,1922,1928,"MTL,BOS,NYA"
Greg Carroll,1956-11-10,1,1979,1980,"DET,WSH,HAR"
Brad DeFauw,1977-11-10,0,2003,2003,CAR
Jaroslav Hlinka,1976-11-10,0,2008,2008,COL
Ken Holland*,1955-11-10,3,1981,1984,"HAR,DET"
Larry Hornung,1945-11-10,1,1971,1972,STL
Cale Hulse,1973-11-10,10,1996,2006,"CGY,NJD,NSH,PHX,CBJ"
Kristian Huselius,1978-11-10,10,2002,2012,"FLA,CGY,CBJ"
Jeff Larmer,1962-11-10,4,1982,1986,"CLR,NJD,CBH"
Mike Leclerc,1976-11-10,9,1997,2006,"MDA,CGY,PHX"
Wayne Maki,1944-11-10,5,1968,1973,"CBH,STL,VAN"
Allan Murray,1908-11-10,6,1934,1940,NYA
Theo Peckham,1987-11-10,5,2008,2013,EDM
Don Saleski,1949-11-10,8,1972,1980,"PHI,CLR"
Robert Schnabel,1978-11-10,2,2002,2004,NSH
Sean Selmser,1974-11-10,0,2001,2001,CBJ
Al Smith,1945-11-10,15,1966,1981,"TOR,PIT,DET,BUF,HAR,CLR"
Bob Stewart,1950-11-10,8,1972,1980,"BOS,CGS,CLE,STL,PIT"
Bill Sutherland,1934-11-10,4,1968,1972,"PHI,TOR,STL,DET"
Jacques Toupin,1910-11-10,0,1944,1944,CBH
Ed Ward,1969-11-10,7,1994,2001,"QUE,CGY,ATL,MDA,NJD"
Duane Wylie,1950-11-10,2,1975,1977,CBH
Michel Bergeron,1954-11-11,4,1975,1979,"DET,NYI,WSH"
Art Chisholm,1934-11-11,0,1961,1961,BOS
Brian Cullen,1933-11-11,6,1955,1961,"TOR,NYR"
Brian Felsner,1972-11-11,0,1998,1998,CHI
Jack Gelineau,1924-11-11,5,1949,1954,"BOS,CBH"
Randy Heath,1964-11-11,1,1985,1986,NYR
Martin Hostak,1967-11-11,1,1991,1992,PHI
Bob Kabel,1934-11-11,1,1960,1961,NYR
Chris Kelly,1980-11-11,14,2004,2018,"OTT,BOS,ANA"
Steve Konowalchuk,1972-11-11,14,1992,2006,"WSH,COL"
Harry Lumley*,1926-11-11,16,1944,1960,"DET,NYR,CBH,TOR,BOS"
Jean-Gabriel Pageau,1992-11-11,7,2013,2020,"OTT,NYI"
Gord Pettinger,1911-11-11,7,1933,1940,"NYR,DET,BOS"
Jackie Schmidt,1924-11-11,0,1943,1943,BOS
Sandy Snow,1946-11-11,0,1969,1969,DET
Jim Boo,1954-11-12,0,1978,1978,MNS
Tony Currie,1957-11-12,7,1978,1985,"STL,VAN,HAR"
Denis DeJordy,1938-11-12,11,1963,1974,"CBH,LAK,MTL,DET"
Tomas Hertl,1993-11-12,6,2014,2020,SJS
Paul Hoganson,1949-11-12,0,1971,1971,PIT
Greg Hubick,1951-11-12,4,1976,1980,"TOR,VAN"
Mark Hunter,1962-11-12,11,1982,1993,"MTL,STL,CGY,HAR,WSH"
Bob Johnson,1948-11-12,2,1973,1975,"STL,PIT"
Mikhail Kravets,1963-11-12,1,1992,1993,SJS
Adam Larsson,1992-11-12,8,2012,2020,"NJD,EDM"
Rene Leclerc,1947-11-12,2,1969,1971,DET
Bryan Little,1987-11-12,12,2008,2020,"ATL,WPG"
Adam Munro,1982-11-12,2,2004,2006,CHI
Vic Myles,1915-11-12,0,1943,1943,NYR
Bert Peer,1910-11-12,0,1940,1940,DET
Elias Pettersson,1998-11-12,1,2019,2020,VAN
Matt Ryan,1983-11-12,0,2006,2006,LAK
Bryce Van Brabant,1991-11-12,0,2014,2014,CGY
Chris Wells,1975-11-12,4,1996,2000,"PIT,FLA"
Marty Zoborosky,1916-11-12,0,1945,1945,CBH
Patrik Augusta,1969-11-13,5,1994,1999,"TOR,WSH"
Irwin Boyd,1908-11-13,12,1932,1944,"BOS,DET"
Mark Cornforth,1972-11-13,0,1996,1996,BOS
Brenden Dillon,1990-11-13,8,2012,2020,"DAL,SJS,WSH"
Rene Drolet,1944-11-13,3,1972,1975,"PHI,DET"
Mark Fitzpatrick,1968-11-13,11,1989,2000,"LAK,NYI,FLA,TBL,CHI,CAR"
Jason Garrison,1984-11-13,10,2009,2019,"FLA,VAN,TBL,VEG,EDM"
Brad Gassoff,1955-11-13,3,1976,1979,VAN
Steve Guenette,1965-11-13,4,1987,1991,"PIT,CGY"
Ilkka Heikkinen,1984-11-13,0,2010,2010,NYR
Wayne Hillman,1938-11-13,11,1962,1973,"CBH,NYR,MNS,PHI"
Juraj Kolnik,1980-11-13,6,2001,2007,"NYI,FLA"
Len Lunde,1936-11-13,12,1959,1971,"DET,CBH,MNS,VAN"
Gates Orlando,1962-11-13,2,1985,1987,BUF
Grigori Panteleev,1972-11-13,3,1993,1996,"BOS,NYI"
Gilbert Perreault*,1950-11-13,16,1971,1987,BUF
Tuomas Pihlman,1982-11-13,3,2004,2007,NJD
Charles Stewart,1895-11-13,2,1925,1927,BOS
Sean Walker,1994-11-13,1,2019,2020,LAK
Bobby Allen,1978-11-14,5,2003,2008,"EDM,BOS"
Greg Andrusak,1969-11-14,6,1994,2000,"PIT,TOR"
Jim Bedard,1956-11-14,1,1978,1979,WSH
Aaron Broten,1960-11-14,11,1981,1992,"CLR,NJD,MNS,QUE,TOR,WIN"
Brad Church,1976-11-14,0,1998,1998,WSH
Bruce Cline,1931-11-14,0,1957,1957,NYR
Jari Gronstrand,1962-11-14,4,1987,1991,"MNS,NYR,QUE,NYI"
Taylor Hall,1991-11-14,9,2011,2020,"EDM,NJD,ARI"
Tim Jackman,1981-11-14,12,2004,2016,"CBJ,PHX,LAK,NYI,CGY,ANA"
Ed Kryzanowski,1925-11-14,4,1949,1953,"BOS,CBH"
Don Lever,1952-11-14,14,1973,1987,"VAN,ATF,CGY,CLR,NJD,BUF"
Murray Oliver,1937-11-14,17,1958,1975,"DET,BOS,TOR,MNS"
Ed Patterson,1972-11-14,3,1994,1997,PIT
Ray Schultz,1976-11-14,5,1998,2003,NYI
Rod Seiling,1944-11-14,16,1963,1979,"TOR,NYR,WSH,STL,ATF"
Jyrki Seppa,1961-11-14,0,1984,1984,WIN
Bryan Watson,1942-11-14,15,1964,1979,"MTL,DET,OAK,PIT,STL,WSH"
Ron Buchanan,1944-11-15,3,1967,1970,"BOS,STL"
Bobby Copp,1918-11-15,8,1943,1951,TOR
Kyle Greentree,1983-11-15,1,2008,2009,"PHI,CGY"
Jonas Junland,1987-11-15,1,2009,2010,STL
John Paul Kelly,1959-11-15,6,1980,1986,LAK
Richard Lintner,1977-11-15,3,2000,2003,"NSH,NYR,PIT"
Clem Loughlin,1894-11-15,2,1927,1929,"DTC,CBH"
Kevan Miller,1987-11-15,5,2014,2019,BOS
Brett Pesce,1994-11-15,4,2016,2020,CAR
Jim Shires,1945-11-15,2,1971,1973,"DET,STL,PIT"
Chris Terreri,1964-11-15,14,1987,2001,"NJD,SJS,CHI,NYI"
Yannick Tremblay,1975-11-15,10,1997,2007,"TOR,ATL,VAN"
Jamie Arniel,1989-11-16,0,2011,2011,BOS
Ralph Barahona,1965-11-16,1,1991,1992,BOS
Dave Forbes,1948-11-16,5,1974,1979,"BOS,WSH"
Dick Gamble,1928-11-16,16,1951,1967,"MTL,CBH,TOR"
Josh Green,1977-11-16,13,1999,2012,"LAK,NYI,EDM,NYR,WSH,CGY,VAN,ANA"
Peter Hayek,1957-11-16,0,1982,1982,MNS
Brent Imlach,1946-11-16,1,1966,1967,TOR
Pierre Larouche,1955-11-16,13,1975,1988,"PIT,MTL,HAR,NYR"
Kari Lehtonen,1983-11-16,14,2004,2018,"ATL,DAL"
Viktor Loov,1992-11-16,0,2016,2016,TOR
Ray Powell,1925-11-16,0,1951,1951,CBH
Shane Prince,1992-11-16,3,2015,2018,"OTT,NYI"
Tim Schaller,1990-11-16,5,2015,2020,"BUF,BOS,VAN,LAK"
Stephane Veilleux,1981-11-16,12,2003,2015,"MIN,TBL,NJD"
Mark Wotton,1973-11-16,6,1995,2001,"VAN,DAL"
Oscar Asmundson,1908-11-17,5,1933,1938,"NYR,DET,STE,NYA,MTL"
Jamie Fraser,1985-11-17,0,2009,2009,NYI
Pierre Giroux,1955-11-17,0,1983,1983,LAK
Roope Hintz,1996-11-17,1,2019,2020,DAL
Blair MacDonald,1953-11-17,3,1980,1983,"EDM,VAN"
Dennis Maruk,1955-11-17,13,1976,1989,"CGS,CLE,MNS,WSH"
Bobby Simpson,1956-11-17,6,1977,1983,"ATF,STL,PIT"
Gord Smith,1949-11-17,5,1975,1980,"WSH,WIN"
Chris Tamer,1970-11-17,10,1994,2004,"PIT,NYR,ATL"
Billy Warwick,1924-11-17,1,1943,1944,NYR
Cal Clutterbuck,1987-11-18,12,2008,2020,"MIN,NYI"
Jimmy Creighton,1905-11-18,0,1931,1931,DTF
Tom Edur,1954-11-18,1,1977,1978,"CLR,PIT"
Bill Hajt,1951-11-18,13,1974,1987,BUF
Emil Hanson,1907-11-18,0,1933,1933,DET
Bob Jay,1965-11-18,0,1994,1994,LAK
Roger Jenkins,1911-11-18,8,1931,1939,"CBH,TOR,MTL,BOS,MTM,NYA"
Dick Kotanen,1925-11-18,0,1951,1951,NYR
Kamil Kreps,1984-11-18,3,2007,2010,FLA
Lane Lambert,1964-11-18,5,1984,1989,"DET,NYR,QUE"
Jocelyn Lemieux,1967-11-18,11,1987,1998,"STL,MTL,CHI,HAR,CGY,NJD,PHX"
Rudy Migay,1928-11-18,10,1950,1960,TOR
Chris Minard,1981-11-18,2,2008,2010,"PIT,EDM"
Lubomir Sekeras,1968-11-18,3,2001,2004,"MIN,DAL"
Ed Slowinski,1922-11-18,5,1948,1953,NYR
Andreas Thuresson,1987-11-18,1,2010,2011,NSH
James Bedard,1927-11-19,1,1950,1951,CBH
Charlie Bourgeois,1959-11-19,6,1982,1988,"CGY,STL,HAR"
Maurice Croghan,1914-11-19,0,1938,1938,MTM
Peter Dineen,1960-11-19,3,1987,1990,"LAK,DET"
Cale Fleury,1998-11-19,0,2020,2020,MTL
Jeff Glass,1985-11-19,0,2018,2018,CHI
Bobby Guindon,1950-11-19,0,1980,1980,WIN
Floyd Hillman,1933-11-19,0,1957,1957,BOS
Dennis Hull,1944-11-19,13,1965,1978,"CBH,DET"
Miroslav Ihnacak,1962-11-19,3,1986,1989,"TOR,DET"
Robbie Irons,1946-11-19,0,1969,1969,STL
Patrick Kane,1988-11-19,12,2008,2020,CHI
Gord Kuhn,1905-11-19,0,1933,1933,NYA
Grant Ledyard,1961-11-19,17,1985,2002,"NYR,LAK,WSH,BUF,DAL,BOS,VAN,OTT,TBL"
Reggie Lemelin,1954-11-19,14,1979,1993,"ATF,CGY,BOS"
Dean Melanson,1973-11-19,7,1995,2002,"BUF,WSH"
John Moore,1990-11-19,9,2011,2020,"CBJ,NYR,ARI,NJD,BOS"
Gus Rivers,1909-11-19,2,1930,1932,MTL
Ron Smith,1952-11-19,0,1973,1973,NYI
Petr Sykora,1976-11-19,16,1996,2012,"NJD,MDA,NYR,EDM,PIT,MIN"
Tomas Vincour,1990-11-19,4,2011,2015,"DAL,COL"
Dmitry Yushkevich,1971-11-19,10,1993,2003,"PHI,TOR,FLA,LAK"
Billy Burch*,1900-11-20,10,1923,1933,"HAM,NYA,BOS,CBH"
Bud Cook,1907-11-20,3,1932,1935,"BOS,OTS,STE"
Tom Draper,1966-11-20,7,1989,1996,"WIN,BUF,NYI"
Yanick Dupre,1972-11-20,4,1992,1996,PHI
Max Friberg,1992-11-20,1,2015,2016,ANA
John MacLean,1964-11-20,18,1984,2002,"NJD,SJS,NYR,DAL"
Dave McLelland,1952-11-20,0,1973,1973,VAN
Bob Murdoch,1946-11-20,11,1971,1982,"MTL,LAK,ATF,CGY"
Max Pacioretty,1988-11-20,11,2009,2020,"MTL,VEG"
Eddie Pasquale,1990-11-20,0,2019,2019,TBL
Kamil Piros,1978-11-20,2,2002,2004,"ATL,FLA"
Tom Roulston,1957-11-20,5,1981,1986,"EDM,PIT"
John Van Boxmeer,1952-11-20,10,1974,1984,"MTL,CLR,BUF,QUE"
Ben Bishop,1986-11-21,11,2009,2020,"STL,OTT,TBL,LAK,DAL"
Lindsay Carson,1960-11-21,6,1982,1988,"PHI,HAR"
Jose Charbonneau,1966-11-21,7,1988,1995,"MTL,VAN"
Guyle Fielder,1930-11-21,7,1951,1958,"CBH,DET"
Vladislav Gavrikov,1995-11-21,0,2020,2020,CBJ
Jimmy Hayes,1989-11-21,6,2012,2018,"CHI,FLA,BOS,NJD"
Dean Jenkins,1959-11-21,0,1984,1984,LAK
Andreas Johnsson,1994-11-21,2,2018,2020,TOR
Dominic Lavoie,1967-11-21,5,1989,1994,"STL,BOS,OTT,LAK"
Butch McDonald,1916-11-21,5,1940,1945,"DET,CBH"
Alex McKendry,1956-11-21,3,1978,1981,"NYI,CGY"
Anton Rodin,1990-11-21,0,2017,2017,VAN
Antoine Roussel,1989-11-21,7,2013,2020,"DAL,VAN"
Denis Shvidki,1980-11-21,3,2001,2004,FLA
Karl Stollery,1987-11-21,3,2014,2017,"COL,SJS,NJD"
Alex Tanguay,1979-11-21,16,2000,2016,"COL,CGY,MTL,TBL,ARI"
John Zeiler,1982-11-21,4,2007,2011,LAK
Yvan Cournoyer*,1943-11-22,15,1964,1979,MTL
Harry Dick,1922-11-22,0,1947,1947,CBH
Clark Donatelli,1965-11-22,2,1990,1992,"MNS,BOS"
Davis Drewiske,1984-11-22,4,2009,2013,"LAK,MTL"
Darin Kimble,1968-11-22,6,1989,1995,"QUE,STL,BOS,CHI"
Jacques Laperriere*,1941-11-22,11,1963,1974,MTL
Albert Leduc,1902-11-22,9,1926,1935,"MTL,NYR,OTS"
Bert Marshall,1943-11-22,13,1966,1979,"DET,OAK,CGS,NYR,NYI"
Casey Mittelstadt,1998-11-22,2,2018,2020,BUF
Vladislav Namestnikov,1992-11-22,6,2014,2020,"TBL,NYR,COL,OTT"
Kevin Smyth,1973-11-22,2,1994,1996,HAR
Matt Watkins,1986-11-22,0,2012,2012,PHX
Darrel Anholt,1962-11-23,0,1984,1984,CBH
Colby Armstrong,1982-11-23,7,2006,2013,"PIT,ATL,TOR,MTL"
Nicklas Backstrom,1987-11-23,12,2008,2020,WSH
John Craighead,1971-11-23,0,1997,1997,TOR
Brian Glynn,1967-11-23,9,1988,1997,"CGY,MNS,EDM,OTT,VAN,HAR"
Garnet Hathaway,1991-11-23,4,2016,2020,"CGY,WSH"
Matt Johnson,1975-11-23,9,1995,2004,"LAK,ATL,MIN"
Dan Kesa,1971-11-23,6,1994,2000,"VAN,DAL,PIT,TBL"
Paul Knox,1933-11-23,0,1955,1955,TOR
Saku Koivu,1974-11-23,18,1996,2014,"MTL,ANA"
Gabriel Landeskog,1992-11-23,8,2012,2020,COL
Simon Nolet,1941-11-23,9,1968,1977,"PHI,KCS,PIT,CLR"
Randy Pierce,1957-11-23,7,1978,1985,"CLR,NJD,HAR"
Bernie Ruelle,1920-11-23,0,1944,1944,DET
David Booth,1984-11-24,11,2007,2018,"FLA,VAN,TOR,DET"
Fred Brathwaite,1972-11-24,10,1994,2004,"EDM,CGY,STL,CBJ"
Robert Burakovsky,1966-11-24,0,1994,1994,OTT
Gino Cavallini,1962-11-24,8,1985,1993,"CGY,STL,QUE"
Fredrik Claesson,1992-11-24,4,2016,2020,"OTT,NYR,NJD"
Tomas Forslund,1968-11-24,1,1992,1993,CGY
Kurtis Foster,1981-11-24,10,2003,2013,"ATL,MIN,TBL,EDM,ANA,NJD,PHI"
Mitch Fritz,1980-11-24,0,2009,2009,NYI
Murray Hall,1940-11-24,10,1962,1972,"CBH,DET,MNS,VAN"
Art Herchenratter,1917-11-24,0,1941,1941,DET
Mike Hoffman,1989-11-24,8,2012,2020,"OTT,FLA"
Dryden Hunt,1995-11-24,2,2018,2020,FLA
Eddie Johnston,1935-11-24,15,1963,1978,"BOS,TOR,STL,CBH"
Christian Laflamme,1976-11-24,7,1997,2004,"CHI,EDM,MTL,STL"
Hec Lalande,1934-11-24,4,1954,1958,"CBH,DET"
George Lyle,1953-11-24,3,1980,1983,"DET,HAR"
Jack McDonald,1921-11-24,0,1944,1944,NYR
Hank Nowak,1950-11-24,3,1974,1977,"PIT,BOS,DET"
Barry Potomski,1972-11-24,2,1996,1998,"LAK,SJS"
Keith Primeau,1971-11-24,15,1991,2006,"DET,HAR,CAR,PHI"
Branko Radivojevic,1980-11-24,6,2002,2008,"PHX,PHI,MIN"
Earl Robertson,1910-11-24,4,1938,1942,"NYA,BRO"
Carsen Twarynski,1997-11-24,0,2020,2020,PHI
Rudy Zunich,1910-11-24,0,1944,1944,DET
Magnus Arvedson,1971-11-25,6,1998,2004,"OTT,VAN"
Anders Carlsson,1960-11-25,2,1987,1989,NJD
Bill Carson,1900-11-25,3,1927,1930,"TOR,BOS"
Gilbert Delorme,1962-11-25,8,1982,1990,"MTL,STL,QUE,DET,PIT"
Yip Foster,1907-11-25,5,1930,1935,"NYR,BOS,DET"
Michael Garnett,1982-11-25,0,2006,2006,ATL
Philipp Grubauer,1991-11-25,7,2013,2020,"WSH,COL"
Marcus Hogberg,1994-11-25,1,2019,2020,OTT
Bob Kelly,1950-11-25,11,1971,1982,"PHI,WSH"
John-Michael Liles,1980-11-25,13,2004,2017,"COL,TOR,CAR,BOS"
Jim Murray,1943-11-25,0,1968,1968,LAK
Jeff Norton,1965-11-25,14,1988,2002,"NYI,SJS,STL,EDM,TBL,FLA,PIT,BOS"
Petteri Nummelin,1972-11-25,7,2001,2008,"CBJ,MIN"
Mike O'Connell,1955-11-25,12,1978,1990,"CBH,BOS,DET"
Eddie Shore*,1902-11-25,13,1927,1940,"BOS,NYA"
Robb Stauber,1967-11-25,5,1990,1995,"LAK,BUF"
Nick Tarnasky,1984-11-25,4,2006,2010,"TBL,FLA,NSH"
Libor Zabransky,1973-11-25,1,1997,1998,STL
Keith Ballard,1982-11-26,9,2006,2015,"PHX,FLA,VAN,MIN"
Jack Borotsik,1949-11-26,0,1975,1975,STL
Steve Bozek,1960-11-26,10,1982,1992,"LAK,CGY,STL,VAN,SJS"
Rich Brennan,1972-11-26,6,1997,2003,"COL,SJS,NYR,LAK,NSH,BOS"
Milt Brink,1910-11-26,0,1937,1937,CBH
Brandon Carlo,1996-11-26,3,2017,2020,BOS
Mathieu Darche,1976-11-26,11,2001,2012,"CBJ,NSH,SJS,TBL,MTL"
Darren Eliot,1961-11-26,4,1985,1989,"LAK,DET,BUF"
Jerry Engele,1950-11-26,2,1976,1978,MNS
Dave Hannan,1961-11-26,15,1982,1997,"PIT,EDM,TOR,BUF,COL,OTT"
Bob Murray,1954-11-26,14,1976,1990,"CBH,CHI"
Randy Osburn,1952-11-26,2,1973,1975,"TOR,PHI"
Chris Osgood,1972-11-26,17,1994,2011,"DET,NYI,STL"
Adam Wilcox,1992-11-26,0,2018,2018,BUF
Joe Bell,1923-11-27,4,1943,1947,NYR
Beau Bennett,1991-11-27,5,2013,2018,"PIT,NJD,STL"
Anton Forsberg,1992-11-27,5,2015,2020,"CBJ,CHI,CAR"
Shawn Heaphy,1968-11-27,0,1993,1993,CGY
Al Jensen,1958-11-27,6,1981,1987,"DET,WSH,LAK"
Norm Johnson,1932-11-27,1,1958,1959,"BOS,CBH"
Bob Jones,1945-11-27,0,1969,1969,NYR
Henrik Karlsson,1983-11-27,1,2011,2012,CGY
Chad Kilger,1976-11-27,12,1996,2008,"MDA,WIN,PHX,CHI,EDM,MTL,TOR"
Chris Kotsopoulos,1958-11-27,9,1981,1990,"NYR,HAR,TOR,DET"
Pierre Mondou,1955-11-27,7,1978,1985,MTL
Rod Norrish,1951-11-27,1,1974,1975,MNS
Darcy Regier,1956-11-27,6,1978,1984,"CLE,NYI"
Ken Schinkel,1932-11-27,13,1960,1973,"NYR,PIT"
Garry Valk,1967-11-27,12,1991,2003,"VAN,MDA,PIT,TOR,CHI"
Ernie Wakely,1940-11-27,9,1963,1972,"MTL,STL"
Filip Zadina,1999-11-27,1,2019,2020,DET
Jaroslav Balastik,1979-11-28,1,2006,2007,CBJ
Norm Beaudin,1941-11-28,3,1968,1971,"STL,MNS"
Brian Bonin,1973-11-28,2,1999,2001,"PIT,MIN"
Joe Bretto,1912-11-28,0,1945,1945,CBH
Mud Bruneteau,1914-11-28,10,1936,1946,DET
Blake Coleman,1991-11-28,3,2017,2020,"NJD,TBL"
Marc-Andre Fleury,1984-11-28,16,2004,2020,"PIT,VEG"
Jamie Gallimore,1957-11-28,0,1978,1978,MNS
Terry Johnson,1958-11-28,7,1980,1987,"QUE,STL,CGY,TOR"
Mike Kostka,1985-11-28,3,2013,2016,"TOR,CHI,TBL,NYR,OTT"
Chris Langevin,1959-11-28,2,1984,1986,BUF
Gerry Munro,1897-11-28,1,1925,1926,"MTM,TRS"
Jim Neilson,1940-11-28,15,1963,1978,"NYR,CGS,CLE"
Ron Shudra,1967-11-28,0,1988,1988,EDM
Art Strobel,1922-11-28,0,1944,1944,NYR
Doug Trapp,1965-11-28,0,1987,1987,BUF
Zach Whitecloud,1996-11-28,2,2018,2020,VEG
Bill Baker,1956-11-29,2,1981,1983,"CLR,MTL,STL,NYR"
Terry Ball,1944-11-29,4,1968,1972,"PHI,BUF"
Bob Berry,1943-11-29,8,1969,1977,"MTL,LAK"
Neal Broten,1959-11-29,16,1981,1997,"MNS,DAL,NJD,LAK"
Brett Carson,1985-11-29,4,2009,2013,"CAR,CGY"
Ian Cushenan,1933-11-29,7,1957,1964,"CBH,MTL,NYR,DET"
Bob Dawes,1924-11-29,4,1947,1951,"TOR,MTL"
Pavol Demitra,1974-11-29,16,1994,2010,"OTT,STL,LAK,MIN,VAN"
Jody Gage,1959-11-29,11,1981,1992,"DET,BUF"
Tanner Glass,1983-11-29,10,2008,2018,"FLA,VAN,WPG,PIT,NYR,CGY"
Ari Haanpaa,1965-11-29,2,1986,1988,NYI
Matt Irwin,1987-11-29,7,2013,2020,"SJS,BOS,NSH,ANA"
Alex Kaleta,1919-11-29,9,1942,1951,"CBH,NYR"
Tomas Kana,1987-11-29,0,2010,2010,CBJ
Yvon Labre,1949-11-29,10,1971,1981,"PIT,WSH"
Anton Lindholm,1994-11-29,3,2017,2020,COL
Georges Mantha,1908-11-29,12,1929,1941,MTL
Jack Martin,1940-11-29,0,1961,1961,TOR
Brad May,1971-11-29,18,1992,2010,"BUF,VAN,PHX,COL,ANA,TOR,DET"
Mike Natyshak,1963-11-29,0,1988,1988,QUE
Fredrik Norrena,1973-11-29,2,2007,2009,CBJ
Art Smith,1906-11-29,3,1928,1931,"TOR,OTS"
Jared Spurgeon,1989-11-29,9,2011,2020,MIN
Bob Sullivan,1957-11-29,0,1983,1983,HAR
Andrej Sustr,1990-11-29,6,2013,2019,"TBL,ANA"
Jack Walker*,1888-11-29,1,1927,1928,DTC
Dave Barr,1960-11-30,12,1982,1994,"BOS,NYR,STL,DET,HAR,NJD,DAL"
Serge Beaudoin,1952-11-30,0,1980,1980,ATF
Philippe Bozon,1966-11-30,3,1992,1995,STL
Dan Chicoine,1957-11-30,2,1978,1980,"CLE,MNS"
Marko Da≈ào,1994-11-30,5,2015,2020,"CBJ,CHI,WPG,COL"
Curt Giles,1958-11-30,13,1980,1993,"MNS,NYR,STL"
Cody Goloubef,1989-11-30,8,2012,2020,"CBJ,COL,OTT,DET"
Earl Heiskala,1942-11-30,2,1969,1971,PHI
Justin Kloos,1993-11-30,1,2018,2019,"MIN,ANA"
Horace Merrill,1885-11-30,2,1918,1920,OTS
Jason Pominville,1982-11-30,15,2004,2019,"BUF,MIN"
Sean Pronger,1972-11-30,8,1996,2004,"MDA,PIT,LAK,NYR,BOS,CBJ,VAN"
Ron Rowe,1923-11-30,0,1948,1948,NYR
Geoff Sarjeant,1969-11-30,1,1995,1996,"STL,SJS"
Darin Sceviour,1965-11-30,0,1987,1987,CHI
Sweeney Schriner*,1911-11-30,11,1935,1946,"NYA,TOR"
Tod Sloan,1927-11-30,13,1948,1961,"TOR,CBH"
Paul Szczechura,1985-11-30,3,2009,2012,"TBL,BUF"
Paul Thompson,1988-11-30,1,2016,2017,"NJD,FLA"
Noel Acciari,1991-12-01,4,2016,2020,"BOS,FLA"
Jim Anderson,1930-12-01,0,1968,1968,LAK
Roger Belanger,1965-12-01,0,1985,1985,PIT
Sam Bettio,1928-12-01,0,1950,1950,BOS
Rick Bragnalo,1951-12-01,3,1976,1979,WSH
Steve Dykstra,1962-12-01,4,1986,1990,"BUF,EDM,PIT,HAR"
Joseph Gambardella,1993-12-01,0,2019,2019,EDM
Mike Gillis,1958-12-01,5,1979,1984,"CLR,BOS"
Carl Grundstrom,1997-12-01,1,2019,2020,LAK
Bob Kirkpatrick,1915-12-01,0,1943,1943,NYR
Al LeBrun,1940-12-01,5,1961,1966,NYR
Ryan Malone,1979-12-01,11,2004,2015,"PIT,TBL,NYR"
Willie Marshall,1931-12-01,6,1953,1959,TOR
Chris McAlpine,1971-12-01,8,1995,2003,"NJD,STL,ATL,TBL,CHI,LAK"
Jim McKenny,1946-12-01,13,1966,1979,"TOR,MNS"
Alfie Moore,1905-12-01,3,1937,1940,"NYA,DET"
Paddy Nolan,1897-12-01,0,1922,1922,TRS
Gustav Olofsson,1994-12-01,4,2016,2020,"MIN,MTL"
Michael Raffl,1988-12-01,6,2014,2020,PHI
Roland Rousseau,1929-12-01,0,1953,1953,MTL
C.J. Smith,1994-12-01,2,2017,2019,BUF
Ed Stankiewicz,1929-12-01,2,1954,1956,DET
Ray Staszak,1962-12-01,0,1986,1986,DET
Tomas Tatar,1990-12-01,9,2011,2020,"DET,VEG,MTL"
Bob Wall,1942-12-01,7,1965,1972,"DET,LAK,STL"
Don Barber,1964-12-02,3,1989,1992,"MNS,WIN,QUE,SJS"
Andre Binette,1933-12-02,0,1955,1955,MTL
Dick Bouchard,1934-12-02,0,1955,1955,NYR
Kelly Buchberger,1966-12-02,16,1988,2004,"EDM,ATL,LAK,PHX,PIT"
Billy Carter,1937-12-02,4,1958,1962,"MTL,BOS"
Bob Champoux,1942-12-02,0,1974,1974,CGS
Kyle Cumiskey,1986-12-02,8,2007,2015,"COL,CHI"
Jiri Dopita,1968-12-02,1,2002,2003,"PHI,EDM"
Jesper Fast,1991-12-02,6,2014,2020,NYR
Mario Faubert,1954-12-02,7,1975,1982,PIT
Val Fonteyne,1933-12-02,12,1960,1972,"DET,NYR,PIT"
Paul Holmgren,1955-12-02,9,1976,1985,"PHI,MNS"
Elias Lindholm,1994-12-02,6,2014,2020,"CAR,CGY"
Brett Lindros,1975-12-02,1,1995,1996,NYI
John McCahill,1955-12-02,0,1978,1978,CLR
Bill McCreary,1934-12-02,17,1954,1971,"NYR,DET,MTL,STL"
Tom McMurchy,1963-12-02,4,1984,1988,"CBH,EDM"
Thomas Pock,1981-12-02,5,2004,2009,"NYR,NYI"
Daryl Stanley,1962-12-02,6,1984,1990,"PHI,VAN"
Ralph Stewart,1948-12-02,7,1971,1978,"VAN,NYI"
Rich Sutter,1963-12-02,12,1983,1995,"PIT,PHI,VAN,STL,CHI,TBL,TOR"
Ron Sutter,1963-12-02,18,1983,2001,"PHI,STL,QUE,NYI,BOS,SJS,CGY"
Joel Ward,1980-12-02,11,2007,2018,"MIN,NSH,WSH,SJS"
Sergei Zholtok,1972-12-02,11,1993,2004,"BOS,OTT,MTL,EDM,MIN,NSH"
Rasmus Asplund,1997-12-03,0,2020,2020,BUF
Jiri Bicek,1978-12-03,3,2001,2004,NJD
Evan Brophey,1986-12-03,1,2011,2012,"CHI,COL"
Harry Connor,1904-12-03,3,1928,1931,"BOS,NYA,OTS"
Kevin Henderson,1986-12-03,0,2013,2013,NSH
Julius Honka,1995-12-03,2,2017,2019,DAL
Igor Larionov*,1960-12-03,14,1990,2004,"VAN,SJS,DET,FLA,NJD"
Ken Lovsin,1966-12-03,0,1991,1991,WSH
Bob MacMillan,1952-12-03,10,1975,1985,"NYR,STL,ATF,CGY,CLR,NJD,CBH"
Ray Manson,1926-12-03,1,1948,1949,"BOS,NYR"
Curtis Murphy,1975-12-03,0,2003,2003,MIN
Tom Preissing,1978-12-03,6,2004,2010,"SJS,OTT,LAK,COL"
Mike Ramsey,1960-12-03,17,1980,1997,"BUF,PIT,DET"
Radek Smolenak,1986-12-03,1,2009,2010,"TBL,CHI"
Wayne Cowley,1964-12-04,0,1994,1994,EDM
Jassen Cullimore,1972-12-04,16,1995,2011,"VAN,MTL,TBL,CHI,FLA"
Jack Darragh*,1890-12-04,6,1918,1924,OTS
Alex Delvecchio*,1932-12-04,23,1951,1974,DET
Dan Gloor,1952-12-04,0,1974,1974,VAN
Curtis Hamilton,1991-12-04,0,2015,2015,EDM
Peter Helander,1951-12-04,0,1983,1983,LAK
Ron Howell,1935-12-04,1,1955,1956,NYR
Fran Huck,1945-12-04,3,1970,1973,"MTL,STL"
Fred Hucul,1931-12-04,17,1951,1968,"CBH,STL"
Luke Kunin,1997-12-04,2,2018,2020,MIN
Rick Middleton,1953-12-04,13,1975,1988,"NYR,BOS"
Dennis Polonich,1953-12-04,8,1975,1983,DET
Gary Sabourin,1943-12-04,9,1968,1977,"STL,TOR,CGS,CLE"
Irv Spencer,1937-12-04,8,1960,1968,"NYR,BOS,DET"
Myron Stankiewicz,1935-12-04,0,1969,1969,"PHI,STL"
Sergei Starikov,1958-12-04,0,1990,1990,NJD
Dave Taylor,1955-12-04,16,1978,1994,LAK
Phil Varone,1990-12-04,5,2014,2019,"BUF,OTT,PHI"
Nathan Beaulieu,1992-12-05,7,2013,2020,"MTL,BUF,WPG"
Perry Berezan,1964-12-05,8,1985,1993,"CGY,MNS,SJS"
Julien Brouillette,1986-12-05,1,2014,2015,"WSH,WPG"
Billy Cameron,1896-12-05,2,1924,1926,"MTL,NYA"
Les Douglas,1918-12-05,6,1941,1947,DET
Cam Fowler,1991-12-05,9,2011,2020,ANA
Bobby Francis,1958-12-05,0,1983,1983,DET
Bob Fryday,1928-12-05,2,1950,1952,MTL
Percy Galbraith,1898-12-05,7,1927,1934,"BOS,OTS"
Niklas Hagman,1979-12-05,10,2002,2012,"FLA,DAL,TOR,CGY,ANA"
Nicolas Hague,1998-12-05,0,2020,2020,VEG
Kevin Haller,1970-12-05,12,1990,2002,"BUF,MTL,PHI,HAR,CAR,MDA,NYI"
Joe Hardy,1945-12-05,1,1970,1971,"OAK,CGS"
John Hendrickson,1936-12-05,4,1958,1962,DET
Olli Jokinen,1978-12-05,17,1998,2015,"LAK,NYI,FLA,CGY,PHX,NYR,WPG,NSH,STL,TOR"
Tyler Lewington,1994-12-05,1,2019,2020,WSH
Joakim Lindstrom,1983-12-05,9,2006,2015,"CBJ,PHX,COL,STL,TOR"
Jacques Mailhot,1961-12-05,0,1989,1989,QUE
Nick Ritchie,1995-12-05,4,2016,2020,"ANA,BOS"
Victor Antipin,1992-12-06,0,2018,2018,BUF
Hank Bassen,1932-12-06,13,1955,1968,"CBH,DET,PIT"
Nathan Bastian,1997-12-06,0,2019,2019,NJD
Bunny Dame,1913-12-06,0,1942,1942,MTL
Tony Feltrin,1961-12-06,5,1981,1986,"PIT,NYR"
Pierre-Cedric Labrie,1986-12-06,2,2012,2014,TBL
Jason Lafreniere,1966-12-06,7,1987,1994,"QUE,NYR,TBL"
Garry Lariviere,1954-12-06,3,1980,1983,"QUE,EDM"
Pentti Lund,1925-12-06,4,1949,1953,"NYR,BOS"
Julian Melchiori,1991-12-06,3,2014,2017,WPG
Matt Niskanen,1986-12-06,12,2008,2020,"DAL,PIT,WSH,PHI"
Fred O'Donnell,1949-12-06,1,1973,1974,BOS
Marcel Pelletier,1927-12-06,12,1951,1963,"CBH,NYR"
Brian Smith,1937-12-06,3,1958,1961,DET
Nick Stajduhar,1974-12-06,0,1996,1996,EDM
Chris Valentine,1961-12-06,2,1982,1984,WSH
Gerry Cheevers*,1940-12-07,18,1962,1980,"TOR,BOS"
Sean Couturier,1992-12-07,8,2012,2020,PHI
Dan Gratton,1966-12-07,0,1988,1988,LAK
Ed Hatoum,1947-12-07,2,1969,1971,"DET,VAN"
James Jarvis,1907-12-07,7,1930,1937,"PTP,PHQ,TOR"
Ching Johnson*,1898-12-07,11,1927,1938,"NYR,NYA"
Georges Laraque,1976-12-07,12,1998,2010,"EDM,PHX,PIT,MTL"
Philip Larsen,1989-12-07,7,2010,2017,"DAL,EDM,VAN"
Peter Laviolette,1964-12-07,0,1989,1989,NYR
Hec Lepine,1897-12-07,0,1926,1926,MTL
Thomas McCollum,1989-12-07,4,2011,2015,DET
Milan Michalek,1984-12-07,13,2004,2017,"SJS,OTT,TOR"
Nick Mickoski,1927-12-07,11,1949,1960,"NYR,CBH,DET,BOS"
Sergei Priakin,1963-12-07,2,1989,1991,CGY
Earl Seibert*,1911-12-07,14,1932,1946,"NYR,CBH,DET"
Riley Sheahan,1991-12-07,8,2012,2020,"DET,PIT,FLA,EDM"
Garry Unger,1947-12-07,15,1968,1983,"DET,TOR,STL,ATF,EDM,LAK"
Francis Wathier,1984-12-07,3,2010,2013,DAL
Marty Barry*,1905-12-08,12,1928,1940,"NYA,BOS,DET,MTL"
Red Berenson,1939-12-08,16,1962,1978,"MTL,NYR,STL,DET"
Sebastien Bisaillon,1986-12-08,0,2007,2007,EDM
Thatcher Demko,1995-12-08,2,2018,2020,VAN
Drew Doughty,1989-12-08,11,2009,2020,LAK
Matt Ellison,1983-12-08,3,2004,2007,"CHI,PHI"
Kenny Girard,1936-12-08,3,1957,1960,TOR
Philip Holm,1991-12-08,0,2018,2018,VAN
Ted Irvine,1944-12-08,13,1964,1977,"BOS,LAK,NYR,STL"
Mattias Janmark,1992-12-08,4,2016,2020,DAL
Pete Morin,1915-12-08,0,1942,1942,MTL
Marcel Paille,1932-12-08,7,1958,1965,NYR
Nathan Perrott,1976-12-08,4,2002,2006,"NSH,TOR,DAL"
Joe Shack,1915-12-08,2,1943,1945,NYR
Darrin Shannon,1969-12-08,9,1989,1998,"BUF,WIN,PHX"
Pete Vipond,1949-12-08,0,1973,1973,CGS
Ryan Bayda,1980-12-09,6,2003,2009,CAR
Phil Besler,1913-12-09,3,1936,1939,"BOS,CBH,DET"
Mackenzie Blackwood,1996-12-09,1,2019,2020,NJD
Kyle Connor,1996-12-09,3,2017,2020,WPG
Kevin Devine,1954-12-09,0,1983,1983,NYI
Bruce Dowie,1962-12-09,0,1984,1984,TOR
Germain Gagnon,1942-12-09,4,1972,1976,"MTL,NYI,CBH,KCS"
Bep Guidolin,1925-12-09,9,1943,1952,"BOS,DET,CBH"
Bill Hay,1935-12-09,7,1960,1967,CBH
Nick Libett,1945-12-09,13,1968,1981,"DET,PIT"
Alex Lyon,1992-12-09,2,2018,2020,PHI
Nevin Markwart,1964-12-09,8,1984,1992,"BOS,CGY"
Pit Martin,1943-12-09,17,1962,1979,"DET,BOS,CBH,VAN"
Joseph Morrow,1992-12-09,4,2015,2019,"BOS,MTL,WPG"
Kael Mouillierat,1987-12-09,1,2015,2016,"NYI,PIT"
Dana Murzyn,1966-12-09,13,1986,1999,"HAR,CGY,VAN"
Petr Nedved,1971-12-09,16,1991,2007,"VAN,STL,NYR,PIT,EDM,PHI,PHX"
Jeff Petry,1987-12-09,9,2011,2020,"EDM,MTL"
Noel Price,1935-12-09,18,1958,1976,"TOR,NYR,DET,MTL,PIT,LAK,ATF"
Jim Slater,1982-12-09,9,2006,2015,"ATL,WPG"
Cliff Thompson,1918-12-09,7,1942,1949,BOS
Thommie Bergman,1947-12-10,7,1973,1980,DET
Rob Blake*,1969-12-10,20,1990,2010,"LAK,COL,SJS"
Rene Bourque,1981-12-10,11,2006,2017,"CHI,CGY,MTL,ANA,CBJ,COL"
Roman Cervenka,1985-12-10,0,2013,2013,CGY
Norm Dennis,1942-12-10,3,1969,1972,STL
Nate Guenin,1982-12-10,9,2007,2016,"PHI,PIT,CBJ,ANA,COL"
T.J. Hensick,1985-12-10,3,2008,2011,"COL,STL"
Henry Hicks,1900-12-10,2,1929,1931,"MTM,DTC,DTF"
Hec Highton,1923-12-10,0,1944,1944,CBH
Jaroslav Jirik,1939-12-10,0,1970,1970,STL
Chris Kontos,1963-12-10,10,1983,1993,"NYR,PIT,LAK,TBL"
Jaycob Megna,1992-12-10,2,2017,2019,ANA
Christian Proulx,1973-12-10,0,1994,1994,MTL
Andy Rymsha,1968-12-10,0,1992,1992,QUE
Jeff Zehr,1978-12-10,0,2000,2000,BOS
Daniel Alfredsson,1972-12-11,18,1996,2014,"OTT,DET"
Erik Burgdoerfer,1988-12-11,2,2017,2019,"BUF,OTT"
Anders Eldebrink,1960-12-11,1,1982,1983,"VAN,QUE"
Dave Gagner,1964-12-11,14,1985,1999,"NYR,MNS,DAL,TOR,CGY,FLA,VAN"
Ted Hampson,1936-12-11,12,1960,1972,"TOR,NYR,DET,OAK,CGS,MNS"
Ralph Intranuovo,1973-12-11,2,1995,1997,"EDM,TOR"
Pat Micheletti,1963-12-11,0,1988,1988,MNS
Mike Nykoluk,1934-12-11,0,1957,1957,TOR
J.P. Parise,1941-12-11,13,1966,1979,"BOS,MNS,TOR,NYI,CLE"
Pierre Pilote*,1931-12-11,13,1956,1969,"CBH,TOR"
Martin Prusek,1975-12-11,4,2002,2006,"OTT,CBJ"
Bill Regan,1908-12-11,3,1930,1933,"NYR,NYA"
Dave Richardson,1940-12-11,4,1964,1968,"NYR,CBH,DET"
Steve Richmond,1959-12-11,5,1984,1989,"NYR,DET,NJD,LAK"
Mark Streit,1977-12-11,12,2006,2018,"MTL,NYI,PHI,PIT"
Matthew Tkachuk,1997-12-11,3,2017,2020,CGY
Moose Vasko,1935-12-11,13,1957,1970,"CBH,MNS"
Dan Bouchard,1950-12-12,13,1973,1986,"ATF,CGY,QUE,WIN"
Austin Czarnik,1992-12-12,3,2017,2020,"BOS,CGY"
Steve Durbano,1951-12-12,6,1973,1979,"STL,PIT,KCS,CLR"
Kris Foucault,1990-12-12,0,2012,2012,MIN
Red Green,1899-12-12,5,1924,1929,"HAM,NYA,BOS,DTC"
Steve Hazlett,1957-12-12,0,1980,1980,VAN
Doug Jackson,1924-12-12,0,1948,1948,CBH
Mike Karakas,1911-12-12,10,1936,1946,"CBH,MTL"
Ted Kennedy*,1925-12-12,14,1943,1957,TOR
Eddie Kullman,1923-12-12,6,1948,1954,NYR
Kevin Labanc,1995-12-12,3,2017,2020,SJS
Andrew Ladd,1985-12-12,14,2006,2020,"CAR,CHI,ATL,WPG,NYI"
Danny Lorenz,1969-12-12,2,1991,1993,NYI
Bill MacKenzie,1911-12-12,6,1934,1940,"MTM,NYR,MTL,CBH"
Danick Martel,1994-12-12,1,2018,2019,"PHI,TBL"
John McKenzie,1937-12-12,13,1959,1972,"CBH,DET,BOS,NYR"
Mike Moore,1984-12-12,0,2011,2011,SJS
Evariste Payer,1887-12-12,0,1918,1918,MTL
Beattie Ramsay,1895-12-12,0,1928,1928,TOR
Mike Rucinski,1963-12-12,0,1989,1989,CHI
Jim Sandlak,1966-12-12,10,1986,1996,"VAN,HAR"
Billy Smith*,1950-12-12,17,1972,1989,"LAK,NYI"
Clint Smith*,1913-12-12,10,1937,1947,"NYR,CBH"
Max Veronneau,1995-12-12,1,2019,2020,OTT
Carl Wetzel,1938-12-12,3,1965,1968,"DET,MNS"
Colin White,1977-12-12,12,2000,2012,"NJD,SJS"
Rudy Ahlin,1908-12-13,0,1938,1938,CBH
Bates Battaglia,1975-12-13,10,1998,2008,"CAR,COL,WSH,TOR"
Mike Busniuk,1951-12-13,1,1980,1981,PHI
Artem Chubarov,1979-12-13,4,2000,2004,VAN
Sergei Fedorov*,1969-12-13,18,1991,2009,"DET,MDA,CBJ,WSH"
Bob Gainey*,1953-12-13,15,1974,1989,MTL
Andrew Gordon,1985-12-13,4,2009,2013,"WSH,ANA,VAN"
Dan Hamhuis,1982-12-13,16,2004,2020,"NSH,VAN,DAL"
Don Johns,1937-12-13,7,1961,1968,"NYR,MTL,MNS"
Kevin Klein,1984-12-13,11,2006,2017,"NSH,NYR"
Blake Lizotte,1997-12-13,1,2019,2020,LAK
Blair MacKasey,1955-12-13,0,1977,1977,TOR
Doug Mohns,1933-12-13,21,1954,1975,"BOS,CBH,MNS,ATF,WSH"
Moe Roberts,1905-12-13,26,1926,1952,"BOS,NYA,CBH"
Vladimir Tarasenko,1991-12-13,7,2013,2020,STL
Bob Warner,1950-12-13,0,1977,1977,TOR
Len Wharton,1927-12-13,0,1945,1945,NYR
Ivan Barbashev,1995-12-14,3,2017,2020,STL
Brad Chartrand,1974-12-14,4,2000,2004,LAK
Cory Conacher,1989-12-14,7,2013,2020,"OTT,TBL,BUF,NYI"
Joe Cooper,1914-12-14,11,1936,1947,"NYR,CBH"
Chris Dahlquist,1962-12-14,10,1986,1996,"PIT,MNS,CGY,OTT"
A.J. Greer,1996-12-14,2,2017,2019,COL
Tomas Kurka,1981-12-14,1,2003,2004,CAR
Shane MacEachern,1967-12-14,0,1988,1988,STL
Eric Pettinger,1904-12-14,2,1929,1931,"BOS,TOR,OTS"
Emile Poirier,1994-12-14,1,2015,2016,CGY
Ken Randall,1888-12-14,9,1918,1927,"TRA,TRS,HAM,NYA"
Bill Ranford,1966-12-14,14,1986,2000,"BOS,EDM,WSH,DET,TBL"
Mike Santorelli,1985-12-14,7,2009,2016,"NSH,FLA,WPG,VAN,TOR,ANA"
Frank St. Marseille,1939-12-14,9,1968,1977,"STL,LAK"
Patrik Sundstrom,1961-12-14,9,1983,1992,"VAN,NJD"
Peter Sundstrom,1961-12-14,6,1984,1990,"NYR,WSH,NJD"
Chris Therien,1971-12-14,11,1995,2006,"PHI,DAL"
Normand Baron,1957-12-15,2,1984,1986,"MTL,STL"
Mike Blunden,1986-12-15,11,2007,2018,"CHI,CBJ,MTL,TBL,OTT"
Hugh Coflin,1928-12-15,0,1951,1951,CBH
Yanni Gourde,1991-12-15,4,2016,2020,TBL
Erik Gustafsson,1988-12-15,3,2011,2014,PHI
Art Jackson,1915-12-15,10,1935,1945,"TOR,BOS,NYA"
Mario Marois,1957-12-15,14,1978,1992,"NYR,QUE,VAN,WIN,STL"
Craig Norwich,1955-12-15,1,1980,1981,"WIN,CLR,STL"
Ric Seiling,1957-12-15,9,1978,1987,"BUF,DET"
Kyle Wilson,1984-12-15,2,2010,2012,"WSH,CBJ,NSH"
Eric Belanger,1977-12-16,12,2001,2013,"LAK,ATL,CAR,MIN,WSH,PHX,EDM"
Mikkel Boedker,1989-12-16,11,2009,2020,"PHX,ARI,COL,SJS,OTT"
Mike Boland,1949-12-16,0,1975,1975,PHI
Wayne Connelly,1939-12-16,11,1961,1972,"MTL,BOS,MNS,DET,STL,VAN"
Eddie Convey,1910-12-16,2,1931,1933,NYA
Randy Legge,1945-12-16,0,1973,1973,NYR
Bob Lemieux,1944-12-16,0,1968,1968,OAK
Jean-Guy Morissette,1937-12-16,0,1964,1964,MTL
Barry Nieckar,1967-12-16,5,1993,1998,"HAR,CGY,MDA"
Bob Trapp,1899-12-16,6,1927,1933,"CBH,MTL"
Mike Weber,1987-12-16,8,2008,2016,"BUF,WSH"
Craig Berube,1965-12-17,16,1987,2003,"PHI,CGY,TOR,WSH,NYI"
Gregory Campbell,1983-12-17,12,2004,2016,"FLA,BOS,CBJ"
Erik Christensen,1983-12-17,6,2006,2012,"PIT,ATL,ANA,NYR,MIN"
Vincent Damphousse,1967-12-17,17,1987,2004,"TOR,EDM,MTL,SJS"
John Duggan,1898-12-17,0,1926,1926,OTS
Edward Lee,1961-12-17,0,1985,1985,QUE
Matt Murley,1979-12-17,4,2004,2008,"PIT,PHX"
Frantisek Musil,1964-12-17,14,1987,2001,"MNS,CGY,OTT,EDM"
Pasi Nurminen,1975-12-17,2,2002,2004,ATL
Nathan Oystrick,1982-12-17,2,2009,2011,"ATL,ANA,STL"
Samuel Pahlsson,1977-12-17,11,2001,2012,"BOS,MDA,ANA,CHI,CBJ,VAN"
Frank Pietrangelo,1964-12-17,6,1988,1994,"PIT,HAR"
Dave Poulin,1958-12-17,12,1983,1995,"PHI,BOS,WSH"
Gilles Tremblay,1938-12-17,8,1961,1969,MTL
Derek Whitmore,1984-12-17,0,2012,2012,BUF
Brian Boyle,1984-12-18,12,2008,2020,"LAK,NYR,TBL,TOR,NJD,NSH,FLA"
Bob Brooke,1960-12-18,6,1984,1990,"NYR,MNS,NJD"
Dan Cleary,1978-12-18,17,1998,2015,"CHI,EDM,PHX,DET"
Bob Corkum,1967-12-18,12,1990,2002,"BUF,MDA,PHI,PHX,LAK,NJD,ATL"
Alex DeBrincat,1997-12-18,2,2018,2020,CHI
Joe Dziedzic,1971-12-18,3,1996,1999,"PIT,PHX"
Jeff Finger,1979-12-18,3,2007,2010,"COL,TOR"
Victor Hedman,1990-12-18,10,2010,2020,TBL
Walter Kalbfleisch,1911-12-18,3,1934,1937,"OTS,STE,NYA,BOS"
Charlie Lindgren,1993-12-18,4,2016,2020,MTL
Neil Little,1971-12-18,2,2002,2004,PHI
Jeff Nelson,1972-12-18,4,1995,1999,"WSH,NSH"
Jean Pronovost,1945-12-18,13,1969,1982,"PIT,ATF,WSH"
Mike Siklenka,1979-12-18,1,2003,2004,"PHI,NYR"
Joe Szura,1938-12-18,1,1968,1969,OAK
Bernie Wolfe,1951-12-18,3,1976,1979,WSH
William Borgen,1996-12-19,0,2019,2019,BUF
Ken Brown,1948-12-19,0,1971,1971,CBH
Marcel Dheere,1918-12-19,0,1943,1943,MTL
Doug Harvey*,1924-12-19,21,1948,1969,"MTL,NYR,DET,STL"
Eric Houde,1976-12-19,2,1997,1999,MTL
Carter Hutton,1985-12-19,7,2013,2020,"CHI,NSH,STL,BUF"
John Ingram,1893-12-19,0,1925,1925,BOS
Dale Krentz,1961-12-19,2,1987,1989,DET
Murray Kuntz,1945-12-19,0,1975,1975,STL
Robert Lang,1970-12-19,17,1993,2010,"LAK,BOS,PIT,WSH,DET,CHI,MTL,PHX"
Mikael Lindholm,1964-12-19,0,1990,1990,LAK
Scott Pearson,1969-12-19,11,1989,2000,"TOR,QUE,EDM,BUF,NYI"
Nels Podolsky,1925-12-19,0,1949,1949,DET
Mike Polich,1952-12-19,3,1978,1981,"MTL,MNS"
Andreas Salomonsson,1973-12-19,1,2002,2003,"NJD,WSH"
Ron Schock,1943-12-19,14,1964,1978,"BOS,STL,PIT,BUF"
Matt Stajan,1983-12-19,15,2003,2018,"TOR,CGY"
Eric Weinrich,1966-12-19,17,1989,2006,"NJD,HAR,CHI,MTL,BOS,PHI,STL,VAN"
Behn Wilson,1958-12-19,9,1979,1988,"PHI,CBH,CHI"
Lin Bend,1922-12-20,0,1943,1943,NYR
Joe Callahan,1982-12-20,2,2009,2011,"NYI,SJS,FLA"
Jan Caloun,1972-12-20,5,1996,2001,"SJS,CBJ"
William Carrier,1994-12-20,3,2017,2020,"BUF,VEG"
Mike Christie,1949-12-20,6,1975,1981,"CGS,CLE,CLR,VAN"
Bill Clement,1950-12-20,10,1972,1982,"PHI,ATF,WSH,CGY"
Charlie Conacher*,1909-12-20,11,1930,1941,"TOR,DET,NYA"
Derek Dorsett,1986-12-20,9,2009,2018,"CBJ,NYR,VAN"
Chay Genoway,1986-12-20,0,2012,2012,MIN
Travis Green,1970-12-20,14,1993,2007,"NYI,MDA,PHX,TOR,BOS,ANA"
Marc Labelle,1969-12-20,0,1997,1997,DAL
Andrei Markov,1978-12-20,16,2001,2017,MTL
Cooper Marody,1996-12-20,0,2019,2019,EDM
Anthony Richard,1996-12-20,1,2019,2020,NSH
Tom Songin,1953-12-20,2,1979,1981,BOS
Cory Stillman,1973-12-20,16,1995,2011,"CGY,STL,TBL,CAR,OTT,FLA"
Chris Tanev,1989-12-20,9,2011,2020,VAN
Alexander Urbom,1990-12-20,3,2011,2014,"NJD,WSH"
Cody Ceci,1993-12-21,6,2014,2020,"OTT,TOR"
Shane Endicott,1981-12-21,4,2002,2006,PIT
Al Huggins,1910-12-21,0,1931,1931,MTM
Alex Iafallo,1993-12-21,2,2018,2020,LAK
Gord Kannegiesser,1945-12-21,4,1968,1972,STL
Joe Kocur,1964-12-21,14,1985,1999,"DET,NYR,VAN"
Peter Marsh,1956-12-21,4,1980,1984,"WIN,CBH"
Charlie McAvoy,1997-12-21,2,2018,2020,BOS
Steve Montador,1979-12-21,10,2002,2012,"CGY,FLA,ANA,BOS,BUF,CHI"
Jamie Oleksiak,1992-12-21,7,2013,2020,"DAL,PIT"
Guy Rousseau,1934-12-21,2,1955,1957,MTL
Joe Schaefer,1924-12-21,1,1960,1961,NYR
Malcolm Subban,1993-12-21,5,2015,2020,"BOS,VEG,CHI"
Petr Sykora,1978-12-21,7,1999,2006,"NSH,WSH"
Walt Atanas,1923-12-22,0,1945,1945,NYR
Scott Darling,1988-12-22,4,2015,2019,"CHI,CAR"
Travis Dermott,1996-12-22,2,2018,2020,TOR
Babe Donnelly,1895-12-22,0,1927,1927,MTM
Paul Fenton,1959-12-22,7,1985,1992,"HAR,NYR,LAK,WIN,CGY,TOR,SJS"
Peter Fiorentino,1968-12-22,0,1992,1992,NYR
Bob Fitchner,1950-12-22,1,1980,1981,QUE
Sandy Fitzpatrick,1944-12-22,3,1965,1968,"NYR,MNS"
Norm Gratton,1950-12-22,4,1972,1976,"NYR,ATF,BUF,MNS"
Ron Greschner,1954-12-22,15,1975,1990,NYR
Steve Kariya,1977-12-22,2,2000,2002,VAN
Kirk Maltby,1972-12-22,16,1994,2010,"EDM,DET"
Stan Neckar,1975-12-22,9,1995,2004,"OTT,NYR,PHX,TBL,NSH"
Stefan Persson,1954-12-22,8,1978,1986,NYI
Ian Turnbull,1953-12-22,9,1974,1983,"TOR,LAK,PIT"
Brett Clark,1976-12-23,15,1998,2013,"MTL,ATL,COL,TBL,MIN"
Chris Conner,1983-12-23,8,2007,2015,"DAL,PIT,DET,PHX,WSH"
Cy Denneny*,1891-12-23,11,1918,1929,"OTS,BOS"
Woody Dumart*,1916-12-23,18,1936,1954,BOS
Andreas Engqvist,1987-12-23,1,2011,2012,MTL
Johan Franzen,1979-12-23,10,2006,2016,DET
Scott Gomez,1979-12-23,16,2000,2016,"NJD,NYR,MTL,SJS,FLA,OTT,STL"
Petr Klima,1964-12-23,13,1986,1999,"DET,EDM,TBL,LAK,PIT"
Ales Kotalik,1978-12-23,9,2002,2011,"BUF,EDM,CGY,NYR"
Bill Kyle,1924-12-23,1,1950,1951,NYR
Steve Langdon,1953-12-23,3,1975,1978,BOS
Jori Lehtera,1987-12-23,4,2015,2019,"STL,PHI"
Zbynek Michalek,1982-12-23,13,2004,2017,"MIN,PHX,PIT,ARI,STL"
Shaone Morrisonn,1982-12-23,8,2003,2011,"BOS,WSH,BUF"
T.J. Oshie,1986-12-23,11,2009,2020,"STL,WSH"
Karel Pilar,1977-12-23,2,2002,2004,TOR
Mikael Samuelsson,1976-12-23,13,2001,2014,"SJS,NYR,PIT,FLA,DET,VAN"
Yves Sarault,1972-12-23,7,1995,2002,"MTL,CGY,COL,OTT,ATL,NSH"
Vadim Sharifijanov,1975-12-23,3,1997,2000,"NJD,VAN"
Bob Solinger,1925-12-23,8,1952,1960,"TOR,DET"
Herb Cain,1912-12-24,12,1934,1946,"MTM,MTL,BOS"
Matt Calvert,1989-12-24,9,2011,2020,"CBJ,COL"
Gary Dineen,1943-12-24,0,1969,1969,MNS
Don Gillen,1960-12-24,2,1980,1982,"PHI,HAR"
Shawn Heins,1973-12-24,5,1999,2004,"SJS,PIT,ATL"
Nick Johnson,1985-12-24,4,2010,2014,"PIT,MIN,PHX,BOS"
Timo Jutila,1963-12-24,0,1985,1985,BUF
Brett Maclean,1988-12-24,1,2011,2012,"PHX,WPG"
Dave Morissette,1971-12-24,1,1999,2000,MTL
George Morrison,1948-12-24,1,1971,1972,STL
Wayne Muloin,1941-12-24,7,1964,1971,"DET,OAK,CGS,MNS"
Justin Shugg,1991-12-24,0,2015,2015,CAR
Red Sullivan,1929-12-24,11,1950,1961,"BOS,CBH,NYR"
Gerry Abel,1944-12-25,0,1967,1967,DET
Stu Barnes,1970-12-25,16,1992,2008,"WIN,FLA,PIT,BUF,DAL"
Larry Cahan,1933-12-25,16,1955,1971,"TOR,NYR,OAK,LAK"
Jim Dowd,1968-12-25,16,1992,2008,"NJD,VAN,NYI,CGY,EDM,MIN,MTL,CHI,COL,PHI"
Mark Friedman,1995-12-25,1,2019,2020,PHI
Dave Kryskow,1951-12-25,3,1973,1976,"CBH,DET,WSH,ATF"
Dmitri Mironov,1965-12-25,9,1992,2001,"TOR,PIT,MDA,DET,WSH"
Noel Picard,1938-12-25,8,1965,1973,"MTL,STL,ATF"
Vitali Prokhorov,1966-12-25,2,1993,1995,STL
Fred Sasakamoose,1933-12-25,0,1954,1954,CBH
Joel Savage,1969-12-25,0,1991,1991,BUF
Brian Stapleton,1951-12-25,0,1976,1976,WSH
Steve Wojciechowski,1922-12-25,2,1945,1947,DET
Bob Attwell,1959-12-26,1,1980,1981,CLR
Colby Cave,1994-12-26,2,2018,2020,"BOS,EDM"
Andy Delmore,1976-12-26,7,1999,2006,"PHI,NSH,BUF,CBJ"
Lee Goren,1977-12-26,6,2001,2007,"BOS,FLA,VAN"
Mark Heaslip,1951-12-26,2,1977,1979,"NYR,LAK"
Tomas Kundratek,1989-12-26,1,2012,2013,WSH
Vojtech Mozik,1992-12-26,0,2016,2016,NJD
Dave Orleski,1959-12-26,1,1981,1982,MTL
Oskar Osala,1987-12-26,1,2009,2010,"WSH,CAR"
Dmitri Tertyshny,1976-12-26,0,1999,1999,PHI
Gene Ubriaco,1937-12-26,2,1968,1970,"PIT,OAK,CBH"
Norm Ullman*,1935-12-26,19,1956,1975,"DET,TOR"
Nikita Alexeev,1981-12-27,5,2002,2007,"TBL,CHI"
Blake Bellefeuille,1977-12-27,1,2002,2003,CBJ
Brad Brown,1975-12-27,7,1997,2004,"MTL,CHI,NYR,MIN,BUF"
Christopher Gibson,1992-12-27,3,2016,2019,NYI
Oscar Hanson,1909-12-27,0,1938,1938,CBH
Jonathan Hedstrom,1977-12-27,3,2003,2006,MDA
Jonathan Marchessault,1990-12-27,7,2013,2020,"CBJ,TBL,FLA,VEG"
Mike Matteucci,1971-12-27,1,2001,2002,MIN
Jay Pandolfo,1974-12-27,16,1997,2013,"NJD,NYI,BOS"
Fernando Pisani,1976-12-27,8,2003,2011,"EDM,CHI"
Mickey Redmond,1947-12-27,8,1968,1976,"MTL,DET"
Patrick Sharp,1981-12-27,15,2003,2018,"PHI,CHI,DAL"
Bryan Smolinski,1971-12-27,15,1993,2008,"BOS,PIT,NYI,LAK,OTT,CHI,VAN,MTL"
Paul Stastny,1985-12-27,13,2007,2020,"COL,STL,WPG,VEG"
Ray Bourque*,1960-12-28,21,1980,2001,"BOS,COL"
Bucky Buchanan,1922-12-28,0,1949,1949,NYR
Patrick Davis,1986-12-28,1,2009,2010,NJD
Kyle Freadrich,1978-12-28,1,2000,2001,TBL
Brett Gallant,1988-12-28,0,2014,2014,NYI
Curtis Glencross,1982-12-28,8,2007,2015,"ANA,CBJ,EDM,CGY,WSH"
Benoit Gratton,1976-12-28,6,1998,2004,"WSH,CGY,MTL"
Harry Howell*,1932-12-28,20,1953,1973,"NYR,OAK,CGS,LAK"
Dave Hudson,1949-12-28,5,1973,1978,"NYI,KCS,CLR"
Jean-Francois Jomphe,1972-12-28,3,1996,1999,"MDA,MTL,PHX"
Tomas Jurco,1992-12-28,6,2014,2020,"DET,CHI,EDM"
Bobby Lee,1911-12-28,0,1943,1943,MTL
Guy Leveque,1972-12-28,1,1993,1994,LAK
Dave Moss,1981-12-28,8,2007,2015,"CGY,PHX,ARI"
Rob Niedermayer,1974-12-28,17,1994,2011,"FLA,CGY,MDA,ANA,NJD,BUF"
Doug Patey,1956-12-28,2,1977,1979,WSH
Phil Samis,1927-12-28,0,1950,1950,TOR
Terry Sawchuk*,1929-12-28,20,1950,1970,"DET,BOS,TOR,LAK,NYR"
Jamie Storr,1975-12-28,9,1995,2004,"LAK,CAR"
Don Wheldon,1954-12-28,0,1975,1975,STL
Eddie Wiseman,1912-12-28,9,1933,1942,"DET,NYA,BOS"
Steve Alley,1953-12-29,1,1980,1981,HAR
Tom Bladon,1952-12-29,8,1973,1981,"PHI,PIT,DET,EDM,WIN"
Red Carr,1916-12-29,0,1944,1944,TOR
Sean Collins,1988-12-29,3,2013,2016,"CBJ,WSH"
Jakub Cutta,1981-12-29,3,2001,2004,WSH
Andreas Dackell,1972-12-29,7,1997,2004,"OTT,MTL"
Don Gibson,1967-12-29,0,1991,1991,VAN
Jeannot Gilbert,1940-12-29,2,1963,1965,BOS
Filip Kuba,1976-12-29,14,1999,2013,"FLA,MIN,TBL,OTT"
Robbie Laird,1954-12-29,0,1980,1980,MNS
Chris Marinucci,1971-12-29,2,1995,1997,"NYI,LAK"
Tom O'Regan,1961-12-29,2,1984,1986,PIT
George Parros,1979-12-29,8,2006,2014,"LAK,ANA,COL,FLA,MTL"
Jack Riley,1910-12-29,3,1933,1936,"DET,MTL,BOS"
Derek Ryan,1986-12-29,4,2016,2020,"CAR,CGY"
Harri Sateri,1989-12-29,0,2018,2018,FLA
Nels Stewart*,1902-12-29,14,1926,1940,"MTM,BOS,NYA"
Tommy Westlund,1974-12-29,3,2000,2003,CAR
Dan Woodley,1967-12-29,0,1988,1988,VAN
David Cullen,1976-12-30,1,2001,2002,"PHX,MIN"
Kevin Dahl,1968-12-30,8,1993,2001,"CGY,PHX,TOR,CBJ"
Gary Emmons,1963-12-30,0,1994,1994,SJS
Brett Lysak,1980-12-30,0,2004,2004,CAR
Jakub Nakladal,1987-12-30,1,2016,2017,"CGY,CAR"
Lester Patrick*,1883-12-30,0,1927,1927,NYR
Lawrence Pilut,1995-12-30,1,2019,2020,BUF
Nikita Scherbak,1995-12-30,2,2017,2019,"MTL,LAK"
Danny Schock,1948-12-30,0,1971,1971,"BOS,PHI"
Rob Scuderi,1978-12-30,12,2004,2016,"PIT,LAK,CHI"
Igor Shesterkin,1995-12-30,0,2020,2020,NYR
Mike Stevens,1965-12-30,5,1985,1990,"VAN,BOS,NYI,TOR"
Dean Sylvester,1972-12-30,2,1999,2001,"BUF,ATL"
Jim Thomson,1965-12-30,7,1987,1994,"WSH,HAR,NJD,LAK,OTT,MDA"
Roman Wick,1985-12-30,0,2011,2011,OTT
Corey Crawford,1984-12-31,14,2006,2020,CHI
Nelson Debenedet,1947-12-31,1,1974,1975,"DET,PIT"
Gerard Desaulniers,1928-12-31,3,1951,1954,MTL
Dennis Everberg,1991-12-31,1,2015,2016,COL
Dan Focht,1977-12-31,2,2002,2004,"PHX,PIT"
Charlie Gardiner*,1904-12-31,6,1928,1934,CBH
Paul Gillis,1963-12-31,10,1983,1993,"QUE,CHI,HAR"
Red Heron,1917-12-31,3,1939,1942,"TOR,BRO,MTL"
Lex Hudson,1955-12-31,0,1979,1979,PIT
Peter Lappin,1965-12-31,2,1990,1992,"MNS,SJS"
Gerald Mayhew,1992-12-31,0,2020,2020,MIN
Gary McAdam,1955-12-31,10,1976,1986,"BUF,PIT,DET,CGY,NJD,WSH,TOR"
Scott Nichol,1974-12-31,17,1996,2013,"BUF,CGY,CHI,NSH,SJS,STL"
Michal Repik,1988-12-31,3,2009,2012,FLA
Ren√© Robert,1948-12-31,11,1971,1982,"TOR,BUF,PIT,CLR"
Nathan Robinson,1981-12-31,2,2004,2006,"DET,BOS"
Terry Ruskowski,1954-12-31,9,1980,1989,"CBH,LAK,PIT,MNS"
Brandon Tanev,1991-12-31,4,2016,2020,"WPG,PIT"
Dominik Uher,1992-12-31,0,2015,2015,PIT
